Id,Label,timeset,modularity_class,indegree,outdegree,degree
0,0,,23,2189,1896,4085
1,1,,23,3574,2315,5889
2,2,,105,10,194,204
3,3,,105,11,10,21
4,4,,105,1,3,4
5,5,,105,600,237,837
6,6,,8,1812,2045,3857
7,7,,8,84,62,146
8,8,,76,316,713,1029
9,9,,76,1000,400,1400
10,10,,76,74,109,183
11,11,,76,28,101,129
12,12,,76,14,25,39
13,13,,76,588,667,1255
14,14,,52,345,1155,1500
15,15,,52,1291,839,2130
16,16,,52,6,17,23
17,17,,52,537,746,1283
18,18,,52,108,170,278
19,19,,43,3515,7506,11021
20,20,,43,760,305,1065
21,21,,23,1058,1346,2404
22,22,,127,493,247,740
23,23,,105,49,94,143
24,24,,105,2,0,2
25,25,,52,1461,995,2456
26,26,,52,526,138,664
27,27,,23,44,86,130
28,28,,23,7666,5533,13199
29,29,,14,15,5,20
30,30,,23,121,71,192
31,31,,14,245,187,432
32,32,,105,624,682,1306
33,33,,105,303,197,500
34,34,,0,34,47,81
35,35,,105,134,105,239
36,36,,105,18,20,38
37,37,,105,87,45,132
38,38,,105,1255,841,2096
39,39,,105,12,19,31
40,40,,43,277,648,925
41,41,,43,270,348,618
42,42,,43,9820,6678,16498
43,43,,43,24,45,69
44,44,,43,3437,2546,5983
45,45,,43,397,647,1044
46,46,,14,107,415,522
47,47,,14,447,213,660
48,48,,120,423,266,689
49,49,,120,236,133,369
50,50,,23,5907,4537,10444
51,51,,111,569,451,1020
52,52,,111,235,129,364
53,53,,23,2497,2605,5102
54,54,,23,167,365,532
55,55,,23,414,821,1235
56,56,,23,72,102,174
57,57,,43,6020,0,6020
58,58,,5,3,7,10
59,59,,5,24,10,34
60,60,,127,80,85,165
61,61,,23,722,372,1094
62,62,,23,61,26,87
63,63,,23,3521,2128,5649
64,64,,23,3271,2219,5490
65,65,,0,2603,1826,4429
66,66,,23,9064,7514,16578
67,67,,23,2616,1974,4590
68,68,,23,539,318,857
69,69,,43,229,132,361
70,70,,43,5511,1649,7160
71,71,,43,65,117,182
72,72,,43,25,37,62
73,73,,23,248,510,758
74,74,,5,1413,960,2373
75,75,,5,382,208,590
76,76,,105,219,213,432
77,77,,105,1167,559,1726
78,78,,15,449,293,742
79,79,,23,351,275,626
80,80,,23,4116,5168,9284
81,81,,88,280,268,548
82,82,,111,79,64,143
83,83,,8,12,22,34
84,84,,8,182,114,296
85,85,,8,79,204,283
86,86,,8,22,41,63
87,87,,8,2,3,5
88,88,,3,171,445,616
89,89,,3,58,27,85
90,90,,5,85,55,140
91,91,,8,276,705,981
92,92,,8,113,65,178
93,93,,127,12,5,17
94,94,,111,109,137,246
95,95,,8,5,4,9
96,96,,8,1,1,2
97,97,,0,410,819,1229
98,98,,0,945,484,1429
99,99,,23,9,1,10
100,100,,43,128,359,487
101,101,,23,64,42,106
102,102,,43,11,7,18
103,103,,43,13,3,16
104,104,,127,22,9,31
105,105,,23,72,62,134
106,106,,23,181,385,566
107,107,,23,1,5,6
108,108,,66,43,22,65
109,109,,66,103,94,197
110,110,,21,157,79,236
111,111,,23,99,76,175
112,112,,8,389,322,711
113,113,,8,2,0,2
114,114,,14,36,91,127
115,115,,23,3084,2693,5777
116,116,,14,631,548,1179
117,117,,23,893,1337,2230
118,118,,23,14,18,32
119,119,,0,23,11,34
120,120,,43,295,406,701
121,121,,52,15,17,32
122,122,,43,7593,5535,13128
123,123,,15,250,321,571
124,124,,15,83,19,102
125,125,,43,1268,1139,2407
126,126,,31,911,702,1613
127,127,,31,876,465,1341
128,128,,43,146,60,206
129,129,,105,145,255,400
130,130,,105,2,5,7
131,131,,105,0,8,8
132,132,,8,32,25,57
133,133,,8,309,194,503
134,134,,8,4,13,17
135,135,,23,85,98,183
136,136,,23,5,21,26
137,137,,23,61,66,127
138,138,,8,92,144,236
139,139,,45,86,64,150
140,140,,45,12,11,23
141,141,,23,11,5,16
142,142,,23,371,310,681
143,143,,23,51,50,101
144,144,,23,143,251,394
145,145,,14,1131,798,1929
146,146,,105,2,3,5
147,147,,105,1,0,1
148,148,,0,31,35,66
149,149,,0,11,6,17
150,150,,8,130,77,207
151,151,,8,100,46,146
152,152,,8,1,2,3
153,153,,8,5,12,17
154,154,,8,15,17,32
155,155,,8,0,1,1
156,156,,23,9,26,35
157,157,,23,1002,1269,2271
158,158,,8,457,541,998
159,159,,120,56,265,321
160,160,,120,2,2,4
161,161,,43,295,380,675
162,162,,43,24,67,91
163,163,,3,723,609,1332
164,164,,3,260,325,585
165,165,,3,41,27,68
166,166,,23,145,189,334
167,167,,23,23,14,37
168,168,,23,64,84,148
169,169,,23,27,13,40
170,170,,43,399,319,718
171,171,,0,196,224,420
172,172,,0,909,1054,1963
173,173,,0,6,45,51
174,174,,31,73,38,111
175,175,,5,13,105,118
176,176,,5,104,33,137
177,177,,23,215,352,567
178,178,,23,75,123,198
179,179,,6,405,259,664
180,180,,24,2,6,8
181,181,,24,1,0,1
182,182,,8,935,865,1800
183,183,,8,186,89,275
184,184,,8,21,51,72
185,185,,8,15,3,18
186,186,,8,5,3,8
187,187,,31,1463,801,2264
188,188,,31,19,10,29
189,189,,43,267,233,500
190,190,,0,215,289,504
191,191,,0,3342,782,4124
192,192,,23,0,1,1
193,193,,23,2,1,3
194,194,,8,7,3,10
195,195,,8,0,4,4
196,196,,8,31,13,44
197,197,,0,16,72,88
198,198,,0,673,461,1134
199,199,,0,487,365,852
200,200,,0,6,116,122
201,201,,0,765,401,1166
202,202,,45,0,3,3
203,203,,45,11,8,19
204,204,,45,15,31,46
205,205,,45,2,3,5
206,206,,8,4,8,12
207,207,,8,329,101,430
208,208,,8,6,4,10
209,209,,8,1,9,10
210,210,,23,64,263,327
211,211,,43,5,6,11
212,212,,21,3,3,6
213,213,,43,12,13,25
214,214,,43,194,169,363
215,215,,23,9,9,18
216,216,,23,146,48,194
217,217,,23,0,1,1
218,218,,23,22,37,59
219,219,,23,1954,1878,3832
220,220,,8,335,128,463
221,221,,23,761,1149,1910
222,222,,0,21,20,41
223,223,,0,20,21,41
224,224,,23,152,138,290
225,225,,23,36,14,50
226,226,,8,20,10,30
227,227,,8,4,0,4
228,228,,8,77,96,173
229,229,,8,140,116,256
230,230,,31,122,225,347
231,231,,127,9,8,17
232,232,,52,11,18,29
233,233,,52,5,24,29
234,234,,52,632,220,852
235,235,,105,279,128,407
236,236,,23,117,194,311
237,237,,127,64,51,115
238,238,,23,234,441,675
239,239,,23,68,69,137
240,240,,23,1236,737,1973
241,241,,23,15,51,66
242,242,,23,44,28,72
243,243,,8,17,17,34
244,244,,8,7,3,10
245,245,,8,59,31,90
246,246,,8,27,11,38
247,247,,8,49,35,84
248,248,,8,131,55,186
249,249,,31,37,40,77
250,250,,31,104,79,183
251,251,,0,212,343,555
252,252,,23,500,130,630
253,253,,23,29,33,62
254,254,,15,115,171,286
255,255,,18,80,143,223
256,256,,23,102,151,253
257,257,,23,8,7,15
258,258,,23,1143,552,1695
259,259,,23,88,178,266
260,260,,23,2414,2448,4862
261,261,,23,41,158,199
262,262,,14,796,600,1396
263,263,,14,159,85,244
264,264,,21,83,57,140
265,265,,21,764,563,1327
266,266,,15,459,275,734
267,267,,127,3,2,5
268,268,,127,7,3,10
269,269,,45,3,3,6
270,270,,45,69,47,116
271,271,,111,72,112,184
272,272,,111,114,45,159
273,273,,127,0,1,1
274,274,,127,43,5,48
275,275,,43,39,35,74
276,276,,0,2,15,17
277,277,,0,2,0,2
278,278,,23,117,328,445
279,279,,43,253,230,483
280,280,,43,918,555,1473
281,281,,43,3,6,9
282,282,,43,28,15,43
283,283,,43,11,15,26
284,284,,0,5,69,74
285,285,,23,518,215,733
286,286,,0,82,105,187
287,287,,23,269,372,641
288,288,,3,28,35,63
289,289,,127,72,19,91
290,290,,8,33,60,93
291,291,,8,2,0,2
292,292,,3,70,146,216
293,293,,127,43,54,97
294,294,,23,53,148,201
295,295,,45,45,63,108
296,296,,45,140,60,200
297,297,,23,59,113,172
298,298,,43,651,1081,1732
299,299,,23,129,123,252
300,300,,23,932,1152,2084
301,301,,52,84,199,283
302,302,,8,82,168,250
303,303,,8,114,12,126
304,304,,23,5,7,12
305,305,,23,26,76,102
306,306,,23,1103,1458,2561
307,307,,0,367,286,653
308,308,,3,159,29,188
309,309,,0,83,15,98
310,310,,0,21,28,49
311,311,,43,221,160,381
312,312,,23,0,24,24
313,313,,111,297,192,489
314,314,,0,2,8,10
315,315,,0,10,4,14
316,316,,0,97,44,141
317,317,,43,39,47,86
318,318,,23,34,6,40
319,319,,88,282,302,584
320,320,,88,41,54,95
321,321,,23,724,528,1252
322,322,,23,379,318,697
323,323,,0,5,7,12
324,324,,0,96,58,154
325,325,,52,64,19,83
326,326,,52,5,10,15
327,327,,52,57,103,160
328,328,,76,11,20,31
329,329,,76,295,84,379
330,330,,8,7,5,12
331,331,,8,65,102,167
332,332,,88,15,23,38
333,333,,88,4,0,4
334,334,,23,314,154,468
335,335,,8,16,20,36
336,336,,8,172,67,239
337,337,,8,0,11,11
338,338,,23,46,40,86
339,339,,0,712,367,1079
340,340,,0,3,1,4
341,341,,0,19,22,41
342,342,,88,82,120,202
343,343,,88,83,93,176
344,344,,105,35,87,122
345,345,,23,494,640,1134
346,346,,105,6,7,13
347,347,,0,93,162,255
348,348,,0,79,124,203
349,349,,8,225,139,364
350,350,,8,89,38,127
351,351,,21,1,1,2
352,352,,21,39,60,99
353,353,,21,148,290,438
354,354,,21,42,43,85
355,355,,88,7,19,26
356,356,,14,328,183,511
357,357,,14,7,2,9
358,358,,14,131,383,514
359,359,,14,0,1,1
360,360,,14,55,87,142
361,361,,14,10,16,26
362,362,,14,8,7,15
363,363,,21,21,56,77
364,364,,21,2,2,4
365,365,,23,312,243,555
366,366,,127,31,53,84
367,367,,23,691,324,1015
368,368,,45,45,67,112
369,369,,21,2,1,3
370,370,,21,3,3,6
371,371,,0,25,29,54
372,372,,127,3,15,18
373,373,,23,479,576,1055
374,374,,11,446,246,692
375,375,,11,162,298,460
376,376,,43,87,395,482
377,377,,43,9,13,22
378,378,,43,24,34,58
379,379,,43,37,25,62
380,380,,43,205,356,561
381,381,,43,135,209,344
382,382,,43,1180,273,1453
383,383,,23,23,55,78
384,384,,43,19,25,44
385,385,,5,0,3,3
386,386,,3,71,102,173
387,387,,43,412,701,1113
388,388,,23,2,16,18
389,389,,43,7,5,12
390,390,,43,103,44,147
391,391,,43,1025,343,1368
392,392,,43,244,182,426
393,393,,43,20,4,24
394,394,,43,6,14,20
395,395,,43,134,83,217
396,396,,43,208,200,408
397,397,,43,2531,2312,4843
398,398,,76,61,42,103
399,399,,43,122,182,304
400,400,,43,1590,1784,3374
401,401,,43,254,608,862
402,402,,43,43,126,169
403,403,,43,186,171,357
404,404,,43,27,66,93
405,405,,43,386,801,1187
406,406,,43,1235,1892,3127
407,407,,43,318,176,494
408,408,,8,285,149,434
409,409,,43,1,7,8
410,410,,23,13,9,22
411,411,,43,53,105,158
412,412,,43,2,2,4
413,413,,43,130,234,364
414,414,,43,580,560,1140
415,415,,43,225,343,568
416,416,,43,23,40,63
417,417,,43,78,152,230
418,418,,15,2,1,3
419,419,,15,1,0,1
420,420,,11,38,65,103
421,421,,11,2,0,2
422,422,,23,119,138,257
423,423,,23,605,360,965
424,424,,88,221,153,374
425,425,,23,123,171,294
426,426,,88,136,173,309
427,427,,23,195,354,549
428,428,,23,807,629,1436
429,429,,23,379,276,655
430,430,,14,106,194,300
431,431,,21,480,289,769
432,432,,88,1,0,1
433,433,,14,177,75,252
434,434,,14,1,23,24
435,435,,23,221,107,328
436,436,,23,78,66,144
437,437,,127,221,141,362
438,438,,127,165,111,276
439,439,,31,52,163,215
440,440,,31,25,10,35
441,441,,8,31,36,67
442,442,,105,102,134,236
443,443,,43,59,44,103
444,444,,43,99,177,276
445,445,,43,918,1891,2809
446,446,,43,82,8,90
447,447,,23,17,25,42
448,448,,21,41,21,62
449,449,,21,276,177,453
450,450,,21,39,53,92
451,451,,21,524,303,827
452,452,,43,38,39,77
453,453,,43,823,384,1207
454,454,,43,902,662,1564
455,455,,43,1033,1703,2736
456,456,,21,120,188,308
457,457,,21,17,16,33
458,458,,14,455,324,779
459,459,,14,288,208,496
460,460,,8,551,334,885
461,461,,14,23,18,41
462,462,,8,28,57,85
463,463,,14,92,278,370
464,464,,14,48,28,76
465,465,,14,46,19,65
466,466,,14,101,209,310
467,467,,14,33,26,59
468,468,,14,62,87,149
469,469,,127,178,165,343
470,470,,127,217,220,437
471,471,,14,222,75,297
472,472,,23,22,2,24
473,473,,43,144,142,286
474,474,,23,296,281,577
475,475,,120,47,88,135
476,476,,23,38,172,210
477,477,,43,649,472,1121
478,478,,43,1,0,1
479,479,,43,142,278,420
480,480,,43,134,264,398
481,481,,43,15,72,87
482,482,,43,15,18,33
483,483,,43,1,0,1
484,484,,43,0,1,1
485,485,,43,212,100,312
486,486,,23,874,1161,2035
487,487,,88,149,196,345
488,488,,23,28,48,76
489,489,,66,184,106,290
490,490,,23,0,7,7
491,491,,23,96,51,147
492,492,,52,12,31,43
493,493,,52,1,0,1
494,494,,8,87,110,197
495,495,,52,22,34,56
496,496,,23,1,3,4
497,497,,14,6,3,9
498,498,,21,6,20,26
499,499,,0,1,4,5
500,500,,0,29,60,89
501,501,,0,23,40,63
502,502,,0,5,2,7
503,503,,0,6,17,23
504,504,,105,27,20,47
505,505,,23,8,4,12
506,506,,0,1,1,2
507,507,,23,33,33,66
508,508,,23,187,160,347
509,509,,127,49,18,67
510,510,,0,1,14,15
511,511,,23,414,706,1120
512,512,,23,325,542,867
513,513,,23,124,165,289
514,514,,105,289,169,458
515,515,,111,177,272,449
516,516,,111,63,13,76
517,517,,111,7,71,78
518,518,,111,125,81,206
519,519,,111,14,30,44
520,520,,111,92,52,144
521,521,,23,9,16,25
522,522,,111,6,28,34
523,523,,76,126,151,277
524,524,,76,837,600,1437
525,525,,76,15,75,90
526,526,,76,82,27,109
527,527,,111,30,8,38
528,528,,111,49,75,124
529,529,,111,466,277,743
530,530,,23,405,442,847
531,531,,3,0,4,4
532,532,,3,2,0,2
533,533,,3,16,10,26
534,534,,3,216,155,371
535,535,,3,10,23,33
536,536,,3,41,55,96
537,537,,23,348,183,531
538,538,,23,22,23,45
539,539,,88,77,254,331
540,540,,111,2,2,4
541,541,,43,6,19,25
542,542,,105,8,16,24
543,543,,105,1,1,2
544,544,,21,88,185,273
545,545,,21,152,171,323
546,546,,8,82,137,219
547,547,,31,4,10,14
548,548,,31,270,250,520
549,549,,31,19,33,52
550,550,,31,32,49,81
551,551,,31,135,34,169
552,552,,31,57,16,73
553,553,,52,16,23,39
554,554,,52,3,8,11
555,555,,120,26,53,79
556,556,,21,3,20,23
557,557,,21,12,19,31
558,558,,0,21,34,55
559,559,,23,50,70,120
560,560,,15,4,1,5
561,561,,105,24,22,46
562,562,,14,127,22,149
563,563,,14,37,236,273
564,564,,14,196,83,279
565,565,,43,109,469,578
566,566,,43,3,6,9
567,567,,43,10,30,40
568,568,,31,687,256,943
569,569,,8,5,5,10
570,570,,8,15,5,20
571,571,,31,1,10,11
572,572,,23,46,49,95
573,573,,43,206,159,365
574,574,,43,410,413,823
575,575,,52,73,43,116
576,576,,105,80,64,144
577,577,,31,249,171,420
578,578,,31,34,9,43
579,579,,31,243,386,629
580,580,,8,4,2,6
581,581,,8,119,90,209
582,582,,8,13,31,44
583,583,,8,42,41,83
584,584,,0,33,27,60
585,585,,23,92,150,242
586,586,,23,37,40,77
587,587,,43,74,121,195
588,588,,43,223,266,489
589,589,,8,75,279,354
590,590,,8,1,0,1
591,591,,23,46,129,175
592,592,,23,668,506,1174
593,593,,23,41,43,84
594,594,,23,5,23,28
595,595,,23,54,114,168
596,596,,23,213,336,549
597,597,,0,9,40,49
598,598,,18,545,394,939
599,599,,43,29,60,89
600,600,,23,525,437,962
601,601,,23,9,33,42
602,602,,0,2,11,13
603,603,,23,11,7,18
604,604,,0,35,42,77
605,605,,14,10,2,12
606,606,,14,23,54,77
607,607,,14,9,6,15
608,608,,43,147,128,275
609,609,,21,57,67,124
610,610,,23,274,229,503
611,611,,127,177,194,371
612,612,,127,405,308,713
613,613,,43,151,237,388
614,614,,8,16,18,34
615,615,,23,14,9,23
616,616,,31,9,37,46
617,617,,31,0,7,7
618,618,,31,91,136,227
619,619,,31,0,6,6
620,620,,31,21,58,79
621,621,,31,181,298,479
622,622,,31,47,117,164
623,623,,31,2,0,2
624,624,,31,108,88,196
625,625,,31,94,181,275
626,626,,31,113,149,262
627,627,,8,533,259,792
628,628,,105,26,51,77
629,629,,120,54,24,78
630,630,,43,11,73,84
631,631,,0,37,89,126
632,632,,105,8,42,50
633,633,,105,32,24,56
634,634,,23,45,79,124
635,635,,0,55,50,105
636,636,,23,2068,1614,3682
637,637,,31,9,20,29
638,638,,31,7,13,20
639,639,,8,3,2,5
640,640,,8,20,45,65
641,641,,43,181,262,443
642,642,,23,183,480,663
643,643,,105,1,9,10
644,644,,105,10,34,44
645,645,,23,23,8,31
646,646,,6,166,106,272
647,647,,23,580,328,908
648,648,,127,36,26,62
649,649,,127,3,0,3
650,650,,127,0,1,1
651,651,,23,19,5,24
652,652,,23,0,2,2
653,653,,23,3,1,4
654,654,,105,0,1,1
655,655,,105,63,143,206
656,656,,18,389,313,702
657,657,,23,9,6,15
658,658,,31,22,12,34
659,659,,14,4,51,55
660,660,,14,91,34,125
661,661,,8,707,637,1344
662,662,,23,23,258,281
663,663,,23,185,343,528
664,664,,0,294,255,549
665,665,,0,3,7,10
666,666,,23,71,100,171
667,667,,31,1,12,13
668,668,,8,8,2,10
669,669,,14,11,2,13
670,670,,23,18,46,64
671,671,,45,0,1,1
672,672,,45,45,34,79
673,673,,23,4,5,9
674,674,,8,19,10,29
675,675,,31,43,24,67
676,676,,31,3,3,6
677,677,,31,3,1,4
678,678,,111,1,2,3
679,679,,111,28,11,39
680,680,,111,3,3,6
681,681,,111,289,329,618
682,682,,43,53,188,241
683,683,,127,6,18,24
684,684,,127,186,127,313
685,685,,11,25,55,80
686,686,,11,14,10,24
687,687,,11,30,34,64
688,688,,5,1,1,2
689,689,,0,19,9,28
690,690,,18,19,22,41
691,691,,18,36,43,79
692,692,,18,90,155,245
693,693,,31,5,30,35
694,694,,88,368,224,592
695,695,,8,0,4,4
696,696,,23,11,3,14
697,697,,23,13,24,37
698,698,,76,265,214,479
699,699,,8,4,3,7
700,700,,43,9,4,13
701,701,,105,127,126,253
702,702,,0,22,67,89
703,703,,0,16,6,22
704,704,,0,3,47,50
705,705,,23,270,229,499
706,706,,8,24,12,36
707,707,,8,0,9,9
708,708,,21,8,10,18
709,709,,21,49,72,121
710,710,,105,1,11,12
711,711,,23,103,62,165
712,712,,31,25,11,36
713,713,,111,4,15,19
714,714,,31,4,1,5
715,715,,31,20,28,48
716,716,,15,65,63,128
717,717,,105,7,23,30
718,718,,8,25,20,45
719,719,,14,604,447,1051
720,720,,14,16,30,46
721,721,,14,7,1,8
722,722,,23,6,21,27
723,723,,23,12,17,29
724,724,,23,2,0,2
725,725,,0,75,233,308
726,726,,0,1,0,1
727,727,,23,2,2,4
728,728,,88,17,137,154
729,729,,23,763,719,1482
730,730,,8,9,13,22
731,731,,23,10,28,38
732,732,,23,160,11,171
733,733,,31,6,12,18
734,734,,31,102,224,326
735,735,,11,425,159,584
736,736,,11,51,2,53
737,737,,0,4,6,10
738,738,,23,10,26,36
739,739,,23,4,13,17
740,740,,23,67,45,112
741,741,,0,353,257,610
742,742,,8,39,6,45
743,743,,8,20,27,47
744,744,,8,15,11,26
745,745,,8,103,98,201
746,746,,8,63,25,88
747,747,,11,28,13,41
748,748,,127,36,23,59
749,749,,18,53,18,71
750,750,,23,25,26,51
751,751,,45,46,33,79
752,752,,45,8,14,22
753,753,,8,3,19,22
754,754,,8,84,34,118
755,755,,31,0,4,4
756,756,,105,14,28,42
757,757,,0,69,47,116
758,758,,23,21,27,48
759,759,,43,0,5,5
760,760,,8,9,14,23
761,761,,31,2,15,17
762,762,,8,2,8,10
763,763,,105,137,150,287
764,764,,8,0,13,13
765,765,,43,332,907,1239
766,766,,43,26,38,64
767,767,,127,1,6,7
768,768,,15,19,52,71
769,769,,15,404,271,675
770,770,,0,0,33,33
771,771,,0,72,42,114
772,772,,0,2,0,2
773,773,,0,3,80,83
774,774,,0,67,62,129
775,775,,23,51,113,164
776,776,,0,26,19,45
777,777,,23,143,145,288
778,778,,8,11,9,20
779,779,,8,81,44,125
780,780,,8,39,31,70
781,781,,45,116,101,217
782,782,,3,306,214,520
783,783,,76,187,192,379
784,784,,23,231,180,411
785,785,,52,2,18,20
786,786,,23,0,6,6
787,787,,23,687,1169,1856
788,788,,23,93,236,329
789,789,,43,164,448,612
790,790,,43,47,50,97
791,791,,11,85,36,121
792,792,,11,21,9,30
793,793,,11,0,1,1
794,794,,23,35,61,96
795,795,,0,2,7,9
796,796,,0,34,15,49
797,797,,8,0,2,2
798,798,,23,42,114,156
799,799,,23,5,6,11
800,800,,43,11,21,32
801,801,,23,3,7,10
802,802,,23,1640,1476,3116
803,803,,127,3,0,3
804,804,,127,3,10,13
805,805,,21,14,6,20
806,806,,88,65,22,87
807,807,,11,161,77,238
808,808,,11,13,18,31
809,809,,11,13,16,29
810,810,,11,55,49,104
811,811,,23,114,252,366
812,812,,8,5,5,10
813,813,,8,36,9,45
814,814,,8,5,23,28
815,815,,23,50,95,145
816,816,,23,16,24,40
817,817,,0,4,0,4
818,818,,8,3,5,8
819,819,,8,23,29,52
820,820,,31,47,26,73
821,821,,31,31,26,57
822,822,,3,42,20,62
823,823,,3,77,76,153
824,824,,23,12,18,30
825,825,,105,12,21,33
826,826,,105,88,144,232
827,827,,0,18,13,31
828,828,,18,5,6,11
829,829,,18,102,77,179
830,830,,23,0,4,4
831,831,,8,176,61,237
832,832,,8,44,62,106
833,833,,8,77,65,142
834,834,,8,15,21,36
835,835,,8,19,14,33
836,836,,8,5,2,7
837,837,,66,1,2,3
838,838,,23,88,61,149
839,839,,43,577,1144,1721
840,840,,8,5,5,10
841,841,,88,18,7,25
842,842,,0,80,138,218
843,843,,23,80,3,83
844,844,,23,354,196,550
845,845,,23,40,200,240
846,846,,15,4,3,7
847,847,,31,101,91,192
848,848,,23,62,53,115
849,849,,8,374,292,666
850,850,,8,42,71,113
851,851,,8,622,449,1071
852,852,,127,1,2,3
853,853,,8,0,1,1
854,854,,23,1,3,4
855,855,,23,0,1,1
856,856,,21,7,7,14
857,857,,127,2,1,3
858,858,,127,17,8,25
859,859,,1,0,1,1
860,860,,1,1,0,1
861,861,,43,0,1,1
862,862,,111,13,13,26
863,863,,23,24,59,83
864,864,,23,1,4,5
865,865,,23,13,130,143
866,866,,43,103,41,144
867,867,,127,10,3,13
868,868,,127,1,0,1
869,869,,127,4,22,26
870,870,,88,7,5,12
871,871,,88,4,7,11
872,872,,88,28,95,123
873,873,,43,29,111,140
874,874,,11,35,20,55
875,875,,11,5,0,5
876,876,,45,21,5,26
877,877,,45,14,3,17
878,878,,23,58,46,104
879,879,,5,150,26,176
880,880,,127,11,12,23
881,881,,8,23,6,29
882,882,,43,224,392,616
883,883,,23,16,24,40
884,884,,0,67,77,144
885,885,,45,0,1,1
886,886,,43,119,61,180
887,887,,5,107,209,316
888,888,,5,107,37,144
889,889,,23,1,2,3
890,890,,88,1,0,1
891,891,,8,34,35,69
892,892,,8,4,2,6
893,893,,52,14,95,109
894,894,,52,26,56,82
895,895,,52,4,9,13
896,896,,52,1,0,1
897,897,,111,373,192,565
898,898,,111,1,1,2
899,899,,8,7,31,38
900,900,,8,1,2,3
901,901,,8,64,18,82
902,902,,111,4,2,6
903,903,,15,4,0,4
904,904,,3,30,126,156
905,905,,43,7,4,11
906,906,,23,279,531,810
907,907,,8,9,50,59
908,908,,8,0,2,2
909,909,,31,13,28,41
910,910,,23,2,1,3
911,911,,0,166,173,339
912,912,,0,120,85,205
913,913,,21,0,2,2
914,914,,21,19,13,32
915,915,,43,254,462,716
916,916,,43,163,87,250
917,917,,23,28,21,49
918,918,,23,8,3,11
919,919,,23,41,183,224
920,920,,15,81,59,140
921,921,,15,46,78,124
922,922,,15,27,38,65
923,923,,15,4,1,5
924,924,,23,92,142,234
925,925,,8,10,23,33
926,926,,8,4,6,10
927,927,,21,6,6,12
928,928,,52,170,58,228
929,929,,14,5,4,9
930,930,,14,23,12,35
931,931,,23,0,1,1
932,932,,23,0,5,5
933,933,,14,6,12,18
934,934,,3,1,1,2
935,935,,3,98,79,177
936,936,,23,3,1,4
937,937,,23,7,8,15
938,938,,23,2,1,3
939,939,,8,107,27,134
940,940,,8,9,27,36
941,941,,31,8,31,39
942,942,,23,8,10,18
943,943,,127,10,16,26
944,944,,43,22,28,50
945,945,,8,10,42,52
946,946,,0,2,5,7
947,947,,0,299,153,452
948,948,,14,207,145,352
949,949,,14,37,50,87
950,950,,43,14,81,95
951,951,,43,282,509,791
952,952,,43,125,238,363
953,953,,43,6,6,12
954,954,,43,18,29,47
955,955,,43,16,59,75
956,956,,45,76,54,130
957,957,,43,32,72,104
958,958,,43,164,259,423
959,959,,43,437,217,654
960,960,,43,112,121,233
961,961,,43,48,42,90
962,962,,43,508,378,886
963,963,,43,41,61,102
964,964,,43,96,232,328
965,965,,43,2,5,7
966,966,,43,23,25,48
967,967,,43,65,50,115
968,968,,43,29,18,47
969,969,,23,1,0,1
970,970,,23,86,39,125
971,971,,23,12,214,226
972,972,,23,152,196,348
973,973,,0,0,1,1
974,974,,0,5,4,9
975,975,,0,7,35,42
976,976,,0,156,71,227
977,977,,0,617,346,963
978,978,,0,11,22,33
979,979,,0,216,149,365
980,980,,0,9,4,13
981,981,,21,0,6,6
982,982,,21,16,19,35
983,983,,0,2,6,8
984,984,,0,5,5,10
985,985,,0,80,77,157
986,986,,127,79,76,155
987,987,,14,25,43,68
988,988,,21,105,52,157
989,989,,21,170,84,254
990,990,,105,23,9,32
991,991,,5,27,3,30
992,992,,8,4,14,18
993,993,,14,9,13,22
994,994,,14,3,1,4
995,995,,14,2,2,4
996,996,,88,7,1,8
997,997,,14,12,11,23
998,998,,21,34,34,68
999,999,,21,79,84,163
1000,1000,,3,119,157,276
1001,1001,,3,10,11,21
1002,1002,,52,12,24,36
1003,1003,,52,133,26,159
1004,1004,,21,10,2,12
1005,1005,,8,24,47,71
1006,1006,,8,4,0,4
1007,1007,,5,9,17,26
1008,1008,,23,0,1,1
1009,1009,,23,60,122,182
1010,1010,,127,1,11,12
1011,1011,,127,6,4,10
1012,1012,,127,14,15,29
1013,1013,,88,235,271,506
1014,1014,,88,1,6,7
1015,1015,,88,26,72,98
1016,1016,,88,45,61,106
1017,1017,,43,13,81,94
1018,1018,,43,226,386,612
1019,1019,,23,386,161,547
1020,1020,,43,330,123,453
1021,1021,,43,23,14,37
1022,1022,,43,32,104,136
1023,1023,,3,0,1,1
1024,1024,,3,25,9,34
1025,1025,,43,109,105,214
1026,1026,,21,68,42,110
1027,1027,,14,20,26,46
1028,1028,,14,2,13,15
1029,1029,,14,6,2,8
1030,1030,,11,8,37,45
1031,1031,,11,7,1,8
1032,1032,,43,20,21,41
1033,1033,,14,25,40,65
1034,1034,,43,5,1,6
1035,1035,,43,14,31,45
1036,1036,,43,213,236,449
1037,1037,,43,64,85,149
1038,1038,,43,0,1,1
1039,1039,,43,10,24,34
1040,1040,,43,5,34,39
1041,1041,,43,34,78,112
1042,1042,,43,12,35,47
1043,1043,,43,89,191,280
1044,1044,,43,29,58,87
1045,1045,,43,10,44,54
1046,1046,,23,40,63,103
1047,1047,,127,9,13,22
1048,1048,,127,1,2,3
1049,1049,,31,49,17,66
1050,1050,,3,5,26,31
1051,1051,,3,83,72,155
1052,1052,,127,10,10,20
1053,1053,,127,38,41,79
1054,1054,,14,19,32,51
1055,1055,,120,32,38,70
1056,1056,,21,390,452,842
1057,1057,,21,160,110,270
1058,1058,,0,1,8,9
1059,1059,,0,9,5,14
1060,1060,,0,16,20,36
1061,1061,,0,38,49,87
1062,1062,,23,2,1,3
1063,1063,,23,270,503,773
1064,1064,,14,15,2,17
1065,1065,,14,13,16,29
1066,1066,,52,107,130,237
1067,1067,,52,80,253,333
1068,1068,,52,45,190,235
1069,1069,,111,0,2,2
1070,1070,,76,285,133,418
1071,1071,,76,17,9,26
1072,1072,,76,19,7,26
1073,1073,,76,7,4,11
1074,1074,,76,67,74,141
1075,1075,,23,13,31,44
1076,1076,,88,29,11,40
1077,1077,,3,4,10,14
1078,1078,,3,38,14,52
1079,1079,,3,29,30,59
1080,1080,,23,14,19,33
1081,1081,,105,18,33,51
1082,1082,,23,208,160,368
1083,1083,,14,6,33,39
1084,1084,,23,0,4,4
1085,1085,,31,7,0,7
1086,1086,,31,70,76,146
1087,1087,,31,46,15,61
1088,1088,,31,16,30,46
1089,1089,,0,339,377,716
1090,1090,,105,0,1,1
1091,1091,,105,4,3,7
1092,1092,,23,2,74,76
1093,1093,,23,233,282,515
1094,1094,,23,16,11,27
1095,1095,,23,12,114,126
1096,1096,,127,18,41,59
1097,1097,,127,5,11,16
1098,1098,,127,2,2,4
1099,1099,,23,133,215,348
1100,1100,,14,21,40,61
1101,1101,,23,189,369,558
1102,1102,,31,60,147,207
1103,1103,,127,73,340,413
1104,1104,,127,146,20,166
1105,1105,,23,4,8,12
1106,1106,,23,39,103,142
1107,1107,,23,13,5,18
1108,1108,,18,0,2,2
1109,1109,,18,2,1,3
1110,1110,,15,51,84,135
1111,1111,,15,107,24,131
1112,1112,,23,1,0,1
1113,1113,,14,2,4,6
1114,1114,,14,4,1,5
1115,1115,,120,10,11,21
1116,1116,,120,46,94,140
1117,1117,,23,0,16,16
1118,1118,,23,10,39,49
1119,1119,,31,9,37,46
1120,1120,,15,28,26,54
1121,1121,,18,5,11,16
1122,1122,,43,13,22,35
1123,1123,,43,107,157,264
1124,1124,,127,0,8,8
1125,1125,,23,448,158,606
1126,1126,,127,30,16,46
1127,1127,,127,47,52,99
1128,1128,,43,4,8,12
1129,1129,,31,11,52,63
1130,1130,,31,58,34,92
1131,1131,,127,203,255,458
1132,1132,,43,65,185,250
1133,1133,,8,15,38,53
1134,1134,,8,14,8,22
1135,1135,,14,0,5,5
1136,1136,,105,42,50,92
1137,1137,,5,645,417,1062
1138,1138,,127,99,81,180
1139,1139,,127,25,56,81
1140,1140,,127,5,15,20
1141,1141,,31,3,9,12
1142,1142,,88,47,47,94
1143,1143,,8,13,23,36
1144,1144,,127,3,2,5
1145,1145,,31,0,2,2
1146,1146,,15,5,14,19
1147,1147,,111,30,31,61
1148,1148,,111,0,1,1
1149,1149,,111,0,6,6
1150,1150,,111,17,41,58
1151,1151,,111,72,39,111
1152,1152,,31,237,145,382
1153,1153,,14,6,6,12
1154,1154,,0,56,73,129
1155,1155,,127,1,1,2
1156,1156,,127,0,4,4
1157,1157,,127,4,5,9
1158,1158,,31,1,5,6
1159,1159,,31,0,4,4
1160,1160,,31,92,17,109
1161,1161,,31,11,13,24
1162,1162,,15,7,15,22
1163,1163,,8,12,19,31
1164,1164,,8,2,0,2
1165,1165,,18,1,1,2
1166,1166,,18,7,7,14
1167,1167,,111,1,2,3
1168,1168,,111,5,47,52
1169,1169,,21,1,4,5
1170,1170,,21,1,4,5
1171,1171,,111,60,101,161
1172,1172,,111,28,3,31
1173,1173,,14,0,3,3
1174,1174,,23,6,70,76
1175,1175,,52,59,21,80
1176,1176,,8,17,30,47
1177,1177,,2,0,1,1
1178,1178,,2,1,0,1
1179,1179,,76,12,38,50
1180,1180,,76,62,68,130
1181,1181,,76,37,26,63
1182,1182,,76,35,19,54
1183,1183,,76,29,30,59
1184,1184,,76,13,58,71
1185,1185,,23,2,7,9
1186,1186,,11,63,102,165
1187,1187,,11,1,0,1
1188,1188,,8,28,0,28
1189,1189,,23,0,2,2
1190,1190,,8,2,3,5
1191,1191,,8,54,15,69
1192,1192,,8,1,13,14
1193,1193,,8,71,43,114
1194,1194,,23,8,6,14
1195,1195,,8,3,2,5
1196,1196,,8,32,22,54
1197,1197,,127,3,10,13
1198,1198,,23,4,111,115
1199,1199,,105,15,27,42
1200,1200,,0,15,19,34
1201,1201,,8,13,42,55
1202,1202,,43,141,120,261
1203,1203,,23,32,41,73
1204,1204,,23,70,149,219
1205,1205,,88,73,77,150
1206,1206,,127,2,7,9
1207,1207,,127,7,12,19
1208,1208,,76,16,11,27
1209,1209,,76,1,5,6
1210,1210,,43,23,70,93
1211,1211,,43,13,10,23
1212,1212,,43,334,429,763
1213,1213,,23,11,17,28
1214,1214,,23,48,71,119
1215,1215,,23,4,16,20
1216,1216,,23,29,16,45
1217,1217,,23,0,1,1
1218,1218,,15,5,13,18
1219,1219,,15,88,59,147
1220,1220,,127,3,2,5
1221,1221,,127,0,3,3
1222,1222,,31,8,5,13
1223,1223,,111,33,18,51
1224,1224,,23,103,21,124
1225,1225,,8,25,2,27
1226,1226,,23,0,5,5
1227,1227,,15,162,294,456
1228,1228,,15,8,24,32
1229,1229,,23,91,88,179
1230,1230,,15,47,31,78
1231,1231,,15,2,0,2
1232,1232,,15,31,67,98
1233,1233,,0,234,346,580
1234,1234,,8,42,72,114
1235,1235,,0,334,448,782
1236,1236,,0,12,10,22
1237,1237,,23,30,46,76
1238,1238,,23,33,59,92
1239,1239,,3,63,17,80
1240,1240,,0,0,23,23
1241,1241,,43,296,298,594
1242,1242,,111,9,18,27
1243,1243,,8,43,75,118
1244,1244,,8,75,59,134
1245,1245,,23,0,6,6
1246,1246,,23,49,72,121
1247,1247,,0,3,0,3
1248,1248,,8,58,61,119
1249,1249,,23,0,13,13
1250,1250,,31,33,30,63
1251,1251,,31,6,16,22
1252,1252,,31,40,94,134
1253,1253,,11,9,46,55
1254,1254,,11,156,122,278
1255,1255,,23,112,110,222
1256,1256,,105,8,3,11
1257,1257,,8,34,22,56
1258,1258,,23,1,0,1
1259,1259,,43,3,16,19
1260,1260,,43,6,30,36
1261,1261,,31,15,41,56
1262,1262,,24,13,19,32
1263,1263,,24,84,63,147
1264,1264,,23,90,54,144
1265,1265,,23,3,0,3
1266,1266,,6,76,82,158
1267,1267,,8,23,57,80
1268,1268,,8,38,87,125
1269,1269,,23,11,19,30
1270,1270,,8,47,55,102
1271,1271,,23,139,261,400
1272,1272,,23,52,78,130
1273,1273,,23,25,79,104
1274,1274,,23,46,48,94
1275,1275,,3,11,6,17
1276,1276,,3,96,69,165
1277,1277,,8,198,70,268
1278,1278,,8,4,2,6
1279,1279,,43,72,108,180
1280,1280,,8,90,39,129
1281,1281,,8,81,187,268
1282,1282,,3,84,57,141
1283,1283,,3,380,286,666
1284,1284,,3,2,4,6
1285,1285,,3,27,15,42
1286,1286,,3,3,7,10
1287,1287,,0,9,11,20
1288,1288,,23,14,12,26
1289,1289,,3,19,89,108
1290,1290,,43,1,8,9
1291,1291,,23,9,7,16
1292,1292,,31,19,32,51
1293,1293,,14,0,12,12
1294,1294,,127,64,34,98
1295,1295,,8,4,3,7
1296,1296,,23,81,68,149
1297,1297,,127,28,39,67
1298,1298,,23,40,87,127
1299,1299,,24,39,57,96
1300,1300,,24,5,15,20
1301,1301,,88,7,26,33
1302,1302,,8,2,5,7
1303,1303,,43,0,6,6
1304,1304,,23,106,75,181
1305,1305,,23,16,35,51
1306,1306,,23,41,100,141
1307,1307,,23,6,18,24
1308,1308,,0,24,21,45
1309,1309,,43,9,8,17
1310,1310,,0,6,6,12
1311,1311,,0,9,12,21
1312,1312,,21,6,14,20
1313,1313,,21,43,55,98
1314,1314,,66,9,50,59
1315,1315,,66,6,3,9
1316,1316,,23,2,4,6
1317,1317,,23,53,35,88
1318,1318,,111,2,4,6
1319,1319,,127,0,2,2
1320,1320,,127,111,60,171
1321,1321,,43,10,7,17
1322,1322,,4,1,2,3
1323,1323,,23,13,42,55
1324,1324,,127,3,17,20
1325,1325,,23,13,29,42
1326,1326,,3,4,21,25
1327,1327,,21,2,4,6
1328,1328,,8,1,1,2
1329,1329,,21,61,105,166
1330,1330,,21,1,1,2
1331,1331,,0,12,53,65
1332,1332,,11,3,1,4
1333,1333,,23,18,22,40
1334,1334,,31,7,3,10
1335,1335,,31,22,42,64
1336,1336,,0,17,25,42
1337,1337,,23,2,77,79
1338,1338,,23,17,25,42
1339,1339,,24,179,121,300
1340,1340,,24,223,129,352
1341,1341,,23,2,2,4
1342,1342,,23,33,20,53
1343,1343,,23,14,12,26
1344,1344,,8,4,9,13
1345,1345,,8,7,14,21
1346,1346,,52,37,43,80
1347,1347,,52,19,20,39
1348,1348,,0,14,7,21
1349,1349,,52,1,1,2
1350,1350,,23,46,80,126
1351,1351,,3,68,48,116
1352,1352,,76,14,11,25
1353,1353,,76,6,9,15
1354,1354,,0,74,82,156
1355,1355,,105,299,211,510
1356,1356,,105,1,0,1
1357,1357,,23,25,62,87
1358,1358,,23,15,26,41
1359,1359,,21,1,2,3
1360,1360,,66,30,92,122
1361,1361,,66,6,8,14
1362,1362,,43,92,28,120
1363,1363,,18,0,2,2
1364,1364,,18,34,29,63
1365,1365,,0,109,157,266
1366,1366,,0,1,1,2
1367,1367,,23,20,51,71
1368,1368,,8,11,4,15
1369,1369,,8,4,1,5
1370,1370,,8,2,1,3
1371,1371,,8,2,5,7
1372,1372,,8,9,10,19
1373,1373,,11,8,23,31
1374,1374,,11,2,3,5
1375,1375,,111,1,1,2
1376,1376,,111,2,0,2
1377,1377,,111,5,17,22
1378,1378,,23,22,50,72
1379,1379,,23,66,141,207
1380,1380,,0,10,10,20
1381,1381,,3,7,5,12
1382,1382,,3,76,106,182
1383,1383,,66,42,20,62
1384,1384,,23,10,18,28
1385,1385,,8,7,19,26
1386,1386,,8,1,21,22
1387,1387,,8,431,140,571
1388,1388,,0,4,14,18
1389,1389,,88,106,97,203
1390,1390,,43,1,1,2
1391,1391,,8,33,45,78
1392,1392,,8,51,62,113
1393,1393,,23,63,30,93
1394,1394,,23,22,38,60
1395,1395,,23,5,7,12
1396,1396,,15,36,69,105
1397,1397,,23,103,220,323
1398,1398,,23,118,245,363
1399,1399,,21,5,8,13
1400,1400,,45,89,73,162
1401,1401,,0,0,17,17
1402,1402,,0,1,0,1
1403,1403,,0,28,28,56
1404,1404,,31,19,73,92
1405,1405,,0,64,63,127
1406,1406,,66,12,36,48
1407,1407,,66,5,1,6
1408,1408,,3,0,1,1
1409,1409,,127,5,6,11
1410,1410,,11,7,8,15
1411,1411,,11,13,27,40
1412,1412,,11,13,12,25
1413,1413,,11,106,68,174
1414,1414,,23,25,23,48
1415,1415,,23,95,158,253
1416,1416,,23,0,1,1
1417,1417,,11,1,46,47
1418,1418,,23,730,494,1224
1419,1419,,111,0,2,2
1420,1420,,111,3,0,3
1421,1421,,0,14,9,23
1422,1422,,23,0,1,1
1423,1423,,23,3,0,3
1424,1424,,23,29,27,56
1425,1425,,21,2,6,8
1426,1426,,23,11,9,20
1427,1427,,21,30,22,52
1428,1428,,21,183,126,309
1429,1429,,3,67,146,213
1430,1430,,66,8,16,24
1431,1431,,66,10,17,27
1432,1432,,21,7,8,15
1433,1433,,23,8,7,15
1434,1434,,8,0,2,2
1435,1435,,8,3,0,3
1436,1436,,23,1,0,1
1437,1437,,23,35,54,89
1438,1438,,0,175,158,333
1439,1439,,23,2,13,15
1440,1440,,23,0,20,20
1441,1441,,21,1,3,4
1442,1442,,21,1,0,1
1443,1443,,43,23,51,74
1444,1444,,43,187,186,373
1445,1445,,105,10,10,20
1446,1446,,105,12,24,36
1447,1447,,105,24,15,39
1448,1448,,105,30,61,91
1449,1449,,43,56,101,157
1450,1450,,43,44,31,75
1451,1451,,43,6,16,22
1452,1452,,11,55,136,191
1453,1453,,11,421,361,782
1454,1454,,43,49,42,91
1455,1455,,43,29,25,54
1456,1456,,43,21,162,183
1457,1457,,43,143,193,336
1458,1458,,43,124,177,301
1459,1459,,43,12,8,20
1460,1460,,43,2,7,9
1461,1461,,105,127,111,238
1462,1462,,43,2,3,5
1463,1463,,43,16,87,103
1464,1464,,43,5,23,28
1465,1465,,43,49,77,126
1466,1466,,105,15,5,20
1467,1467,,8,31,11,42
1468,1468,,8,1,21,22
1469,1469,,8,11,5,16
1470,1470,,23,10,16,26
1471,1471,,14,2,16,18
1472,1472,,14,2,1,3
1473,1473,,14,14,5,19
1474,1474,,14,49,14,63
1475,1475,,21,149,234,383
1476,1476,,21,2,0,2
1477,1477,,3,1,16,17
1478,1478,,23,33,59,92
1479,1479,,23,44,99,143
1480,1480,,0,5,10,15
1481,1481,,0,31,5,36
1482,1482,,0,5,8,13
1483,1483,,23,16,5,21
1484,1484,,88,2,6,8
1485,1485,,88,2,1,3
1486,1486,,66,13,1,14
1487,1487,,120,25,168,193
1488,1488,,120,51,16,67
1489,1489,,66,3,9,12
1490,1490,,3,13,36,49
1491,1491,,120,2,4,6
1492,1492,,23,30,13,43
1493,1493,,8,28,18,46
1494,1494,,14,5,11,16
1495,1495,,88,13,16,29
1496,1496,,127,58,20,78
1497,1497,,23,122,181,303
1498,1498,,127,10,10,20
1499,1499,,23,22,15,37
1500,1500,,0,17,16,33
1501,1501,,5,119,355,474
1502,1502,,14,17,11,28
1503,1503,,14,3,6,9
1504,1504,,43,12,16,28
1505,1505,,43,103,177,280
1506,1506,,23,7,12,19
1507,1507,,127,1,3,4
1508,1508,,120,53,31,84
1509,1509,,43,192,82,274
1510,1510,,43,86,134,220
1511,1511,,43,42,20,62
1512,1512,,43,34,76,110
1513,1513,,23,69,119,188
1514,1514,,43,0,4,4
1515,1515,,43,297,210,507
1516,1516,,52,12,12,24
1517,1517,,43,304,285,589
1518,1518,,43,157,303,460
1519,1519,,23,61,145,206
1520,1520,,23,10,10,20
1521,1521,,21,185,86,271
1522,1522,,23,872,1316,2188
1523,1523,,43,6,45,51
1524,1524,,23,23,116,139
1525,1525,,43,48,45,93
1526,1526,,43,15,42,57
1527,1527,,43,47,40,87
1528,1528,,8,5,3,8
1529,1529,,43,19,23,42
1530,1530,,43,23,125,148
1531,1531,,8,12,6,18
1532,1532,,8,9,1,10
1533,1533,,45,2,16,18
1534,1534,,43,20,29,49
1535,1535,,43,8,21,29
1536,1536,,43,5,17,22
1537,1537,,8,35,8,43
1538,1538,,3,26,10,36
1539,1539,,76,7,3,10
1540,1540,,76,1,1,2
1541,1541,,23,54,73,127
1542,1542,,66,3,10,13
1543,1543,,8,10,10,20
1544,1544,,0,9,20,29
1545,1545,,8,240,296,536
1546,1546,,21,4,2,6
1547,1547,,21,4,3,7
1548,1548,,8,7,6,13
1549,1549,,8,0,3,3
1550,1550,,8,15,6,21
1551,1551,,8,23,16,39
1552,1552,,23,3,27,30
1553,1553,,23,0,3,3
1554,1554,,127,3,6,9
1555,1555,,127,3,1,4
1556,1556,,127,7,4,11
1557,1557,,23,381,556,937
1558,1558,,23,726,916,1642
1559,1559,,111,18,34,52
1560,1560,,111,34,19,53
1561,1561,,111,12,8,20
1562,1562,,8,43,16,59
1563,1563,,52,193,136,329
1564,1564,,76,23,6,29
1565,1565,,0,5,15,20
1566,1566,,14,6,6,12
1567,1567,,14,74,138,212
1568,1568,,3,24,124,148
1569,1569,,23,84,104,188
1570,1570,,52,74,36,110
1571,1571,,120,6,0,6
1572,1572,,43,24,52,76
1573,1573,,23,67,90,157
1574,1574,,23,1,6,7
1575,1575,,23,2,5,7
1576,1576,,8,40,63,103
1577,1577,,8,49,94,143
1578,1578,,3,25,7,32
1579,1579,,127,28,15,43
1580,1580,,127,20,20,40
1581,1581,,127,1,1,2
1582,1582,,127,0,1,1
1583,1583,,127,27,11,38
1584,1584,,127,1,2,3
1585,1585,,14,7,4,11
1586,1586,,8,0,3,3
1587,1587,,31,4,2,6
1588,1588,,31,60,83,143
1589,1589,,31,3,3,6
1590,1590,,31,127,187,314
1591,1591,,14,11,31,42
1592,1592,,14,2,9,11
1593,1593,,31,1,0,1
1594,1594,,31,0,3,3
1595,1595,,31,2,0,2
1596,1596,,31,3,4,7
1597,1597,,23,43,80,123
1598,1598,,43,58,97,155
1599,1599,,8,14,58,72
1600,1600,,8,10,3,13
1601,1601,,23,59,37,96
1602,1602,,23,20,22,42
1603,1603,,23,1,5,6
1604,1604,,23,214,168,382
1605,1605,,23,1,1,2
1606,1606,,8,3,2,5
1607,1607,,6,7,20,27
1608,1608,,6,3,4,7
1609,1609,,6,236,109,345
1610,1610,,31,50,104,154
1611,1611,,8,77,74,151
1612,1612,,5,106,98,204
1613,1613,,88,9,16,25
1614,1614,,15,22,38,60
1615,1615,,23,32,47,79
1616,1616,,21,5,23,28
1617,1617,,21,34,15,49
1618,1618,,45,1,7,8
1619,1619,,31,2,1,3
1620,1620,,31,59,53,112
1621,1621,,31,15,51,66
1622,1622,,31,3,10,13
1623,1623,,31,9,24,33
1624,1624,,0,7,24,31
1625,1625,,0,3,8,11
1626,1626,,14,66,13,79
1627,1627,,14,2,33,35
1628,1628,,23,2,12,14
1629,1629,,23,12,22,34
1630,1630,,23,1,1,2
1631,1631,,8,93,53,146
1632,1632,,8,2,2,4
1633,1633,,24,51,87,138
1634,1634,,24,64,9,73
1635,1635,,11,32,66,98
1636,1636,,31,1,4,5
1637,1637,,31,10,12,22
1638,1638,,8,46,115,161
1639,1639,,111,3,2,5
1640,1640,,52,18,37,55
1641,1641,,111,0,5,5
1642,1642,,23,8,11,19
1643,1643,,14,30,6,36
1644,1644,,105,1,6,7
1645,1645,,18,26,28,54
1646,1646,,18,7,4,11
1647,1647,,14,6,6,12
1648,1648,,23,2,8,10
1649,1649,,105,56,18,74
1650,1650,,23,8,4,12
1651,1651,,3,85,182,267
1652,1652,,23,8,16,24
1653,1653,,76,44,124,168
1654,1654,,14,94,28,122
1655,1655,,23,47,152,199
1656,1656,,23,3,4,7
1657,1657,,43,2,3,5
1658,1658,,76,73,45,118
1659,1659,,76,4,28,32
1660,1660,,76,18,35,53
1661,1661,,14,14,33,47
1662,1662,,23,16,131,147
1663,1663,,11,189,107,296
1664,1664,,11,6,15,21
1665,1665,,23,6,13,19
1666,1666,,76,9,225,234
1667,1667,,76,64,22,86
1668,1668,,8,2,7,9
1669,1669,,23,44,6,50
1670,1670,,8,2,2,4
1671,1671,,8,3,19,22
1672,1672,,8,15,18,33
1673,1673,,23,0,1,1
1674,1674,,23,4,3,7
1675,1675,,23,9,8,17
1676,1676,,0,56,60,116
1677,1677,,23,20,56,76
1678,1678,,23,22,55,77
1679,1679,,76,41,66,107
1680,1680,,23,7,14,21
1681,1681,,11,91,114,205
1682,1682,,11,36,20,56
1683,1683,,23,49,67,116
1684,1684,,76,24,130,154
1685,1685,,11,11,27,38
1686,1686,,11,10,63,73
1687,1687,,23,12,59,71
1688,1688,,15,136,117,253
1689,1689,,0,6,6,12
1690,1690,,3,33,32,65
1691,1691,,23,328,618,946
1692,1692,,105,41,45,86
1693,1693,,8,0,6,6
1694,1694,,8,3,2,5
1695,1695,,111,2,3,5
1696,1696,,111,58,120,178
1697,1697,,23,13,13,26
1698,1698,,105,2,6,8
1699,1699,,105,2,5,7
1700,1700,,15,4,11,15
1701,1701,,15,3,1,4
1702,1702,,0,2,54,56
1703,1703,,0,21,13,34
1704,1704,,0,4,1,5
1705,1705,,8,1,5,6
1706,1706,,0,5,8,13
1707,1707,,15,1,1,2
1708,1708,,23,21,14,35
1709,1709,,194,8,7,15
1710,1710,,194,1,0,1
1711,1711,,21,8,11,19
1712,1712,,21,3,0,3
1713,1713,,11,7,13,20
1714,1714,,11,23,40,63
1715,1715,,8,183,245,428
1716,1716,,8,4,2,6
1717,1717,,18,2,3,5
1718,1718,,8,2,2,4
1719,1719,,8,2,1,3
1720,1720,,8,12,8,20
1721,1721,,21,59,196,255
1722,1722,,23,3,25,28
1723,1723,,23,0,1,1
1724,1724,,127,36,51,87
1725,1725,,127,0,1,1
1726,1726,,24,20,32,52
1727,1727,,111,1,4,5
1728,1728,,111,28,25,53
1729,1729,,15,635,494,1129
1730,1730,,15,307,163,470
1731,1731,,3,22,24,46
1732,1732,,3,132,188,320
1733,1733,,43,6,11,17
1734,1734,,45,5,1,6
1735,1735,,111,1,5,6
1736,1736,,111,18,21,39
1737,1737,,111,4,0,4
1738,1738,,111,133,102,235
1739,1739,,45,5,2,7
1740,1740,,8,8,14,22
1741,1741,,8,3,1,4
1742,1742,,127,0,3,3
1743,1743,,127,126,94,220
1744,1744,,23,23,28,51
1745,1745,,21,1,12,13
1746,1746,,21,23,38,61
1747,1747,,8,8,13,21
1748,1748,,8,20,15,35
1749,1749,,8,101,123,224
1750,1750,,8,1,2,3
1751,1751,,45,12,16,28
1752,1752,,45,10,20,30
1753,1753,,45,0,1,1
1754,1754,,23,22,25,47
1755,1755,,0,15,35,50
1756,1756,,0,50,57,107
1757,1757,,0,8,71,79
1758,1758,,0,8,5,13
1759,1759,,0,87,21,108
1760,1760,,0,0,1,1
1761,1761,,0,10,2,12
1762,1762,,23,44,53,97
1763,1763,,23,16,21,37
1764,1764,,23,0,1,1
1765,1765,,105,4,7,11
1766,1766,,105,2,0,2
1767,1767,,88,0,2,2
1768,1768,,14,6,23,29
1769,1769,,11,3,5,8
1770,1770,,11,3,3,6
1771,1771,,11,5,2,7
1772,1772,,11,9,11,20
1773,1773,,11,1,0,1
1774,1774,,11,115,160,275
1775,1775,,111,19,60,79
1776,1776,,111,0,3,3
1777,1777,,111,8,26,34
1778,1778,,43,71,50,121
1779,1779,,8,2,2,4
1780,1780,,8,3,7,10
1781,1781,,8,1,2,3
1782,1782,,23,104,74,178
1783,1783,,105,29,52,81
1784,1784,,23,15,32,47
1785,1785,,15,192,125,317
1786,1786,,15,15,9,24
1787,1787,,15,6,3,9
1788,1788,,15,3,5,8
1789,1789,,23,25,37,62
1790,1790,,18,5,10,15
1791,1791,,23,9,4,13
1792,1792,,3,6,14,20
1793,1793,,3,438,177,615
1794,1794,,24,23,8,31
1795,1795,,24,20,32,52
1796,1796,,5,8,24,32
1797,1797,,127,3,0,3
1798,1798,,23,47,64,111
1799,1799,,18,5,1,6
1800,1800,,23,12,14,26
1801,1801,,15,4,2,6
1802,1802,,15,21,19,40
1803,1803,,127,2,1,3
1804,1804,,127,5,4,9
1805,1805,,0,2,18,20
1806,1806,,8,16,38,54
1807,1807,,8,4,3,7
1808,1808,,66,68,44,112
1809,1809,,105,1,0,1
1810,1810,,105,70,191,261
1811,1811,,105,66,88,154
1812,1812,,52,54,54,108
1813,1813,,23,35,27,62
1814,1814,,18,1,3,4
1815,1815,,18,3,9,12
1816,1816,,18,0,1,1
1817,1817,,66,24,10,34
1818,1818,,0,2,11,13
1819,1819,,0,39,30,69
1820,1820,,52,117,160,277
1821,1821,,52,104,95,199
1822,1822,,52,18,59,77
1823,1823,,0,1,18,19
1824,1824,,43,16,53,69
1825,1825,,0,161,114,275
1826,1826,,23,0,1,1
1827,1827,,23,11,7,18
1828,1828,,0,23,29,52
1829,1829,,11,3,19,22
1830,1830,,31,43,89,132
1831,1831,,8,0,1,1
1832,1832,,11,122,110,232
1833,1833,,5,16,17,33
1834,1834,,5,7,39,46
1835,1835,,5,1,0,1
1836,1836,,11,1,3,4
1837,1837,,15,106,36,142
1838,1838,,15,3,4,7
1839,1839,,15,4,1,5
1840,1840,,3,122,157,279
1841,1841,,11,46,37,83
1842,1842,,127,80,77,157
1843,1843,,31,2,7,9
1844,1844,,21,21,16,37
1845,1845,,23,54,33,87
1846,1846,,23,38,40,78
1847,1847,,23,74,100,174
1848,1848,,23,22,68,90
1849,1849,,23,3,0,3
1850,1850,,23,15,20,35
1851,1851,,23,97,85,182
1852,1852,,3,0,1,1
1853,1853,,3,27,11,38
1854,1854,,0,1,2,3
1855,1855,,0,3,0,3
1856,1856,,21,13,13,26
1857,1857,,18,136,191,327
1858,1858,,18,20,15,35
1859,1859,,14,6,3,9
1860,1860,,14,3,8,11
1861,1861,,14,1,13,14
1862,1862,,14,22,12,34
1863,1863,,43,2,3,5
1864,1864,,43,7,6,13
1865,1865,,43,5,15,20
1866,1866,,43,28,57,85
1867,1867,,43,5,3,8
1868,1868,,43,30,44,74
1869,1869,,43,24,70,94
1870,1870,,8,143,53,196
1871,1871,,43,1,0,1
1872,1872,,43,20,17,37
1873,1873,,43,1,11,12
1874,1874,,43,0,2,2
1875,1875,,21,13,12,25
1876,1876,,0,1,7,8
1877,1877,,0,20,34,54
1878,1878,,0,90,15,105
1879,1879,,0,23,38,61
1880,1880,,11,6,6,12
1881,1881,,23,79,129,208
1882,1882,,0,68,7,75
1883,1883,,0,0,4,4
1884,1884,,127,13,25,38
1885,1885,,127,13,11,24
1886,1886,,23,2,7,9
1887,1887,,23,12,18,30
1888,1888,,127,57,49,106
1889,1889,,23,31,48,79
1890,1890,,52,0,3,3
1891,1891,,8,23,40,63
1892,1892,,0,1,11,12
1893,1893,,0,8,30,38
1894,1894,,76,57,67,124
1895,1895,,76,3,1,4
1896,1896,,76,68,125,193
1897,1897,,0,39,50,89
1898,1898,,31,1,1,2
1899,1899,,88,2,1,3
1900,1900,,88,5,10,15
1901,1901,,88,27,35,62
1902,1902,,88,2,6,8
1903,1903,,88,12,6,18
1904,1904,,23,22,44,66
1905,1905,,18,3,7,10
1906,1906,,3,19,36,55
1907,1907,,127,2,1,3
1908,1908,,21,8,13,21
1909,1909,,52,2,4,6
1910,1910,,23,3,0,3
1911,1911,,52,22,61,83
1912,1912,,52,185,133,318
1913,1913,,23,16,15,31
1914,1914,,23,2,3,5
1915,1915,,127,2,3,5
1916,1916,,23,0,1,1
1917,1917,,11,25,37,62
1918,1918,,120,10,7,17
1919,1919,,120,14,29,43
1920,1920,,23,58,123,181
1921,1921,,14,42,40,82
1922,1922,,14,54,49,103
1923,1923,,24,96,197,293
1924,1924,,24,10,9,19
1925,1925,,3,26,28,54
1926,1926,,23,12,16,28
1927,1927,,127,49,43,92
1928,1928,,14,1,12,13
1929,1929,,14,8,3,11
1930,1930,,3,12,14,26
1931,1931,,3,4,2,6
1932,1932,,43,37,28,65
1933,1933,,43,12,13,25
1934,1934,,21,71,76,147
1935,1935,,21,4,1,5
1936,1936,,14,0,4,4
1937,1937,,21,438,283,721
1938,1938,,23,16,22,38
1939,1939,,43,3,4,7
1940,1940,,3,38,55,93
1941,1941,,3,69,60,129
1942,1942,,3,82,96,178
1943,1943,,52,4,12,16
1944,1944,,52,33,63,96
1945,1945,,43,93,141,234
1946,1946,,120,36,81,117
1947,1947,,43,61,96,157
1948,1948,,43,3,10,13
1949,1949,,43,1,20,21
1950,1950,,43,49,22,71
1951,1951,,43,37,133,170
1952,1952,,43,2,3,5
1953,1953,,43,151,134,285
1954,1954,,43,10,24,34
1955,1955,,43,16,6,22
1956,1956,,43,9,19,28
1957,1957,,8,45,33,78
1958,1958,,43,12,31,43
1959,1959,,43,14,11,25
1960,1960,,23,18,25,43
1961,1961,,23,65,49,114
1962,1962,,21,11,16,27
1963,1963,,11,47,44,91
1964,1964,,52,26,38,64
1965,1965,,127,1,2,3
1966,1966,,127,29,57,86
1967,1967,,23,2,3,5
1968,1968,,3,15,23,38
1969,1969,,11,27,29,56
1970,1970,,11,1,0,1
1971,1971,,127,8,38,46
1972,1972,,127,48,3,51
1973,1973,,21,2,8,10
1974,1974,,8,12,29,41
1975,1975,,66,0,1,1
1976,1976,,66,11,1,12
1977,1977,,15,113,85,198
1978,1978,,15,15,11,26
1979,1979,,24,17,11,28
1980,1980,,24,1,5,6
1981,1981,,8,157,103,260
1982,1982,,8,25,58,83
1983,1983,,23,1,1,2
1984,1984,,23,25,49,74
1985,1985,,11,4,13,17
1986,1986,,11,1,1,2
1987,1987,,105,18,10,28
1988,1988,,23,83,74,157
1989,1989,,88,2,7,9
1990,1990,,8,1,0,1
1991,1991,,8,6,4,10
1992,1992,,23,16,42,58
1993,1993,,23,16,42,58
1994,1994,,127,5,10,15
1995,1995,,23,15,2,17
1996,1996,,23,19,19,38
1997,1997,,23,305,211,516
1998,1998,,0,3,4,7
1999,1999,,0,16,14,30
2000,2000,,0,6,11,17
2001,2001,,23,8,12,20
2002,2002,,8,35,22,57
2003,2003,,8,1,0,1
2004,2004,,31,41,224,265
2005,2005,,14,6,4,10
2006,2006,,21,2,6,8
2007,2007,,31,7,26,33
2008,2008,,111,12,9,21
2009,2009,,8,11,27,38
2010,2010,,76,10,26,36
2011,2011,,76,56,46,102
2012,2012,,76,5,24,29
2013,2013,,8,9,3,12
2014,2014,,14,7,9,16
2015,2015,,127,6,11,17
2016,2016,,43,8,3,11
2017,2017,,15,23,33,56
2018,2018,,23,0,1,1
2019,2019,,21,18,15,33
2020,2020,,23,12,34,46
2021,2021,,23,7,103,110
2022,2022,,31,16,11,27
2023,2023,,23,10,13,23
2024,2024,,3,22,17,39
2025,2025,,23,1,1,2
2026,2026,,18,18,17,35
2027,2027,,31,4,5,9
2028,2028,,31,9,17,26
2029,2029,,31,4,6,10
2030,2030,,76,33,20,53
2031,2031,,3,10,37,47
2032,2032,,3,7,19,26
2033,2033,,23,94,156,250
2034,2034,,43,13,31,44
2035,2035,,15,15,25,40
2036,2036,,8,2,0,2
2037,2037,,23,1,0,1
2038,2038,,105,1,9,10
2039,2039,,23,5,29,34
2040,2040,,31,0,2,2
2041,2041,,8,13,30,43
2042,2042,,43,0,2,2
2043,2043,,6,36,102,138
2044,2044,,6,19,17,36
2045,2045,,88,9,8,17
2046,2046,,111,6,6,12
2047,2047,,111,40,61,101
2048,2048,,111,21,9,30
2049,2049,,52,32,45,77
2050,2050,,21,1,1,2
2051,2051,,21,4,2,6
2052,2052,,15,41,57,98
2053,2053,,15,7,8,15
2054,2054,,15,10,9,19
2055,2055,,105,1,3,4
2056,2056,,105,1,3,4
2057,2057,,23,701,555,1256
2058,2058,,23,3,13,16
2059,2059,,23,13,13,26
2060,2060,,127,11,19,30
2061,2061,,127,25,38,63
2062,2062,,43,5,8,13
2063,2063,,127,7,7,14
2064,2064,,8,7,39,46
2065,2065,,18,21,21,42
2066,2066,,14,10,9,19
2067,2067,,24,1,9,10
2068,2068,,31,13,15,28
2069,2069,,23,25,31,56
2070,2070,,8,7,15,22
2071,2071,,105,27,44,71
2072,2072,,3,8,15,23
2073,2073,,3,10,11,21
2074,2074,,3,7,8,15
2075,2075,,43,8,12,20
2076,2076,,43,2,1,3
2077,2077,,43,22,38,60
2078,2078,,8,3,10,13
2079,2079,,14,1,9,10
2080,2080,,14,19,5,24
2081,2081,,11,5,12,17
2082,2082,,23,2,4,6
2083,2083,,23,1,0,1
2084,2084,,11,13,71,84
2085,2085,,23,106,61,167
2086,2086,,76,25,94,119
2087,2087,,76,16,12,28
2088,2088,,76,4,6,10
2089,2089,,14,113,120,233
2090,2090,,76,11,96,107
2091,2091,,76,23,14,37
2092,2092,,76,49,27,76
2093,2093,,8,256,250,506
2094,2094,,31,37,40,77
2095,2095,,31,1,5,6
2096,2096,,31,16,13,29
2097,2097,,8,15,36,51
2098,2098,,111,6,15,21
2099,2099,,111,22,19,41
2100,2100,,111,26,42,68
2101,2101,,111,3,2,5
2102,2102,,105,13,32,45
2103,2103,,23,18,31,49
2104,2104,,111,62,38,100
2105,2105,,21,54,117,171
2106,2106,,21,9,3,12
2107,2107,,21,4,2,6
2108,2108,,45,3,5,8
2109,2109,,45,9,8,17
2110,2110,,8,12,14,26
2111,2111,,8,2,0,2
2112,2112,,127,14,17,31
2113,2113,,127,2,0,2
2114,2114,,127,3,2,5
2115,2115,,6,2,11,13
2116,2116,,6,20,24,44
2117,2117,,0,38,60,98
2118,2118,,8,22,15,37
2119,2119,,23,0,2,2
2120,2120,,23,5,2,7
2121,2121,,11,7,15,22
2122,2122,,8,38,48,86
2123,2123,,8,0,3,3
2124,2124,,8,53,50,103
2125,2125,,8,1,2,3
2126,2126,,8,213,124,337
2127,2127,,111,1,12,13
2128,2128,,111,21,10,31
2129,2129,,127,0,1,1
2130,2130,,127,2,0,2
2131,2131,,23,35,46,81
2132,2132,,23,5,11,16
2133,2133,,23,23,38,61
2134,2134,,23,112,173,285
2135,2135,,15,1,2,3
2136,2136,,15,58,92,150
2137,2137,,3,0,3,3
2138,2138,,8,30,70,100
2139,2139,,0,10,21,31
2140,2140,,111,43,16,59
2141,2141,,23,46,82,128
2142,2142,,111,1,2,3
2143,2143,,23,61,47,108
2144,2144,,23,0,1,1
2145,2145,,6,16,28,44
2146,2146,,6,8,4,12
2147,2147,,15,4,5,9
2148,2148,,23,0,1,1
2149,2149,,23,5,3,8
2150,2150,,8,0,1,1
2151,2151,,8,22,7,29
2152,2152,,8,1,0,1
2153,2153,,45,0,4,4
2154,2154,,45,13,2,15
2155,2155,,45,14,2,16
2156,2156,,127,1,29,30
2157,2157,,45,5,6,11
2158,2158,,23,222,218,440
2159,2159,,23,9,19,28
2160,2160,,14,15,11,26
2161,2161,,52,3,3,6
2162,2162,,18,0,3,3
2163,2163,,18,35,20,55
2164,2164,,23,78,27,105
2165,2165,,11,2,3,5
2166,2166,,11,1,0,1
2167,2167,,66,2,4,6
2168,2168,,23,35,45,80
2169,2169,,5,1,0,1
2170,2170,,15,3,9,12
2171,2171,,15,6,13,19
2172,2172,,15,145,226,371
2173,2173,,3,0,3,3
2174,2174,,7,0,1,1
2175,2175,,7,1,0,1
2176,2176,,8,0,9,9
2177,2177,,8,2,0,2
2178,2178,,8,1,1,2
2179,2179,,23,0,2,2
2180,2180,,23,1,1,2
2181,2181,,8,0,1,1
2182,2182,,8,3,3,6
2183,2183,,76,46,46,92
2184,2184,,88,1,0,1
2185,2185,,43,64,19,83
2186,2186,,23,33,97,130
2187,2187,,23,156,135,291
2188,2188,,8,5,5,10
2189,2189,,15,1,0,1
2190,2190,,127,19,82,101
2191,2191,,127,4,0,4
2192,2192,,127,3,6,9
2193,2193,,23,22,43,65
2194,2194,,11,2,6,8
2195,2195,,11,32,12,44
2196,2196,,8,2,0,2
2197,2197,,8,1,8,9
2198,2198,,0,6,11,17
2199,2199,,23,1,2,3
2200,2200,,23,17,15,32
2201,2201,,127,20,0,20
2202,2202,,8,5,3,8
2203,2203,,8,3,7,10
2204,2204,,8,0,1,1
2205,2205,,11,14,16,30
2206,2206,,18,33,63,96
2207,2207,,18,7,3,10
2208,2208,,11,200,99,299
2209,2209,,11,38,9,47
2210,2210,,88,20,32,52
2211,2211,,88,183,144,327
2212,2212,,111,4,3,7
2213,2213,,111,1,0,1
2214,2214,,5,7,12,19
2215,2215,,8,160,104,264
2216,2216,,0,1,2,3
2217,2217,,23,60,32,92
2218,2218,,43,1,2,3
2219,2219,,5,44,100,144
2220,2220,,45,2,10,12
2221,2221,,45,4,2,6
2222,2222,,23,15,84,99
2223,2223,,23,1,0,1
2224,2224,,8,16,22,38
2225,2225,,8,10,13,23
2226,2226,,23,0,11,11
2227,2227,,0,28,42,70
2228,2228,,0,2,9,11
2229,2229,,8,0,4,4
2230,2230,,21,15,10,25
2231,2231,,21,24,45,69
2232,2232,,23,10,16,26
2233,2233,,23,3,3,6
2234,2234,,52,12,16,28
2235,2235,,111,0,4,4
2236,2236,,111,4,17,21
2237,2237,,111,0,1,1
2238,2238,,23,2,2,4
2239,2239,,0,4,2,6
2240,2240,,3,2,2,4
2241,2241,,127,223,152,375
2242,2242,,11,0,2,2
2243,2243,,23,247,305,552
2244,2244,,23,1,0,1
2245,2245,,8,0,2,2
2246,2246,,8,32,70,102
2247,2247,,5,6,16,22
2248,2248,,66,34,17,51
2249,2249,,0,18,14,32
2250,2250,,23,0,5,5
2251,2251,,127,1,2,3
2252,2252,,127,7,2,9
2253,2253,,127,12,2,14
2254,2254,,127,7,19,26
2255,2255,,127,1,0,1
2256,2256,,0,22,19,41
2257,2257,,14,4,9,13
2258,2258,,14,12,11,23
2259,2259,,14,93,28,121
2260,2260,,14,5,7,12
2261,2261,,8,10,11,21
2262,2262,,0,3,5,8
2263,2263,,8,17,6,23
2264,2264,,0,4,11,15
2265,2265,,23,226,413,639
2266,2266,,0,19,42,61
2267,2267,,0,5,9,14
2268,2268,,14,0,2,2
2269,2269,,0,8,10,18
2270,2270,,0,8,14,22
2271,2271,,8,4,7,11
2272,2272,,0,51,41,92
2273,2273,,43,7,8,15
2274,2274,,43,56,122,178
2275,2275,,43,0,1,1
2276,2276,,43,5,14,19
2277,2277,,43,22,37,59
2278,2278,,43,48,30,78
2279,2279,,43,4,2,6
2280,2280,,15,4,7,11
2281,2281,,23,73,89,162
2282,2282,,43,12,12,24
2283,2283,,43,6,17,23
2284,2284,,43,3,7,10
2285,2285,,43,7,16,23
2286,2286,,43,13,10,23
2287,2287,,43,13,21,34
2288,2288,,43,6,18,24
2289,2289,,43,27,68,95
2290,2290,,21,13,7,20
2291,2291,,21,19,58,77
2292,2292,,23,10,6,16
2293,2293,,127,0,4,4
2294,2294,,127,21,16,37
2295,2295,,8,0,1,1
2296,2296,,8,33,12,45
2297,2297,,127,4,25,29
2298,2298,,127,12,0,12
2299,2299,,5,2,10,12
2300,2300,,5,17,17,34
2301,2301,,127,17,59,76
2302,2302,,14,0,3,3
2303,2303,,88,4,2,6
2304,2304,,88,14,13,27
2305,2305,,88,136,121,257
2306,2306,,14,19,19,38
2307,2307,,14,6,9,15
2308,2308,,14,14,17,31
2309,2309,,14,16,7,23
2310,2310,,14,8,1,9
2311,2311,,14,10,1,11
2312,2312,,23,13,25,38
2313,2313,,23,170,108,278
2314,2314,,23,349,567,916
2315,2315,,23,43,98,141
2316,2316,,66,85,86,171
2317,2317,,66,28,14,42
2318,2318,,43,13,17,30
2319,2319,,43,9,11,20
2320,2320,,3,13,40,53
2321,2321,,5,1,3,4
2322,2322,,23,0,1,1
2323,2323,,23,23,24,47
2324,2324,,23,1,10,11
2325,2325,,127,9,20,29
2326,2326,,127,11,2,13
2327,2327,,23,3,1,4
2328,2328,,43,0,1,1
2329,2329,,88,6,2,8
2330,2330,,127,16,7,23
2331,2331,,105,2,9,11
2332,2332,,66,19,23,42
2333,2333,,66,4,13,17
2334,2334,,43,7,135,142
2335,2335,,23,3,2,5
2336,2336,,3,0,1,1
2337,2337,,24,1,2,3
2338,2338,,43,13,36,49
2339,2339,,43,4,8,12
2340,2340,,43,20,22,42
2341,2341,,43,15,22,37
2342,2342,,43,14,22,36
2343,2343,,8,30,10,40
2344,2344,,43,3,19,22
2345,2345,,8,3,2,5
2346,2346,,23,2,1,3
2347,2347,,43,10,32,42
2348,2348,,45,1,5,6
2349,2349,,45,57,28,85
2350,2350,,0,3,2,5
2351,2351,,23,5,12,17
2352,2352,,23,1,1,2
2353,2353,,31,61,46,107
2354,2354,,11,6,8,14
2355,2355,,11,4,4,8
2356,2356,,127,3,10,13
2357,2357,,43,1,2,3
2358,2358,,43,179,137,316
2359,2359,,43,4,9,13
2360,2360,,23,0,1,1
2361,2361,,23,5,6,11
2362,2362,,3,36,19,55
2363,2363,,127,2,2,4
2364,2364,,127,17,11,28
2365,2365,,23,25,50,75
2366,2366,,76,2,2,4
2367,2367,,43,0,1,1
2368,2368,,43,5,4,9
2369,2369,,0,2,7,9
2370,2370,,8,2,8,10
2371,2371,,8,4,1,5
2372,2372,,127,21,25,46
2373,2373,,43,47,26,73
2374,2374,,76,1,3,4
2375,2375,,76,4,34,38
2376,2376,,3,1,1,2
2377,2377,,3,36,31,67
2378,2378,,43,21,62,83
2379,2379,,43,4,8,12
2380,2380,,105,89,196,285
2381,2381,,76,10,19,29
2382,2382,,105,1,1,2
2383,2383,,105,3,4,7
2384,2384,,43,4,2,6
2385,2385,,43,12,35,47
2386,2386,,127,4,1,5
2387,2387,,23,26,48,74
2388,2388,,23,38,75,113
2389,2389,,105,6,22,28
2390,2390,,105,8,12,20
2391,2391,,8,122,117,239
2392,2392,,127,24,8,32
2393,2393,,105,8,1,9
2394,2394,,31,1,0,1
2395,2395,,31,15,3,18
2396,2396,,8,3,18,21
2397,2397,,23,12,17,29
2398,2398,,23,16,32,48
2399,2399,,0,48,64,112
2400,2400,,14,22,46,68
2401,2401,,43,20,9,29
2402,2402,,31,3,1,4
2403,2403,,31,38,17,55
2404,2404,,8,2,2,4
2405,2405,,21,0,1,1
2406,2406,,8,13,5,18
2407,2407,,23,1,0,1
2408,2408,,23,1,4,5
2409,2409,,105,3,3,6
2410,2410,,8,20,34,54
2411,2411,,31,16,39,55
2412,2412,,31,1,5,6
2413,2413,,31,0,1,1
2414,2414,,8,0,19,19
2415,2415,,24,0,4,4
2416,2416,,8,3,3,6
2417,2417,,8,14,7,21
2418,2418,,23,10,19,29
2419,2419,,23,3,18,21
2420,2420,,8,8,13,21
2421,2421,,8,2,13,15
2422,2422,,15,33,19,52
2423,2423,,8,0,12,12
2424,2424,,23,3,4,7
2425,2425,,0,2,3,5
2426,2426,,23,0,4,4
2427,2427,,24,34,52,86
2428,2428,,43,14,18,32
2429,2429,,5,25,17,42
2430,2430,,127,11,23,34
2431,2431,,23,10,57,67
2432,2432,,8,0,1,1
2433,2433,,105,1,4,5
2434,2434,,105,1,0,1
2435,2435,,18,5,3,8
2436,2436,,18,10,6,16
2437,2437,,76,0,19,19
2438,2438,,23,0,5,5
2439,2439,,18,28,23,51
2440,2440,,15,6,3,9
2441,2441,,23,0,3,3
2442,2442,,76,7,10,17
2443,2443,,15,6,1,7
2444,2444,,15,1,1,2
2445,2445,,15,3,19,22
2446,2446,,23,2,32,34
2447,2447,,23,86,113,199
2448,2448,,23,1,1,2
2449,2449,,23,2,3,5
2450,2450,,31,0,8,8
2451,2451,,127,23,23,46
2452,2452,,31,6,8,14
2453,2453,,8,5,0,5
2454,2454,,23,12,35,47
2455,2455,,8,30,37,67
2456,2456,,8,206,138,344
2457,2457,,43,28,92,120
2458,2458,,45,0,1,1
2459,2459,,23,0,1,1
2460,2460,,23,1,1,2
2461,2461,,43,0,5,5
2462,2462,,76,2,3,5
2463,2463,,43,14,24,38
2464,2464,,45,73,53,126
2465,2465,,8,89,46,135
2466,2466,,23,33,67,100
2467,2467,,15,121,236,357
2468,2468,,21,3,2,5
2469,2469,,21,2,3,5
2470,2470,,21,4,0,4
2471,2471,,8,2,1,3
2472,2472,,11,28,19,47
2473,2473,,11,27,14,41
2474,2474,,127,13,12,25
2475,2475,,127,1,0,1
2476,2476,,8,20,11,31
2477,2477,,8,20,53,73
2478,2478,,8,17,15,32
2479,2479,,8,15,20,35
2480,2480,,15,3,1,4
2481,2481,,0,24,3,27
2482,2482,,3,7,7,14
2483,2483,,3,30,32,62
2484,2484,,45,1,1,2
2485,2485,,43,22,52,74
2486,2486,,11,0,2,2
2487,2487,,21,2,3,5
2488,2488,,21,9,3,12
2489,2489,,23,80,100,180
2490,2490,,21,18,32,50
2491,2491,,8,65,45,110
2492,2492,,127,1,8,9
2493,2493,,127,6,12,18
2494,2494,,11,35,68,103
2495,2495,,11,40,58,98
2496,2496,,0,7,13,20
2497,2497,,31,21,27,48
2498,2498,,23,1,0,1
2499,2499,,23,107,153,260
2500,2500,,105,19,9,28
2501,2501,,21,8,10,18
2502,2502,,23,16,12,28
2503,2503,,15,8,20,28
2504,2504,,11,1,5,6
2505,2505,,15,22,43,65
2506,2506,,15,199,259,458
2507,2507,,15,1,0,1
2508,2508,,0,11,23,34
2509,2509,,8,23,38,61
2510,2510,,8,22,36,58
2511,2511,,8,7,9,16
2512,2512,,8,3,0,3
2513,2513,,111,17,16,33
2514,2514,,8,10,19,29
2515,2515,,8,6,3,9
2516,2516,,111,7,1,8
2517,2517,,8,62,77,139
2518,2518,,8,1,1,2
2519,2519,,24,16,16,32
2520,2520,,24,1,5,6
2521,2521,,45,10,23,33
2522,2522,,8,11,7,18
2523,2523,,8,3,4,7
2524,2524,,8,7,6,13
2525,2525,,23,14,12,26
2526,2526,,23,25,38,63
2527,2527,,43,20,44,64
2528,2528,,127,2,7,9
2529,2529,,127,5,9,14
2530,2530,,43,1,2,3
2531,2531,,43,30,18,48
2532,2532,,43,2,1,3
2533,2533,,43,21,26,47
2534,2534,,21,0,6,6
2535,2535,,24,1,1,2
2536,2536,,8,1,1,2
2537,2537,,8,0,4,4
2538,2538,,21,24,14,38
2539,2539,,21,2,5,7
2540,2540,,23,1,10,11
2541,2541,,45,2,0,2
2542,2542,,14,139,276,415
2543,2543,,15,1,3,4
2544,2544,,0,32,9,41
2545,2545,,23,51,31,82
2546,2546,,23,81,128,209
2547,2547,,8,4,4,8
2548,2548,,3,19,54,73
2549,2549,,3,14,22,36
2550,2550,,14,25,16,41
2551,2551,,3,0,1,1
2552,2552,,21,8,8,16
2553,2553,,21,1,0,1
2554,2554,,52,3,7,10
2555,2555,,66,32,39,71
2556,2556,,21,0,1,1
2557,2557,,43,91,189,280
2558,2558,,8,2,0,2
2559,2559,,14,7,7,14
2560,2560,,43,8,26,34
2561,2561,,43,12,13,25
2562,2562,,21,47,44,91
2563,2563,,43,140,74,214
2564,2564,,43,25,32,57
2565,2565,,43,2,2,4
2566,2566,,43,1,6,7
2567,2567,,43,5,0,5
2568,2568,,45,4,3,7
2569,2569,,45,25,16,41
2570,2570,,45,162,96,258
2571,2571,,15,46,116,162
2572,2572,,15,18,1,19
2573,2573,,15,3,4,7
2574,2574,,15,8,10,18
2575,2575,,8,6,4,10
2576,2576,,0,1,4,5
2577,2577,,8,42,13,55
2578,2578,,24,1,16,17
2579,2579,,111,1,3,4
2580,2580,,111,15,7,22
2581,2581,,8,1,2,3
2582,2582,,127,3,5,8
2583,2583,,66,4,5,9
2584,2584,,23,5,6,11
2585,2585,,18,6,5,11
2586,2586,,8,45,12,57
2587,2587,,8,27,20,47
2588,2588,,23,1,0,1
2589,2589,,23,7,7,14
2590,2590,,8,1,0,1
2591,2591,,23,57,57,114
2592,2592,,127,5,7,12
2593,2593,,23,0,5,5
2594,2594,,23,48,53,101
2595,2595,,23,4,1,5
2596,2596,,23,9,3,12
2597,2597,,0,58,105,163
2598,2598,,23,82,110,192
2599,2599,,23,320,226,546
2600,2600,,111,8,7,15
2601,2601,,23,66,80,146
2602,2602,,105,6,9,15
2603,2603,,23,2,16,18
2604,2604,,31,13,24,37
2605,2605,,31,41,35,76
2606,2606,,14,21,3,24
2607,2607,,14,10,11,21
2608,2608,,23,4,5,9
2609,2609,,23,1,3,4
2610,2610,,14,55,42,97
2611,2611,,14,18,6,24
2612,2612,,14,17,35,52
2613,2613,,111,111,96,207
2614,2614,,23,48,92,140
2615,2615,,23,0,2,2
2616,2616,,43,0,1,1
2617,2617,,66,7,26,33
2618,2618,,3,70,53,123
2619,2619,,23,1,7,8
2620,2620,,127,8,23,31
2621,2621,,76,6,6,12
2622,2622,,24,6,1,7
2623,2623,,24,0,3,3
2624,2624,,24,1,4,5
2625,2625,,18,11,17,28
2626,2626,,5,83,279,362
2627,2627,,8,1,0,1
2628,2628,,21,74,109,183
2629,2629,,23,0,1,1
2630,2630,,8,4,1,5
2631,2631,,0,5,28,33
2632,2632,,0,54,30,84
2633,2633,,11,18,33,51
2634,2634,,24,6,1,7
2635,2635,,23,0,1,1
2636,2636,,0,0,1,1
2637,2637,,23,26,40,66
2638,2638,,23,97,125,222
2639,2639,,15,81,126,207
2640,2640,,23,23,18,41
2641,2641,,23,39,43,82
2642,2642,,23,0,1,1
2643,2643,,23,3,1,4
2644,2644,,8,0,1,1
2645,2645,,0,6,3,9
2646,2646,,23,17,2,19
2647,2647,,111,1,8,9
2648,2648,,111,29,27,56
2649,2649,,111,4,3,7
2650,2650,,31,0,1,1
2651,2651,,8,0,6,6
2652,2652,,14,2,2,4
2653,2653,,8,2,2,4
2654,2654,,11,4,13,17
2655,2655,,21,7,2,9
2656,2656,,11,7,2,9
2657,2657,,14,168,109,277
2658,2658,,21,43,29,72
2659,2659,,21,4,4,8
2660,2660,,105,12,16,28
2661,2661,,23,41,96,137
2662,2662,,52,0,3,3
2663,2663,,52,22,11,33
2664,2664,,23,1,2,3
2665,2665,,8,11,17,28
2666,2666,,21,41,40,81
2667,2667,,8,2,3,5
2668,2668,,23,0,3,3
2669,2669,,43,23,47,70
2670,2670,,15,1,2,3
2671,2671,,15,1,0,1
2672,2672,,15,3,2,5
2673,2673,,8,1,10,11
2674,2674,,8,156,125,281
2675,2675,,8,1,1,2
2676,2676,,0,18,11,29
2677,2677,,8,12,20,32
2678,2678,,8,100,95,195
2679,2679,,8,5,6,11
2680,2680,,8,14,17,31
2681,2681,,23,23,56,79
2682,2682,,0,14,13,27
2683,2683,,23,89,61,150
2684,2684,,11,103,59,162
2685,2685,,21,29,29,58
2686,2686,,43,0,1,1
2687,2687,,111,3,2,5
2688,2688,,88,11,3,14
2689,2689,,14,3,0,3
2690,2690,,24,21,101,122
2691,2691,,52,49,11,60
2692,2692,,127,0,1,1
2693,2693,,127,7,2,9
2694,2694,,23,689,1036,1725
2695,2695,,8,122,58,180
2696,2696,,8,4,11,15
2697,2697,,21,41,4,45
2698,2698,,21,0,1,1
2699,2699,,76,2,3,5
2700,2700,,0,4,6,10
2701,2701,,88,9,44,53
2702,2702,,8,23,39,62
2703,2703,,8,1,1,2
2704,2704,,15,73,111,184
2705,2705,,24,5,5,10
2706,2706,,14,3,6,9
2707,2707,,31,22,25,47
2708,2708,,11,280,196,476
2709,2709,,11,9,27,36
2710,2710,,11,3,4,7
2711,2711,,8,8,7,15
2712,2712,,11,8,23,31
2713,2713,,88,2,0,2
2714,2714,,43,6,7,13
2715,2715,,23,0,2,2
2716,2716,,23,54,9,63
2717,2717,,23,17,27,44
2718,2718,,66,0,2,2
2719,2719,,127,2,2,4
2720,2720,,14,4,11,15
2721,2721,,66,6,23,29
2722,2722,,52,1,14,15
2723,2723,,23,9,2,11
2724,2724,,23,1,12,13
2725,2725,,14,0,3,3
2726,2726,,88,38,38,76
2727,2727,,3,49,113,162
2728,2728,,52,1,14,15
2729,2729,,3,53,24,77
2730,2730,,23,1,0,1
2731,2731,,23,39,33,72
2732,2732,,14,3,0,3
2733,2733,,43,8,28,36
2734,2734,,14,19,4,23
2735,2735,,43,1,15,16
2736,2736,,21,357,154,511
2737,2737,,11,4,1,5
2738,2738,,88,12,13,25
2739,2739,,76,0,1,1
2740,2740,,52,6,7,13
2741,2741,,43,40,48,88
2742,2742,,23,1,5,6
2743,2743,,23,19,12,31
2744,2744,,23,12,6,18
2745,2745,,43,16,31,47
2746,2746,,43,33,11,44
2747,2747,,0,18,20,38
2748,2748,,9,0,1,1
2749,2749,,9,1,0,1
2750,2750,,11,83,25,108
2751,2751,,23,4,4,8
2752,2752,,23,1,0,1
2753,2753,,0,3,13,16
2754,2754,,0,9,2,11
2755,2755,,23,25,36,61
2756,2756,,0,2,2,4
2757,2757,,0,7,7,14
2758,2758,,23,4,7,11
2759,2759,,18,24,38,62
2760,2760,,52,7,12,19
2761,2761,,8,38,19,57
2762,2762,,8,0,10,10
2763,2763,,8,4,21,25
2764,2764,,8,2,2,4
2765,2765,,31,8,5,13
2766,2766,,23,2,3,5
2767,2767,,88,23,5,28
2768,2768,,111,5,10,15
2769,2769,,111,2,6,8
2770,2770,,111,9,8,17
2771,2771,,8,65,60,125
2772,2772,,14,61,16,77
2773,2773,,14,0,8,8
2774,2774,,14,2,3,5
2775,2775,,76,5,12,17
2776,2776,,3,4,0,4
2777,2777,,3,12,15,27
2778,2778,,3,11,12,23
2779,2779,,5,11,16,27
2780,2780,,111,238,369,607
2781,2781,,111,53,37,90
2782,2782,,111,1,0,1
2783,2783,,23,15,22,37
2784,2784,,52,5,14,19
2785,2785,,23,22,21,43
2786,2786,,88,2,1,3
2787,2787,,0,5,1,6
2788,2788,,0,16,1,17
2789,2789,,14,2,4,6
2790,2790,,45,7,7,14
2791,2791,,45,4,3,7
2792,2792,,31,10,9,19
2793,2793,,23,0,1,1
2794,2794,,111,0,1,1
2795,2795,,23,5,6,11
2796,2796,,23,1,1,2
2797,2797,,127,26,105,131
2798,2798,,127,49,5,54
2799,2799,,23,195,148,343
2800,2800,,43,0,1,1
2801,2801,,23,6,5,11
2802,2802,,23,3,7,10
2803,2803,,6,7,2,9
2804,2804,,8,94,203,297
2805,2805,,23,1,2,3
2806,2806,,0,23,31,54
2807,2807,,0,2,51,53
2808,2808,,76,13,19,32
2809,2809,,76,1,2,3
2810,2810,,76,14,12,26
2811,2811,,76,32,19,51
2812,2812,,31,13,8,21
2813,2813,,15,64,72,136
2814,2814,,15,34,26,60
2815,2815,,15,30,23,53
2816,2816,,6,5,1,6
2817,2817,,15,47,65,112
2818,2818,,15,1,0,1
2819,2819,,23,4,2,6
2820,2820,,14,200,332,532
2821,2821,,14,10,1,11
2822,2822,,14,36,19,55
2823,2823,,15,26,37,63
2824,2824,,45,55,23,78
2825,2825,,31,0,5,5
2826,2826,,45,0,1,1
2827,2827,,45,7,1,8
2828,2828,,45,0,2,2
2829,2829,,105,27,9,36
2830,2830,,14,7,4,11
2831,2831,,23,25,24,49
2832,2832,,8,37,178,215
2833,2833,,8,0,1,1
2834,2834,,8,12,24,36
2835,2835,,21,12,11,23
2836,2836,,21,7,14,21
2837,2837,,23,13,14,27
2838,2838,,23,9,7,16
2839,2839,,0,9,5,14
2840,2840,,23,0,3,3
2841,2841,,3,1,0,1
2842,2842,,3,2,5,7
2843,2843,,8,0,1,1
2844,2844,,8,28,40,68
2845,2845,,43,57,46,103
2846,2846,,127,50,7,57
2847,2847,,31,11,5,16
2848,2848,,11,1,20,21
2849,2849,,11,68,18,86
2850,2850,,23,17,40,57
2851,2851,,3,12,15,27
2852,2852,,31,7,2,9
2853,2853,,52,43,43,86
2854,2854,,23,31,69,100
2855,2855,,23,68,62,130
2856,2856,,18,119,69,188
2857,2857,,18,20,7,27
2858,2858,,15,6,2,8
2859,2859,,11,15,79,94
2860,2860,,23,7,1,8
2861,2861,,18,77,210,287
2862,2862,,18,13,8,21
2863,2863,,31,14,17,31
2864,2864,,8,2,2,4
2865,2865,,8,4,0,4
2866,2866,,15,107,196,303
2867,2867,,11,22,19,41
2868,2868,,23,14,16,30
2869,2869,,23,0,1,1
2870,2870,,23,113,237,350
2871,2871,,111,0,1,1
2872,2872,,31,0,23,23
2873,2873,,14,9,8,17
2874,2874,,23,28,41,69
2875,2875,,3,1,0,1
2876,2876,,0,1,3,4
2877,2877,,18,9,4,13
2878,2878,,24,1,3,4
2879,2879,,15,438,237,675
2880,2880,,66,4,5,9
2881,2881,,23,90,85,175
2882,2882,,15,10,15,25
2883,2883,,76,5,16,21
2884,2884,,76,23,14,37
2885,2885,,76,49,57,106
2886,2886,,76,0,9,9
2887,2887,,0,1,7,8
2888,2888,,0,7,7,14
2889,2889,,11,6,3,9
2890,2890,,120,10,17,27
2891,2891,,43,11,33,44
2892,2892,,23,5,4,9
2893,2893,,18,28,16,44
2894,2894,,18,5,7,12
2895,2895,,127,0,4,4
2896,2896,,127,1,0,1
2897,2897,,127,6,4,10
2898,2898,,14,1,3,4
2899,2899,,23,142,186,328
2900,2900,,23,14,8,22
2901,2901,,24,0,1,1
2902,2902,,24,10,4,14
2903,2903,,31,2,1,3
2904,2904,,127,11,25,36
2905,2905,,127,1,0,1
2906,2906,,15,23,35,58
2907,2907,,14,17,7,24
2908,2908,,23,1,0,1
2909,2909,,45,39,14,53
2910,2910,,45,1,1,2
2911,2911,,3,3,6,9
2912,2912,,52,4,4,8
2913,2913,,8,2,7,9
2914,2914,,23,3,2,5
2915,2915,,8,39,21,60
2916,2916,,8,1,0,1
2917,2917,,6,13,6,19
2918,2918,,23,21,28,49
2919,2919,,23,3,27,30
2920,2920,,43,1,2,3
2921,2921,,15,8,15,23
2922,2922,,15,41,41,82
2923,2923,,10,0,2,2
2924,2924,,10,2,1,3
2925,2925,,23,7,8,15
2926,2926,,23,10,12,22
2927,2927,,23,1,0,1
2928,2928,,15,3,4,7
2929,2929,,3,13,17,30
2930,2930,,45,22,19,41
2931,2931,,45,41,77,118
2932,2932,,3,11,29,40
2933,2933,,24,3,9,12
2934,2934,,24,2,0,2
2935,2935,,0,10,6,16
2936,2936,,8,8,8,16
2937,2937,,43,2,0,2
2938,2938,,8,33,36,69
2939,2939,,127,61,90,151
2940,2940,,127,7,9,16
2941,2941,,23,6,14,20
2942,2942,,88,11,15,26
2943,2943,,3,38,70,108
2944,2944,,23,15,15,30
2945,2945,,8,1,1,2
2946,2946,,5,7,9,16
2947,2947,,45,15,3,18
2948,2948,,45,0,2,2
2949,2949,,45,0,5,5
2950,2950,,31,19,41,60
2951,2951,,31,76,64,140
2952,2952,,14,5,11,16
2953,2953,,52,36,14,50
2954,2954,,23,0,13,13
2955,2955,,11,33,43,76
2956,2956,,11,21,48,69
2957,2957,,15,4,22,26
2958,2958,,23,1,0,1
2959,2959,,0,67,86,153
2960,2960,,111,4,1,5
2961,2961,,11,228,141,369
2962,2962,,23,7,23,30
2963,2963,,127,2,1,3
2964,2964,,23,0,1,1
2965,2965,,105,16,41,57
2966,2966,,23,8,4,12
2967,2967,,23,8,11,19
2968,2968,,23,13,11,24
2969,2969,,111,0,5,5
2970,2970,,3,1,2,3
2971,2971,,3,14,24,38
2972,2972,,3,1,1,2
2973,2973,,88,5,1,6
2974,2974,,21,0,1,1
2975,2975,,21,14,5,19
2976,2976,,66,2,4,6
2977,2977,,66,17,12,29
2978,2978,,21,19,17,36
2979,2979,,3,4,9,13
2980,2980,,23,4,4,8
2981,2981,,23,31,26,57
2982,2982,,23,4,2,6
2983,2983,,15,12,8,20
2984,2984,,15,32,40,72
2985,2985,,15,2,10,12
2986,2986,,76,2,15,17
2987,2987,,111,7,7,14
2988,2988,,111,12,11,23
2989,2989,,127,1,0,1
2990,2990,,111,8,10,18
2991,2991,,21,4,7,11
2992,2992,,52,14,18,32
2993,2993,,8,1,51,52
2994,2994,,0,106,159,265
2995,2995,,66,4,2,6
2996,2996,,23,10,11,21
2997,2997,,8,11,0,11
2998,2998,,11,5,4,9
2999,2999,,8,3,13,16
3000,3000,,23,190,109,299
3001,3001,,8,7,39,46
3002,3002,,43,0,1,1
3003,3003,,3,4,2,6
3004,3004,,23,1,2,3
3005,3005,,11,3,3,6
3006,3006,,23,17,25,42
3007,3007,,52,15,35,50
3008,3008,,52,1,0,1
3009,3009,,52,15,25,40
3010,3010,,52,9,13,22
3011,3011,,52,79,59,138
3012,3012,,14,8,31,39
3013,3013,,52,60,58,118
3014,3014,,23,61,85,146
3015,3015,,45,5,7,12
3016,3016,,66,0,7,7
3017,3017,,111,0,1,1
3018,3018,,111,19,8,27
3019,3019,,11,6,6,12
3020,3020,,11,13,5,18
3021,3021,,23,4,2,6
3022,3022,,23,3,5,8
3023,3023,,111,8,41,49
3024,3024,,8,3,0,3
3025,3025,,0,9,6,15
3026,3026,,21,4,4,8
3027,3027,,8,1,1,2
3028,3028,,8,5,4,9
3029,3029,,127,65,49,114
3030,3030,,88,3,4,7
3031,3031,,21,2,5,7
3032,3032,,23,18,20,38
3033,3033,,11,2,4,6
3034,3034,,21,0,4,4
3035,3035,,31,1,5,6
3036,3036,,23,32,33,65
3037,3037,,23,1,0,1
3038,3038,,3,3,6,9
3039,3039,,23,23,40,63
3040,3040,,21,2,10,12
3041,3041,,23,15,30,45
3042,3042,,11,4,5,9
3043,3043,,5,13,43,56
3044,3044,,88,55,68,123
3045,3045,,23,35,54,89
3046,3046,,23,6,11,17
3047,3047,,23,1,2,3
3048,3048,,23,19,18,37
3049,3049,,8,6,8,14
3050,3050,,15,1,1,2
3051,3051,,21,16,14,30
3052,3052,,45,53,8,61
3053,3053,,23,3,0,3
3054,3054,,45,2,2,4
3055,3055,,18,15,12,27
3056,3056,,18,5,6,11
3057,3057,,23,6,16,22
3058,3058,,11,3,10,13
3059,3059,,11,7,10,17
3060,3060,,11,15,11,26
3061,3061,,11,9,11,20
3062,3062,,21,4,9,13
3063,3063,,0,9,8,17
3064,3064,,0,3,6,9
3065,3065,,0,12,4,16
3066,3066,,3,1,3,4
3067,3067,,23,3,7,10
3068,3068,,3,19,16,35
3069,3069,,14,1,2,3
3070,3070,,21,2,5,7
3071,3071,,21,86,61,147
3072,3072,,11,22,17,39
3073,3073,,45,2,0,2
3074,3074,,3,0,1,1
3075,3075,,5,1,0,1
3076,3076,,23,10,16,26
3077,3077,,88,1,3,4
3078,3078,,88,25,11,36
3079,3079,,88,30,12,42
3080,3080,,88,4,0,4
3081,3081,,88,69,34,103
3082,3082,,120,14,17,31
3083,3083,,23,1,1,2
3084,3084,,23,23,89,112
3085,3085,,21,41,20,61
3086,3086,,23,4,10,14
3087,3087,,23,5,40,45
3088,3088,,8,4,5,9
3089,3089,,14,1,1,2
3090,3090,,14,11,29,40
3091,3091,,14,105,32,137
3092,3092,,127,2,0,2
3093,3093,,14,47,24,71
3094,3094,,23,34,26,60
3095,3095,,120,35,39,74
3096,3096,,120,4,1,5
3097,3097,,23,70,158,228
3098,3098,,23,24,33,57
3099,3099,,43,8,46,54
3100,3100,,43,28,93,121
3101,3101,,0,1,1,2
3102,3102,,23,61,117,178
3103,3103,,43,4,2,6
3104,3104,,23,24,21,45
3105,3105,,105,35,90,125
3106,3106,,5,7,22,29
3107,3107,,45,0,2,2
3108,3108,,45,1,0,1
3109,3109,,43,37,25,62
3110,3110,,8,62,106,168
3111,3111,,66,7,2,9
3112,3112,,43,43,60,103
3113,3113,,52,63,36,99
3114,3114,,43,4,3,7
3115,3115,,43,41,44,85
3116,3116,,43,1,0,1
3117,3117,,43,69,102,171
3118,3118,,43,1,4,5
3119,3119,,43,11,19,30
3120,3120,,43,8,25,33
3121,3121,,43,75,67,142
3122,3122,,43,6,2,8
3123,3123,,127,0,3,3
3124,3124,,127,0,1,1
3125,3125,,127,0,1,1
3126,3126,,76,1,0,1
3127,3127,,23,33,43,76
3128,3128,,8,0,10,10
3129,3129,,21,47,39,86
3130,3130,,3,0,1,1
3131,3131,,3,1,1,2
3132,3132,,23,15,72,87
3133,3133,,43,13,35,48
3134,3134,,14,19,42,61
3135,3135,,43,19,28,47
3136,3136,,43,3,2,5
3137,3137,,43,10,14,24
3138,3138,,43,14,8,22
3139,3139,,43,25,52,77
3140,3140,,76,15,64,79
3141,3141,,76,11,5,16
3142,3142,,76,19,27,46
3143,3143,,76,9,34,43
3144,3144,,76,10,19,29
3145,3145,,76,13,36,49
3146,3146,,23,1,17,18
3147,3147,,52,124,125,249
3148,3148,,23,198,246,444
3149,3149,,105,1,16,17
3150,3150,,23,42,62,104
3151,3151,,105,1,3,4
3152,3152,,24,0,4,4
3153,3153,,105,0,1,1
3154,3154,,111,3,3,6
3155,3155,,31,8,10,18
3156,3156,,31,8,17,25
3157,3157,,31,2,3,5
3158,3158,,23,1,8,9
3159,3159,,23,8,6,14
3160,3160,,21,1,1,2
3161,3161,,23,18,28,46
3162,3162,,23,1,1,2
3163,3163,,111,27,39,66
3164,3164,,0,4,7,11
3165,3165,,31,2,8,10
3166,3166,,31,9,6,15
3167,3167,,31,23,13,36
3168,3168,,31,6,10,16
3169,3169,,31,22,66,88
3170,3170,,23,6,2,8
3171,3171,,8,10,9,19
3172,3172,,3,6,3,9
3173,3173,,23,1,0,1
3174,3174,,23,30,7,37
3175,3175,,14,32,51,83
3176,3176,,23,0,1,1
3177,3177,,88,9,6,15
3178,3178,,88,11,20,31
3179,3179,,43,22,40,62
3180,3180,,23,14,13,27
3181,3181,,43,15,5,20
3182,3182,,31,3,5,8
3183,3183,,31,2,14,16
3184,3184,,31,0,1,1
3185,3185,,31,0,2,2
3186,3186,,31,2,0,2
3187,3187,,31,17,3,20
3188,3188,,31,2,3,5
3189,3189,,15,5,3,8
3190,3190,,127,21,23,44
3191,3191,,21,4,7,11
3192,3192,,0,1,0,1
3193,3193,,23,9,9,18
3194,3194,,23,10,14,24
3195,3195,,8,12,13,25
3196,3196,,8,4,3,7
3197,3197,,23,25,26,51
3198,3198,,105,27,41,68
3199,3199,,23,13,29,42
3200,3200,,23,5,0,5
3201,3201,,43,0,1,1
3202,3202,,105,1,5,6
3203,3203,,43,0,1,1
3204,3204,,8,0,1,1
3205,3205,,111,19,15,34
3206,3206,,111,41,34,75
3207,3207,,23,37,44,81
3208,3208,,127,95,46,141
3209,3209,,21,0,1,1
3210,3210,,23,16,12,28
3211,3211,,6,14,2,16
3212,3212,,14,12,3,15
3213,3213,,8,2,0,2
3214,3214,,14,73,64,137
3215,3215,,23,3,1,4
3216,3216,,23,53,71,124
3217,3217,,23,231,180,411
3218,3218,,15,3,5,8
3219,3219,,24,25,32,57
3220,3220,,11,57,37,94
3221,3221,,45,18,15,33
3222,3222,,23,3,5,8
3223,3223,,23,0,5,5
3224,3224,,45,15,29,44
3225,3225,,15,3,5,8
3226,3226,,15,51,62,113
3227,3227,,15,2,2,4
3228,3228,,111,16,8,24
3229,3229,,111,7,3,10
3230,3230,,0,5,49,54
3231,3231,,23,3,3,6
3232,3232,,21,0,1,1
3233,3233,,23,46,55,101
3234,3234,,15,5,6,11
3235,3235,,15,2,8,10
3236,3236,,8,18,31,49
3237,3237,,5,5,4,9
3238,3238,,31,93,142,235
3239,3239,,45,9,2,11
3240,3240,,31,20,60,80
3241,3241,,31,0,4,4
3242,3242,,0,9,6,15
3243,3243,,43,2,3,5
3244,3244,,88,18,1,19
3245,3245,,23,5,2,7
3246,3246,,8,2,0,2
3247,3247,,0,2,3,5
3248,3248,,23,27,56,83
3249,3249,,11,67,70,137
3250,3250,,23,18,24,42
3251,3251,,120,67,35,102
3252,3252,,0,11,8,19
3253,3253,,3,1,7,8
3254,3254,,3,3,0,3
3255,3255,,6,133,135,268
3256,3256,,23,1,0,1
3257,3257,,15,23,42,65
3258,3258,,24,8,17,25
3259,3259,,23,10,6,16
3260,3260,,23,6,2,8
3261,3261,,8,1,2,3
3262,3262,,8,3,9,12
3263,3263,,23,0,1,1
3264,3264,,15,13,5,18
3265,3265,,31,76,27,103
3266,3266,,15,11,5,16
3267,3267,,15,16,20,36
3268,3268,,0,0,1,1
3269,3269,,8,7,26,33
3270,3270,,11,0,1,1
3271,3271,,105,1,1,2
3272,3272,,23,26,27,53
3273,3273,,18,5,3,8
3274,3274,,5,5,3,8
3275,3275,,5,2,2,4
3276,3276,,5,432,625,1057
3277,3277,,0,97,23,120
3278,3278,,127,1,4,5
3279,3279,,0,38,50,88
3280,3280,,23,101,180,281
3281,3281,,127,7,4,11
3282,3282,,15,2,0,2
3283,3283,,23,4,11,15
3284,3284,,18,17,87,104
3285,3285,,18,7,1,8
3286,3286,,23,79,88,167
3287,3287,,8,5,8,13
3288,3288,,11,3,0,3
3289,3289,,18,8,2,10
3290,3290,,18,2,1,3
3291,3291,,23,19,31,50
3292,3292,,23,0,2,2
3293,3293,,0,90,55,145
3294,3294,,23,11,16,27
3295,3295,,15,1,2,3
3296,3296,,76,1,0,1
3297,3297,,23,56,83,139
3298,3298,,8,14,3,17
3299,3299,,11,1,0,1
3300,3300,,18,8,3,11
3301,3301,,18,1,0,1
3302,3302,,88,0,6,6
3303,3303,,105,40,82,122
3304,3304,,11,37,16,53
3305,3305,,127,0,1,1
3306,3306,,127,6,5,11
3307,3307,,111,93,149,242
3308,3308,,127,4,4,8
3309,3309,,127,4,2,6
3310,3310,,11,6,0,6
3311,3311,,23,34,32,66
3312,3312,,18,3,10,13
3313,3313,,18,14,10,24
3314,3314,,88,2,5,7
3315,3315,,23,5,6,11
3316,3316,,3,4,5,9
3317,3317,,43,53,67,120
3318,3318,,0,9,8,17
3319,3319,,0,8,25,33
3320,3320,,15,0,6,6
3321,3321,,76,91,136,227
3322,3322,,76,54,16,70
3323,3323,,76,0,1,1
3324,3324,,76,1,5,6
3325,3325,,45,0,4,4
3326,3326,,45,2,4,6
3327,3327,,45,3,2,5
3328,3328,,45,8,14,22
3329,3329,,45,4,3,7
3330,3330,,45,1,6,7
3331,3331,,8,47,31,78
3332,3332,,8,9,7,16
3333,3333,,23,2,2,4
3334,3334,,21,22,24,46
3335,3335,,21,3,6,9
3336,3336,,18,1,1,2
3337,3337,,43,16,15,31
3338,3338,,8,17,17,34
3339,3339,,21,4,6,10
3340,3340,,21,36,52,88
3341,3341,,11,0,1,1
3342,3342,,11,5,2,7
3343,3343,,15,1,1,2
3344,3344,,88,3,3,6
3345,3345,,88,3,3,6
3346,3346,,52,0,1,1
3347,3347,,52,3,12,15
3348,3348,,111,3,6,9
3349,3349,,23,18,14,32
3350,3350,,23,1,1,2
3351,3351,,23,14,31,45
3352,3352,,21,0,4,4
3353,3353,,0,1,44,45
3354,3354,,76,4,4,8
3355,3355,,105,12,11,23
3356,3356,,76,3,1,4
3357,3357,,11,1,4,5
3358,3358,,11,3,0,3
3359,3359,,0,10,26,36
3360,3360,,111,2,4,6
3361,3361,,8,0,4,4
3362,3362,,21,6,27,33
3363,3363,,15,13,37,50
3364,3364,,15,2,0,2
3365,3365,,0,16,51,67
3366,3366,,23,1,1,2
3367,3367,,23,6,4,10
3368,3368,,23,2,6,8
3369,3369,,3,13,7,20
3370,3370,,3,5,3,8
3371,3371,,23,36,108,144
3372,3372,,5,1,2,3
3373,3373,,5,14,3,17
3374,3374,,23,7,15,22
3375,3375,,88,80,12,92
3376,3376,,23,6,4,10
3377,3377,,11,17,26,43
3378,3378,,105,24,23,47
3379,3379,,127,0,3,3
3380,3380,,127,2,0,2
3381,3381,,127,4,0,4
3382,3382,,8,135,186,321
3383,3383,,21,41,37,78
3384,3384,,105,12,18,30
3385,3385,,21,15,23,38
3386,3386,,23,7,7,14
3387,3387,,23,20,42,62
3388,3388,,120,3,5,8
3389,3389,,23,2,2,4
3390,3390,,8,11,9,20
3391,3391,,8,18,34,52
3392,3392,,8,1,2,3
3393,3393,,14,29,37,66
3394,3394,,52,11,33,44
3395,3395,,52,11,5,16
3396,3396,,52,19,0,19
3397,3397,,8,0,4,4
3398,3398,,23,173,225,398
3399,3399,,127,2,5,7
3400,3400,,127,2,1,3
3401,3401,,3,23,35,58
3402,3402,,3,1,9,10
3403,3403,,66,5,35,40
3404,3404,,11,7,15,22
3405,3405,,15,11,5,16
3406,3406,,8,62,10,72
3407,3407,,8,2,0,2
3408,3408,,45,2,1,3
3409,3409,,45,10,45,55
3410,3410,,45,0,4,4
3411,3411,,45,5,1,6
3412,3412,,45,5,3,8
3413,3413,,21,80,21,101
3414,3414,,0,22,3,25
3415,3415,,23,6,8,14
3416,3416,,21,11,14,25
3417,3417,,21,93,79,172
3418,3418,,8,1,1,2
3419,3419,,0,9,11,20
3420,3420,,21,10,5,15
3421,3421,,11,0,1,1
3422,3422,,23,12,4,16
3423,3423,,23,77,143,220
3424,3424,,23,9,19,28
3425,3425,,23,4,11,15
3426,3426,,21,9,2,11
3427,3427,,5,5,4,9
3428,3428,,21,6,22,28
3429,3429,,127,1,2,3
3430,3430,,23,0,1,1
3431,3431,,14,1,2,3
3432,3432,,14,0,1,1
3433,3433,,14,6,21,27
3434,3434,,127,1,3,4
3435,3435,,3,45,10,55
3436,3436,,66,1,2,3
3437,3437,,5,1,0,1
3438,3438,,23,115,80,195
3439,3439,,43,9,8,17
3440,3440,,43,3,6,9
3441,3441,,43,2,3,5
3442,3442,,43,16,35,51
3443,3443,,8,8,7,15
3444,3444,,43,2,2,4
3445,3445,,43,10,25,35
3446,3446,,8,3,0,3
3447,3447,,21,109,95,204
3448,3448,,8,37,11,48
3449,3449,,0,20,107,127
3450,3450,,0,7,10,17
3451,3451,,6,12,5,17
3452,3452,,3,2,5,7
3453,3453,,3,2,0,2
3454,3454,,88,0,21,21
3455,3455,,88,2,1,3
3456,3456,,52,5,6,11
3457,3457,,8,6,3,9
3458,3458,,43,1,2,3
3459,3459,,23,107,160,267
3460,3460,,14,8,4,12
3461,3461,,14,4,3,7
3462,3462,,52,5,1,6
3463,3463,,23,11,7,18
3464,3464,,23,23,43,66
3465,3465,,127,2,6,8
3466,3466,,88,2,10,12
3467,3467,,88,0,12,12
3468,3468,,23,40,48,88
3469,3469,,88,8,3,11
3470,3470,,88,10,18,28
3471,3471,,88,5,15,20
3472,3472,,43,2,2,4
3473,3473,,105,1,16,17
3474,3474,,127,48,84,132
3475,3475,,21,0,1,1
3476,3476,,21,2,3,5
3477,3477,,8,0,1,1
3478,3478,,8,4,10,14
3479,3479,,24,17,25,42
3480,3480,,24,23,6,29
3481,3481,,5,13,16,29
3482,3482,,5,11,18,29
3483,3483,,0,9,3,12
3484,3484,,8,2,3,5
3485,3485,,43,1,22,23
3486,3486,,43,1,3,4
3487,3487,,23,0,2,2
3488,3488,,43,0,2,2
3489,3489,,23,3,6,9
3490,3490,,18,11,3,14
3491,3491,,11,0,27,27
3492,3492,,11,9,0,9
3493,3493,,14,4,25,29
3494,3494,,14,17,9,26
3495,3495,,43,8,48,56
3496,3496,,127,10,10,20
3497,3497,,0,9,5,14
3498,3498,,66,7,3,10
3499,3499,,88,4,0,4
3500,3500,,8,17,25,42
3501,3501,,43,1,1,2
3502,3502,,8,5,4,9
3503,3503,,8,5,8,13
3504,3504,,45,59,77,136
3505,3505,,8,1,11,12
3506,3506,,8,13,5,18
3507,3507,,43,1,1,2
3508,3508,,43,14,7,21
3509,3509,,43,2,3,5
3510,3510,,15,33,61,94
3511,3511,,8,3,5,8
3512,3512,,8,2,2,4
3513,3513,,5,24,9,33
3514,3514,,5,3,5,8
3515,3515,,43,0,1,1
3516,3516,,0,28,34,62
3517,3517,,11,0,1,1
3518,3518,,88,7,0,7
3519,3519,,23,0,1,1
3520,3520,,0,4,4,8
3521,3521,,52,0,4,4
3522,3522,,0,0,1,1
3523,3523,,21,0,2,2
3524,3524,,21,8,8,16
3525,3525,,111,3,2,5
3526,3526,,105,0,1,1
3527,3527,,105,10,8,18
3528,3528,,76,12,15,27
3529,3529,,127,16,5,21
3530,3530,,23,4,5,9
3531,3531,,23,10,19,29
3532,3532,,23,47,71,118
3533,3533,,12,0,1,1
3534,3534,,12,1,0,1
3535,3535,,31,16,43,59
3536,3536,,23,5,6,11
3537,3537,,31,30,21,51
3538,3538,,31,4,11,15
3539,3539,,31,32,42,74
3540,3540,,0,23,20,43
3541,3541,,127,3,10,13
3542,3542,,3,4,3,7
3543,3543,,23,7,13,20
3544,3544,,23,21,86,107
3545,3545,,5,57,72,129
3546,3546,,76,1,2,3
3547,3547,,105,7,16,23
3548,3548,,14,0,3,3
3549,3549,,14,2,1,3
3550,3550,,14,3,14,17
3551,3551,,127,28,27,55
3552,3552,,127,2,0,2
3553,3553,,23,0,2,2
3554,3554,,23,16,4,20
3555,3555,,45,3,8,11
3556,3556,,23,4,4,8
3557,3557,,111,3,9,12
3558,3558,,31,22,12,34
3559,3559,,8,2,8,10
3560,3560,,8,20,4,24
3561,3561,,14,2,1,3
3562,3562,,14,34,79,113
3563,3563,,14,1,14,15
3564,3564,,23,7,27,34
3565,3565,,23,0,1,1
3566,3566,,6,8,20,28
3567,3567,,6,5,2,7
3568,3568,,11,2,1,3
3569,3569,,23,10,36,46
3570,3570,,127,2,1,3
3571,3571,,105,3,1,4
3572,3572,,43,8,6,14
3573,3573,,105,1,6,7
3574,3574,,15,19,31,50
3575,3575,,15,32,15,47
3576,3576,,15,47,103,150
3577,3577,,111,8,4,12
3578,3578,,105,0,1,1
3579,3579,,8,11,26,37
3580,3580,,23,0,1,1
3581,3581,,8,4,2,6
3582,3582,,8,1,9,10
3583,3583,,8,11,3,14
3584,3584,,120,26,9,35
3585,3585,,120,11,8,19
3586,3586,,120,2,2,4
3587,3587,,31,4,11,15
3588,3588,,111,0,2,2
3589,3589,,111,4,1,5
3590,3590,,5,1,1,2
3591,3591,,23,8,12,20
3592,3592,,31,6,13,19
3593,3593,,8,0,2,2
3594,3594,,18,24,47,71
3595,3595,,14,14,31,45
3596,3596,,14,2,3,5
3597,3597,,15,1,2,3
3598,3598,,66,2,0,2
3599,3599,,23,9,16,25
3600,3600,,23,39,19,58
3601,3601,,23,37,52,89
3602,3602,,8,9,8,17
3603,3603,,8,0,5,5
3604,3604,,23,64,132,196
3605,3605,,23,3,1,4
3606,3606,,3,2,2,4
3607,3607,,31,4,10,14
3608,3608,,0,12,7,19
3609,3609,,8,36,15,51
3610,3610,,23,0,1,1
3611,3611,,127,1,3,4
3612,3612,,127,5,6,11
3613,3613,,11,0,2,2
3614,3614,,105,1,3,4
3615,3615,,8,43,66,109
3616,3616,,105,4,6,10
3617,3617,,105,17,45,62
3618,3618,,8,105,89,194
3619,3619,,31,1,6,7
3620,3620,,11,1,5,6
3621,3621,,18,9,8,17
3622,3622,,23,0,1,1
3623,3623,,127,12,9,21
3624,3624,,111,17,28,45
3625,3625,,14,8,8,16
3626,3626,,23,1,2,3
3627,3627,,23,1,4,5
3628,3628,,23,2,1,3
3629,3629,,23,4,7,11
3630,3630,,23,9,4,13
3631,3631,,3,6,14,20
3632,3632,,23,3,1,4
3633,3633,,111,15,22,37
3634,3634,,23,1,23,24
3635,3635,,127,6,6,12
3636,3636,,14,0,1,1
3637,3637,,14,4,12,16
3638,3638,,5,7,20,27
3639,3639,,5,2,2,4
3640,3640,,11,1,1,2
3641,3641,,11,4,0,4
3642,3642,,8,1,0,1
3643,3643,,45,0,2,2
3644,3644,,111,6,4,10
3645,3645,,8,1,0,1
3646,3646,,23,26,27,53
3647,3647,,23,59,57,116
3648,3648,,23,53,79,132
3649,3649,,88,40,23,63
3650,3650,,23,9,9,18
3651,3651,,23,1,0,1
3652,3652,,0,7,28,35
3653,3653,,23,3,2,5
3654,3654,,24,1,2,3
3655,3655,,111,1,1,2
3656,3656,,23,0,5,5
3657,3657,,23,13,5,18
3658,3658,,23,4,8,12
3659,3659,,23,13,6,19
3660,3660,,23,0,3,3
3661,3661,,0,7,9,16
3662,3662,,0,4,2,6
3663,3663,,8,9,14,23
3664,3664,,23,10,10,20
3665,3665,,23,2,9,11
3666,3666,,23,18,31,49
3667,3667,,23,4,7,11
3668,3668,,5,6,8,14
3669,3669,,5,8,16,24
3670,3670,,23,6,23,29
3671,3671,,8,1,3,4
3672,3672,,8,44,42,86
3673,3673,,111,3,9,12
3674,3674,,88,3,5,8
3675,3675,,88,1,2,3
3676,3676,,88,17,4,21
3677,3677,,11,42,21,63
3678,3678,,0,0,1,1
3679,3679,,11,0,3,3
3680,3680,,23,5,57,62
3681,3681,,8,1,9,10
3682,3682,,8,1,0,1
3683,3683,,8,3,5,8
3684,3684,,23,1,6,7
3685,3685,,23,3,5,8
3686,3686,,111,1,1,2
3687,3687,,5,11,1,12
3688,3688,,105,0,6,6
3689,3689,,18,4,2,6
3690,3690,,0,18,23,41
3691,3691,,11,1,1,2
3692,3692,,18,1,12,13
3693,3693,,24,1,6,7
3694,3694,,105,20,4,24
3695,3695,,88,3,10,13
3696,3696,,88,1,0,1
3697,3697,,15,14,22,36
3698,3698,,23,5,6,11
3699,3699,,111,2,0,2
3700,3700,,8,0,2,2
3701,3701,,23,1,4,5
3702,3702,,23,2,0,2
3703,3703,,18,6,10,16
3704,3704,,18,20,29,49
3705,3705,,8,11,12,23
3706,3706,,0,11,8,19
3707,3707,,105,39,35,74
3708,3708,,21,8,10,18
3709,3709,,8,2,16,18
3710,3710,,0,14,5,19
3711,3711,,45,5,11,16
3712,3712,,88,2,2,4
3713,3713,,23,16,14,30
3714,3714,,23,4,16,20
3715,3715,,11,0,3,3
3716,3716,,11,5,2,7
3717,3717,,45,1,0,1
3718,3718,,45,0,1,1
3719,3719,,45,0,1,1
3720,3720,,23,13,13,26
3721,3721,,23,0,1,1
3722,3722,,23,0,1,1
3723,3723,,0,10,15,25
3724,3724,,11,0,1,1
3725,3725,,24,6,6,12
3726,3726,,24,4,1,5
3727,3727,,24,5,2,7
3728,3728,,8,1,1,2
3729,3729,,8,5,1,6
3730,3730,,13,0,1,1
3731,3731,,13,1,0,1
3732,3732,,111,0,1,1
3733,3733,,6,0,2,2
3734,3734,,6,64,49,113
3735,3735,,3,6,3,9
3736,3736,,23,2,8,10
3737,3737,,105,45,23,68
3738,3738,,23,21,52,73
3739,3739,,23,1,6,7
3740,3740,,23,6,1,7
3741,3741,,15,0,1,1
3742,3742,,15,3,0,3
3743,3743,,18,6,10,16
3744,3744,,11,11,3,14
3745,3745,,76,4,6,10
3746,3746,,8,6,6,12
3747,3747,,23,5,26,31
3748,3748,,23,84,211,295
3749,3749,,3,7,19,26
3750,3750,,43,7,46,53
3751,3751,,18,0,21,21
3752,3752,,11,1,0,1
3753,3753,,23,33,40,73
3754,3754,,23,48,18,66
3755,3755,,11,32,40,72
3756,3756,,111,2,0,2
3757,3757,,11,0,6,6
3758,3758,,11,1,0,1
3759,3759,,23,17,14,31
3760,3760,,23,20,23,43
3761,3761,,23,1,1,2
3762,3762,,8,1,3,4
3763,3763,,127,2,1,3
3764,3764,,18,7,11,18
3765,3765,,8,1,1,2
3766,3766,,8,32,57,89
3767,3767,,45,13,45,58
3768,3768,,45,13,1,14
3769,3769,,11,9,12,21
3770,3770,,111,2,0,2
3771,3771,,21,7,5,12
3772,3772,,8,4,1,5
3773,3773,,5,38,16,54
3774,3774,,8,0,1,1
3775,3775,,8,0,1,1
3776,3776,,21,18,19,37
3777,3777,,8,7,9,16
3778,3778,,11,15,27,42
3779,3779,,8,4,0,4
3780,3780,,3,205,265,470
3781,3781,,15,4,4,8
3782,3782,,23,25,23,48
3783,3783,,23,27,23,50
3784,3784,,23,5,3,8
3785,3785,,23,1,2,3
3786,3786,,23,5,4,9
3787,3787,,52,2,11,13
3788,3788,,23,5,10,15
3789,3789,,52,3,3,6
3790,3790,,8,9,4,13
3791,3791,,8,5,0,5
3792,3792,,88,0,2,2
3793,3793,,8,2,5,7
3794,3794,,8,6,6,12
3795,3795,,23,50,57,107
3796,3796,,21,17,14,31
3797,3797,,23,1,3,4
3798,3798,,8,0,1,1
3799,3799,,3,1,0,1
3800,3800,,0,2,35,37
3801,3801,,18,14,20,34
3802,3802,,3,22,12,34
3803,3803,,127,0,1,1
3804,3804,,127,17,4,21
3805,3805,,127,1,1,2
3806,3806,,23,5,13,18
3807,3807,,23,3,7,10
3808,3808,,127,0,1,1
3809,3809,,15,6,16,22
3810,3810,,14,170,338,508
3811,3811,,5,1,3,4
3812,3812,,21,11,16,27
3813,3813,,23,6,5,11
3814,3814,,5,22,29,51
3815,3815,,5,23,30,53
3816,3816,,23,3,10,13
3817,3817,,23,119,104,223
3818,3818,,23,38,51,89
3819,3819,,0,82,16,98
3820,3820,,0,3,6,9
3821,3821,,11,5,8,13
3822,3822,,23,3,1,4
3823,3823,,0,11,9,20
3824,3824,,11,15,14,29
3825,3825,,0,2,1,3
3826,3826,,127,1,0,1
3827,3827,,11,12,15,27
3828,3828,,11,5,2,7
3829,3829,,5,1,0,1
3830,3830,,21,6,16,22
3831,3831,,21,42,46,88
3832,3832,,14,26,29,55
3833,3833,,21,1,1,2
3834,3834,,21,8,14,22
3835,3835,,66,0,15,15
3836,3836,,21,1,2,3
3837,3837,,21,13,8,21
3838,3838,,14,25,31,56
3839,3839,,43,2,0,2
3840,3840,,43,2,0,2
3841,3841,,43,30,31,61
3842,3842,,43,13,18,31
3843,3843,,43,2,3,5
3844,3844,,43,30,28,58
3845,3845,,52,3,5,8
3846,3846,,45,16,71,87
3847,3847,,23,3,12,15
3848,3848,,23,27,34,61
3849,3849,,11,56,32,88
3850,3850,,23,11,34,45
3851,3851,,8,13,2,15
3852,3852,,23,17,29,46
3853,3853,,66,1,1,2
3854,3854,,0,14,29,43
3855,3855,,0,1,2,3
3856,3856,,23,1,7,8
3857,3857,,23,12,15,27
3858,3858,,23,0,1,1
3859,3859,,14,43,4,47
3860,3860,,127,49,30,79
3861,3861,,14,6,6,12
3862,3862,,127,38,69,107
3863,3863,,23,2,1,3
3864,3864,,14,7,7,14
3865,3865,,8,4,4,8
3866,3866,,8,17,29,46
3867,3867,,8,0,2,2
3868,3868,,8,12,2,14
3869,3869,,88,36,50,86
3870,3870,,88,1,6,7
3871,3871,,88,2,4,6
3872,3872,,88,6,1,7
3873,3873,,23,33,50,83
3874,3874,,8,2,5,7
3875,3875,,3,29,25,54
3876,3876,,23,2,2,4
3877,3877,,3,1,5,6
3878,3878,,127,4,9,13
3879,3879,,43,1,0,1
3880,3880,,43,4,1,5
3881,3881,,14,22,60,82
3882,3882,,43,117,48,165
3883,3883,,43,1,1,2
3884,3884,,43,0,1,1
3885,3885,,105,7,21,28
3886,3886,,14,6,11,17
3887,3887,,43,11,14,25
3888,3888,,23,10,8,18
3889,3889,,5,0,9,9
3890,3890,,15,154,95,249
3891,3891,,52,0,1,1
3892,3892,,52,51,26,77
3893,3893,,76,35,24,59
3894,3894,,76,1,1,2
3895,3895,,76,48,10,58
3896,3896,,127,12,20,32
3897,3897,,0,14,16,30
3898,3898,,0,2,3,5
3899,3899,,0,3,0,3
3900,3900,,15,0,6,6
3901,3901,,15,1,1,2
3902,3902,,111,10,4,14
3903,3903,,8,10,5,15
3904,3904,,111,26,0,26
3905,3905,,76,7,2,9
3906,3906,,76,2,0,2
3907,3907,,88,6,11,17
3908,3908,,43,4,0,4
3909,3909,,66,4,7,11
3910,3910,,23,1,1,2
3911,3911,,23,0,2,2
3912,3912,,127,3,1,4
3913,3913,,127,5,2,7
3914,3914,,23,0,1,1
3915,3915,,23,1,2,3
3916,3916,,111,6,12,18
3917,3917,,111,1,2,3
3918,3918,,31,5,5,10
3919,3919,,23,14,9,23
3920,3920,,31,0,8,8
3921,3921,,31,7,4,11
3922,3922,,31,1,5,6
3923,3923,,0,1,2,3
3924,3924,,127,14,16,30
3925,3925,,127,19,4,23
3926,3926,,8,1,11,12
3927,3927,,127,13,16,29
3928,3928,,23,41,75,116
3929,3929,,23,127,97,224
3930,3930,,23,7,3,10
3931,3931,,31,12,5,17
3932,3932,,31,2,6,8
3933,3933,,31,26,24,50
3934,3934,,127,4,4,8
3935,3935,,23,3,8,11
3936,3936,,23,17,10,27
3937,3937,,23,2,3,5
3938,3938,,14,14,9,23
3939,3939,,23,0,17,17
3940,3940,,6,30,22,52
3941,3941,,105,0,1,1
3942,3942,,23,2,0,2
3943,3943,,23,3,4,7
3944,3944,,8,0,4,4
3945,3945,,23,17,9,26
3946,3946,,11,1,1,2
3947,3947,,127,0,2,2
3948,3948,,31,8,4,12
3949,3949,,31,6,34,40
3950,3950,,31,35,15,50
3951,3951,,111,0,7,7
3952,3952,,18,11,12,23
3953,3953,,6,26,37,63
3954,3954,,43,23,19,42
3955,3955,,43,25,14,39
3956,3956,,15,19,15,34
3957,3957,,88,33,42,75
3958,3958,,111,2,5,7
3959,3959,,31,0,2,2
3960,3960,,111,3,3,6
3961,3961,,23,1,0,1
3962,3962,,23,5,5,10
3963,3963,,23,29,23,52
3964,3964,,76,3,10,13
3965,3965,,23,5,0,5
3966,3966,,23,0,17,17
3967,3967,,23,11,12,23
3968,3968,,3,1,4,5
3969,3969,,23,2,1,3
3970,3970,,23,67,54,121
3971,3971,,23,6,8,14
3972,3972,,111,7,14,21
3973,3973,,31,3,25,28
3974,3974,,31,1,7,8
3975,3975,,8,15,20,35
3976,3976,,24,11,8,19
3977,3977,,18,1,3,4
3978,3978,,8,3,6,9
3979,3979,,14,30,8,38
3980,3980,,23,15,18,33
3981,3981,,23,12,17,29
3982,3982,,5,1,4,5
3983,3983,,127,8,15,23
3984,3984,,23,0,1,1
3985,3985,,23,21,21,42
3986,3986,,23,27,32,59
3987,3987,,76,0,4,4
3988,3988,,76,9,13,22
3989,3989,,76,15,23,38
3990,3990,,8,2,11,13
3991,3991,,15,3,1,4
3992,3992,,23,1,1,2
3993,3993,,11,0,3,3
3994,3994,,127,10,12,22
3995,3995,,0,4,10,14
3996,3996,,23,44,76,120
3997,3997,,8,15,14,29
3998,3998,,8,1,0,1
3999,3999,,31,10,14,24
4000,4000,,31,66,10,76
4001,4001,,31,10,27,37
4002,4002,,8,3,3,6
4003,4003,,8,21,31,52
4004,4004,,23,5,8,13
4005,4005,,105,23,4,27
4006,4006,,15,5,7,12
4007,4007,,45,9,3,12
4008,4008,,23,0,1,1
4009,4009,,23,54,56,110
4010,4010,,43,9,5,14
4011,4011,,15,17,24,41
4012,4012,,23,137,152,289
4013,4013,,21,2,3,5
4014,4014,,23,44,70,114
4015,4015,,15,15,4,19
4016,4016,,23,0,4,4
4017,4017,,23,28,44,72
4018,4018,,3,3,4,7
4019,4019,,11,0,8,8
4020,4020,,11,5,0,5
4021,4021,,23,3,4,7
4022,4022,,23,8,6,14
4023,4023,,23,15,15,30
4024,4024,,23,11,6,17
4025,4025,,111,3,7,10
4026,4026,,23,4,11,15
4027,4027,,43,20,13,33
4028,4028,,23,2,1,3
4029,4029,,23,2,5,7
4030,4030,,14,6,51,57
4031,4031,,8,3,5,8
4032,4032,,5,5,3,8
4033,4033,,5,2,0,2
4034,4034,,23,9,9,18
4035,4035,,76,26,34,60
4036,4036,,23,11,15,26
4037,4037,,23,10,11,21
4038,4038,,120,11,12,23
4039,4039,,8,4,3,7
4040,4040,,15,17,41,58
4041,4041,,23,11,31,42
4042,4042,,23,43,56,99
4043,4043,,23,18,41,59
4044,4044,,14,9,23,32
4045,4045,,23,0,1,1
4046,4046,,14,5,4,9
4047,4047,,45,0,2,2
4048,4048,,45,2,1,3
4049,4049,,45,2,6,8
4050,4050,,45,1,0,1
4051,4051,,45,2,1,3
4052,4052,,45,4,6,10
4053,4053,,45,1,0,1
4054,4054,,23,37,28,65
4055,4055,,23,5,12,17
4056,4056,,8,1,4,5
4057,4057,,23,3,2,5
4058,4058,,15,2,9,11
4059,4059,,15,70,77,147
4060,4060,,15,31,18,49
4061,4061,,15,3,0,3
4062,4062,,15,2,6,8
4063,4063,,105,9,10,19
4064,4064,,105,2,2,4
4065,4065,,105,20,22,42
4066,4066,,120,3,30,33
4067,4067,,21,1,3,4
4068,4068,,23,0,1,1
4069,4069,,127,2,1,3
4070,4070,,8,1,9,10
4071,4071,,8,20,14,34
4072,4072,,8,5,3,8
4073,4073,,15,10,14,24
4074,4074,,15,13,12,25
4075,4075,,88,19,0,19
4076,4076,,23,3,11,14
4077,4077,,21,8,5,13
4078,4078,,127,1,1,2
4079,4079,,111,10,40,50
4080,4080,,111,4,6,10
4081,4081,,111,3,1,4
4082,4082,,0,34,37,71
4083,4083,,23,0,1,1
4084,4084,,127,0,3,3
4085,4085,,127,1,1,2
4086,4086,,3,19,12,31
4087,4087,,5,0,2,2
4088,4088,,8,4,2,6
4089,4089,,8,0,4,4
4090,4090,,8,5,9,14
4091,4091,,15,37,32,69
4092,4092,,11,3,4,7
4093,4093,,45,13,4,17
4094,4094,,11,2,0,2
4095,4095,,23,115,160,275
4096,4096,,23,1,14,15
4097,4097,,52,8,37,45
4098,4098,,23,1,0,1
4099,4099,,52,81,236,317
4100,4100,,23,1,1,2
4101,4101,,23,48,110,158
4102,4102,,23,42,87,129
4103,4103,,24,0,2,2
4104,4104,,24,8,7,15
4105,4105,,3,0,1,1
4106,4106,,21,64,53,117
4107,4107,,127,3,11,14
4108,4108,,45,2,0,2
4109,4109,,11,14,13,27
4110,4110,,8,10,9,19
4111,4111,,23,12,27,39
4112,4112,,15,44,46,90
4113,4113,,0,0,1,1
4114,4114,,23,1,0,1
4115,4115,,88,23,43,66
4116,4116,,88,1,3,4
4117,4117,,8,38,75,113
4118,4118,,0,4,2,6
4119,4119,,5,21,47,68
4120,4120,,5,20,9,29
4121,4121,,21,0,1,1
4122,4122,,127,35,21,56
4123,4123,,127,4,4,8
4124,4124,,8,1,0,1
4125,4125,,0,1,1,2
4126,4126,,11,1,1,2
4127,4127,,23,8,5,13
4128,4128,,14,6,14,20
4129,4129,,23,22,11,33
4130,4130,,8,2,0,2
4131,4131,,43,0,2,2
4132,4132,,15,13,1,14
4133,4133,,23,3,14,17
4134,4134,,111,5,8,13
4135,4135,,21,4,2,6
4136,4136,,43,37,34,71
4137,4137,,43,7,40,47
4138,4138,,43,2,0,2
4139,4139,,43,33,33,66
4140,4140,,43,0,7,7
4141,4141,,43,1,0,1
4142,4142,,43,0,2,2
4143,4143,,43,2,5,7
4144,4144,,43,2,1,3
4145,4145,,43,4,14,18
4146,4146,,43,4,3,7
4147,4147,,66,4,18,22
4148,4148,,3,6,8,14
4149,4149,,21,1,1,2
4150,4150,,23,3,7,10
4151,4151,,21,7,15,22
4152,4152,,21,10,14,24
4153,4153,,23,113,164,277
4154,4154,,127,6,7,13
4155,4155,,127,5,3,8
4156,4156,,23,0,4,4
4157,4157,,127,3,5,8
4158,4158,,66,2,0,2
4159,4159,,11,2,3,5
4160,4160,,0,8,19,27
4161,4161,,23,19,103,122
4162,4162,,23,3,9,12
4163,4163,,23,14,12,26
4164,4164,,127,1,3,4
4165,4165,,23,0,2,2
4166,4166,,23,1,0,1
4167,4167,,21,5,4,9
4168,4168,,23,7,5,12
4169,4169,,3,10,15,25
4170,4170,,23,0,1,1
4171,4171,,23,46,26,72
4172,4172,,23,69,12,81
4173,4173,,23,13,15,28
4174,4174,,8,0,4,4
4175,4175,,23,1,1,2
4176,4176,,23,1,2,3
4177,4177,,23,1,1,2
4178,4178,,23,4,4,8
4179,4179,,5,11,3,14
4180,4180,,8,4,1,5
4181,4181,,43,2,14,16
4182,4182,,21,2,0,2
4183,4183,,21,7,5,12
4184,4184,,5,30,18,48
4185,4185,,23,9,7,16
4186,4186,,23,3,1,4
4187,4187,,23,0,1,1
4188,4188,,52,2,4,6
4189,4189,,14,27,4,31
4190,4190,,14,11,8,19
4191,4191,,23,4,1,5
4192,4192,,23,1,0,1
4193,4193,,23,22,9,31
4194,4194,,52,7,3,10
4195,4195,,52,2,4,6
4196,4196,,76,0,1,1
4197,4197,,120,14,57,71
4198,4198,,43,23,32,55
4199,4199,,18,20,22,42
4200,4200,,66,13,2,15
4201,4201,,66,5,0,5
4202,4202,,0,1,2,3
4203,4203,,0,11,24,35
4204,4204,,76,0,13,13
4205,4205,,76,2,3,5
4206,4206,,14,26,23,49
4207,4207,,0,74,26,100
4208,4208,,0,12,8,20
4209,4209,,23,0,1,1
4210,4210,,23,84,131,215
4211,4211,,14,11,17,28
4212,4212,,23,21,22,43
4213,4213,,127,31,22,53
4214,4214,,127,17,15,32
4215,4215,,127,0,2,2
4216,4216,,23,10,8,18
4217,4217,,127,4,3,7
4218,4218,,127,1,0,1
4219,4219,,76,31,10,41
4220,4220,,76,10,5,15
4221,4221,,23,18,16,34
4222,4222,,3,1,1,2
4223,4223,,43,0,1,1
4224,4224,,8,0,2,2
4225,4225,,8,8,8,16
4226,4226,,8,8,1,9
4227,4227,,0,3,3,6
4228,4228,,127,1,1,2
4229,4229,,127,6,5,11
4230,4230,,127,8,14,22
4231,4231,,31,1,5,6
4232,4232,,23,26,9,35
4233,4233,,127,4,4,8
4234,4234,,23,19,5,24
4235,4235,,23,4,6,10
4236,4236,,127,6,3,9
4237,4237,,43,9,13,22
4238,4238,,23,8,17,25
4239,4239,,23,1,13,14
4240,4240,,23,22,31,53
4241,4241,,23,2,0,2
4242,4242,,23,1,0,1
4243,4243,,15,11,6,17
4244,4244,,105,31,27,58
4245,4245,,105,0,9,9
4246,4246,,8,1,5,6
4247,4247,,8,1,1,2
4248,4248,,8,12,14,26
4249,4249,,23,4,2,6
4250,4250,,21,2,1,3
4251,4251,,3,65,38,103
4252,4252,,111,54,75,129
4253,4253,,111,1,3,4
4254,4254,,6,1,3,4
4255,4255,,8,0,1,1
4256,4256,,8,0,2,2
4257,4257,,18,1,1,2
4258,4258,,0,0,1,1
4259,4259,,0,1,2,3
4260,4260,,127,26,4,30
4261,4261,,14,4,13,17
4262,4262,,23,1,3,4
4263,4263,,18,5,2,7
4264,4264,,3,0,1,1
4265,4265,,3,2,0,2
4266,4266,,3,0,4,4
4267,4267,,3,6,0,6
4268,4268,,105,10,0,10
4269,4269,,23,17,15,32
4270,4270,,76,6,18,24
4271,4271,,88,9,3,12
4272,4272,,111,6,1,7
4273,4273,,111,11,43,54
4274,4274,,111,77,52,129
4275,4275,,8,21,4,25
4276,4276,,23,0,4,4
4277,4277,,8,10,3,13
4278,4278,,127,2,10,12
4279,4279,,127,1,0,1
4280,4280,,111,0,3,3
4281,4281,,23,5,4,9
4282,4282,,0,2,0,2
4283,4283,,11,3,2,5
4284,4284,,6,1,2,3
4285,4285,,23,5,3,8
4286,4286,,105,14,7,21
4287,4287,,23,0,3,3
4288,4288,,52,4,9,13
4289,4289,,0,10,12,22
4290,4290,,23,6,2,8
4291,4291,,15,13,4,17
4292,4292,,8,0,2,2
4293,4293,,127,5,8,13
4294,4294,,23,45,18,63
4295,4295,,11,0,4,4
4296,4296,,21,21,67,88
4297,4297,,76,35,39,74
4298,4298,,105,1,7,8
4299,4299,,23,1,4,5
4300,4300,,8,0,1,1
4301,4301,,8,0,5,5
4302,4302,,43,10,16,26
4303,4303,,23,9,13,22
4304,4304,,127,5,22,27
4305,4305,,105,53,19,72
4306,4306,,23,3,2,5
4307,4307,,15,32,41,73
4308,4308,,127,3,9,12
4309,4309,,18,3,1,4
4310,4310,,31,23,68,91
4311,4311,,120,24,55,79
4312,4312,,120,3,3,6
4313,4313,,120,1,0,1
4314,4314,,23,160,130,290
4315,4315,,23,1,6,7
4316,4316,,0,12,14,26
4317,4317,,23,1,1,2
4318,4318,,23,2,1,3
4319,4319,,105,9,1,10
4320,4320,,105,16,2,18
4321,4321,,31,6,10,16
4322,4322,,8,16,10,26
4323,4323,,8,1,0,1
4324,4324,,43,0,5,5
4325,4325,,23,21,8,29
4326,4326,,23,18,14,32
4327,4327,,88,14,49,63
4328,4328,,23,1,1,2
4329,4329,,23,25,19,44
4330,4330,,23,67,73,140
4331,4331,,127,1,3,4
4332,4332,,8,7,13,20
4333,4333,,23,29,32,61
4334,4334,,15,207,115,322
4335,4335,,15,21,22,43
4336,4336,,23,61,87,148
4337,4337,,23,9,14,23
4338,4338,,21,0,5,5
4339,4339,,111,0,4,4
4340,4340,,23,25,19,44
4341,4341,,6,2,0,2
4342,4342,,14,9,29,38
4343,4343,,31,1,9,10
4344,4344,,11,3,3,6
4345,4345,,31,4,6,10
4346,4346,,105,6,13,19
4347,4347,,0,0,2,2
4348,4348,,23,2,9,11
4349,4349,,8,4,5,9
4350,4350,,23,5,9,14
4351,4351,,6,4,7,11
4352,4352,,6,1,1,2
4353,4353,,23,3,4,7
4354,4354,,8,5,1,6
4355,4355,,43,0,1,1
4356,4356,,8,19,49,68
4357,4357,,23,2,13,15
4358,4358,,21,11,9,20
4359,4359,,43,51,75,126
4360,4360,,127,0,2,2
4361,4361,,127,1,0,1
4362,4362,,127,5,1,6
4363,4363,,8,0,3,3
4364,4364,,0,0,2,2
4365,4365,,15,7,12,19
4366,4366,,15,13,22,35
4367,4367,,23,33,6,39
4368,4368,,15,2,8,10
4369,4369,,23,9,13,22
4370,4370,,23,64,6,70
4371,4371,,6,5,7,12
4372,4372,,23,2,5,7
4373,4373,,23,5,4,9
4374,4374,,15,6,7,13
4375,4375,,3,0,9,9
4376,4376,,3,12,9,21
4377,4377,,21,13,18,31
4378,4378,,3,12,26,38
4379,4379,,43,4,11,15
4380,4380,,111,14,9,23
4381,4381,,23,9,12,21
4382,4382,,23,71,57,128
4383,4383,,111,7,4,11
4384,4384,,23,6,0,6
4385,4385,,23,2,3,5
4386,4386,,0,13,15,28
4387,4387,,0,11,2,13
4388,4388,,8,0,2,2
4389,4389,,18,2,5,7
4390,4390,,52,10,8,18
4391,4391,,52,1,2,3
4392,4392,,52,1,2,3
4393,4393,,24,3,1,4
4394,4394,,43,1,9,10
4395,4395,,76,14,6,20
4396,4396,,76,20,13,33
4397,4397,,76,13,8,21
4398,4398,,23,9,14,23
4399,4399,,3,28,12,40
4400,4400,,6,5,7,12
4401,4401,,111,4,12,16
4402,4402,,8,1,1,2
4403,4403,,127,5,7,12
4404,4404,,127,3,0,3
4405,4405,,5,40,27,67
4406,4406,,8,0,6,6
4407,4407,,23,41,34,75
4408,4408,,23,6,1,7
4409,4409,,23,0,2,2
4410,4410,,23,8,7,15
4411,4411,,21,0,1,1
4412,4412,,8,3,2,5
4413,4413,,11,0,1,1
4414,4414,,24,27,21,48
4415,4415,,8,2,1,3
4416,4416,,127,4,0,4
4417,4417,,127,1,7,8
4418,4418,,111,1,0,1
4419,4419,,111,2,4,6
4420,4420,,111,8,11,19
4421,4421,,23,48,93,141
4422,4422,,8,19,12,31
4423,4423,,127,0,2,2
4424,4424,,15,1,11,12
4425,4425,,111,3,3,6
4426,4426,,23,11,9,20
4427,4427,,23,3,2,5
4428,4428,,23,9,20,29
4429,4429,,23,26,44,70
4430,4430,,5,1,5,6
4431,4431,,43,0,3,3
4432,4432,,43,0,1,1
4433,4433,,11,16,31,47
4434,4434,,88,0,4,4
4435,4435,,3,5,12,17
4436,4436,,11,1,1,2
4437,4437,,23,1,0,1
4438,4438,,15,8,19,27
4439,4439,,105,1,1,2
4440,4440,,11,1,2,3
4441,4441,,11,11,16,27
4442,4442,,23,0,1,1
4443,4443,,8,0,4,4
4444,4444,,52,14,7,21
4445,4445,,23,1,1,2
4446,4446,,127,0,10,10
4447,4447,,23,17,22,39
4448,4448,,21,5,14,19
4449,4449,,23,5,0,5
4450,4450,,23,12,0,12
4451,4451,,3,6,4,10
4452,4452,,3,15,3,18
4453,4453,,23,1,0,1
4454,4454,,120,9,4,13
4455,4455,,43,8,11,19
4456,4456,,5,11,37,48
4457,4457,,8,5,24,29
4458,4458,,0,30,46,76
4459,4459,,0,2,3,5
4460,4460,,23,8,9,17
4461,4461,,11,0,7,7
4462,4462,,23,11,13,24
4463,4463,,8,3,10,13
4464,4464,,8,63,85,148
4465,4465,,18,2,0,2
4466,4466,,23,7,14,21
4467,4467,,127,2,2,4
4468,4468,,111,4,0,4
4469,4469,,43,7,11,18
4470,4470,,43,2,0,2
4471,4471,,43,1,0,1
4472,4472,,105,8,13,21
4473,4473,,43,24,24,48
4474,4474,,21,1,1,2
4475,4475,,21,11,10,21
4476,4476,,21,15,5,20
4477,4477,,127,2,3,5
4478,4478,,21,6,15,21
4479,4479,,127,10,3,13
4480,4480,,127,0,1,1
4481,4481,,127,33,41,74
4482,4482,,23,1,1,2
4483,4483,,0,9,16,25
4484,4484,,23,0,3,3
4485,4485,,23,1,3,4
4486,4486,,66,52,12,64
4487,4487,,45,0,2,2
4488,4488,,45,4,3,7
4489,4489,,52,20,31,51
4490,4490,,88,9,6,15
4491,4491,,88,1,2,3
4492,4492,,11,2,4,6
4493,4493,,88,16,30,46
4494,4494,,127,0,2,2
4495,4495,,66,0,2,2
4496,4496,,66,4,0,4
4497,4497,,127,9,13,22
4498,4498,,127,4,3,7
4499,4499,,14,0,1,1
4500,4500,,5,4,8,12
4501,4501,,66,14,26,40
4502,4502,,3,9,28,37
4503,4503,,14,36,29,65
4504,4504,,127,9,7,16
4505,4505,,127,4,5,9
4506,4506,,23,9,29,38
4507,4507,,23,0,3,3
4508,4508,,14,18,4,22
4509,4509,,120,15,16,31
4510,4510,,120,14,5,19
4511,4511,,23,57,91,148
4512,4512,,66,1,8,9
4513,4513,,127,17,24,41
4514,4514,,43,4,1,5
4515,4515,,8,4,6,10
4516,4516,,8,17,9,26
4517,4517,,43,3,3,6
4518,4518,,43,8,14,22
4519,4519,,43,1,0,1
4520,4520,,8,5,8,13
4521,4521,,15,24,44,68
4522,4522,,15,3,7,10
4523,4523,,23,8,23,31
4524,4524,,23,9,3,12
4525,4525,,127,31,26,57
4526,4526,,76,7,1,8
4527,4527,,76,70,5,75
4528,4528,,14,1,0,1
4529,4529,,14,0,1,1
4530,4530,,14,6,1,7
4531,4531,,43,7,5,12
4532,4532,,43,1,0,1
4533,4533,,0,5,12,17
4534,4534,,105,2,3,5
4535,4535,,105,8,3,11
4536,4536,,105,18,12,30
4537,4537,,76,18,14,32
4538,4538,,76,11,35,46
4539,4539,,0,43,54,97
4540,4540,,23,31,48,79
4541,4541,,23,7,14,21
4542,4542,,8,3,9,12
4543,4543,,23,8,30,38
4544,4544,,127,2,8,10
4545,4545,,127,3,0,3
4546,4546,,23,2,2,4
4547,4547,,43,2,2,4
4548,4548,,14,7,15,22
4549,4549,,14,1,4,5
4550,4550,,14,12,3,15
4551,4551,,21,1,1,2
4552,4552,,21,1,0,1
4553,4553,,23,19,19,38
4554,4554,,14,6,3,9
4555,4555,,127,1,2,3
4556,4556,,127,1,3,4
4557,4557,,14,16,26,42
4558,4558,,8,2,3,5
4559,4559,,8,112,91,203
4560,4560,,8,3,0,3
4561,4561,,23,15,2,17
4562,4562,,23,13,11,24
4563,4563,,111,0,2,2
4564,4564,,0,6,2,8
4565,4565,,111,19,18,37
4566,4566,,0,6,2,8
4567,4567,,23,10,9,19
4568,4568,,45,10,2,12
4569,4569,,23,5,3,8
4570,4570,,8,35,17,52
4571,4571,,8,16,36,52
4572,4572,,5,17,26,43
4573,4573,,5,32,26,58
4574,4574,,5,27,40,67
4575,4575,,3,0,1,1
4576,4576,,43,2,14,16
4577,4577,,105,2,2,4
4578,4578,,15,24,55,79
4579,4579,,76,0,4,4
4580,4580,,76,18,15,33
4581,4581,,76,1,0,1
4582,4582,,11,12,5,17
4583,4583,,127,4,0,4
4584,4584,,23,17,25,42
4585,4585,,21,7,52,59
4586,4586,,11,2,2,4
4587,4587,,15,2,7,9
4588,4588,,0,76,33,109
4589,4589,,8,5,3,8
4590,4590,,31,10,5,15
4591,4591,,8,3,20,23
4592,4592,,45,1,1,2
4593,4593,,3,6,14,20
4594,4594,,66,3,4,7
4595,4595,,15,14,22,36
4596,4596,,15,1,2,3
4597,4597,,0,5,9,14
4598,4598,,8,3,3,6
4599,4599,,127,0,2,2
4600,4600,,3,12,38,50
4601,4601,,23,0,1,1
4602,4602,,0,32,17,49
4603,4603,,8,1,0,1
4604,4604,,23,13,16,29
4605,4605,,21,1,5,6
4606,4606,,21,2,0,2
4607,4607,,21,3,5,8
4608,4608,,21,7,9,16
4609,4609,,43,21,21,42
4610,4610,,105,0,1,1
4611,4611,,105,16,3,19
4612,4612,,43,0,2,2
4613,4613,,15,1,2,3
4614,4614,,15,14,12,26
4615,4615,,3,8,9,17
4616,4616,,66,1,0,1
4617,4617,,43,0,4,4
4618,4618,,23,2,2,4
4619,4619,,8,6,4,10
4620,4620,,23,5,6,11
4621,4621,,127,7,24,31
4622,4622,,66,62,34,96
4623,4623,,11,6,15,21
4624,4624,,105,9,12,21
4625,4625,,8,4,0,4
4626,4626,,23,0,1,1
4627,4627,,45,11,18,29
4628,4628,,88,13,3,16
4629,4629,,8,5,6,11
4630,4630,,43,24,13,37
4631,4631,,43,2,2,4
4632,4632,,43,27,4,31
4633,4633,,23,0,1,1
4634,4634,,8,1,1,2
4635,4635,,8,3,3,6
4636,4636,,8,5,6,11
4637,4637,,66,6,0,6
4638,4638,,66,4,0,4
4639,4639,,21,0,2,2
4640,4640,,21,4,0,4
4641,4641,,88,0,2,2
4642,4642,,88,3,9,12
4643,4643,,21,50,80,130
4644,4644,,3,5,7,12
4645,4645,,43,15,52,67
4646,4646,,0,5,8,13
4647,4647,,11,0,1,1
4648,4648,,8,0,1,1
4649,4649,,105,1,10,11
4650,4650,,105,12,10,22
4651,4651,,14,0,1,1
4652,4652,,127,6,6,12
4653,4653,,23,12,17,29
4654,4654,,23,15,32,47
4655,4655,,23,202,161,363
4656,4656,,21,5,16,21
4657,4657,,0,1,3,4
4658,4658,,0,17,8,25
4659,4659,,105,17,14,31
4660,4660,,23,17,23,40
4661,4661,,127,6,0,6
4662,4662,,23,8,1,9
4663,4663,,23,3,15,18
4664,4664,,23,30,55,85
4665,4665,,21,10,6,16
4666,4666,,11,0,1,1
4667,4667,,0,1,4,5
4668,4668,,8,2,3,5
4669,4669,,14,11,12,23
4670,4670,,14,25,15,40
4671,4671,,14,6,6,12
4672,4672,,14,7,8,15
4673,4673,,15,0,1,1
4674,4674,,3,1,4,5
4675,4675,,23,0,1,1
4676,4676,,120,8,14,22
4677,4677,,120,2,1,3
4678,4678,,14,13,3,16
4679,4679,,14,7,2,9
4680,4680,,8,10,13,23
4681,4681,,11,0,2,2
4682,4682,,11,11,39,50
4683,4683,,11,18,11,29
4684,4684,,23,7,7,14
4685,4685,,18,0,1,1
4686,4686,,18,13,19,32
4687,4687,,76,1,3,4
4688,4688,,23,42,31,73
4689,4689,,5,2,2,4
4690,4690,,3,1,0,1
4691,4691,,3,3,0,3
4692,4692,,43,5,13,18
4693,4693,,43,10,2,12
4694,4694,,15,0,1,1
4695,4695,,8,1,0,1
4696,4696,,23,10,3,13
4697,4697,,8,22,27,49
4698,4698,,8,1,4,5
4699,4699,,8,16,2,18
4700,4700,,23,11,3,14
4701,4701,,8,4,15,19
4702,4702,,3,6,9,15
4703,4703,,23,0,4,4
4704,4704,,23,8,1,9
4705,4705,,0,4,8,12
4706,4706,,24,14,11,25
4707,4707,,8,4,5,9
4708,4708,,8,1,1,2
4709,4709,,8,0,1,1
4710,4710,,76,35,12,47
4711,4711,,3,4,8,12
4712,4712,,76,3,2,5
4713,4713,,8,4,7,11
4714,4714,,23,2,1,3
4715,4715,,23,4,6,10
4716,4716,,23,1,3,4
4717,4717,,8,1,1,2
4718,4718,,8,1,0,1
4719,4719,,23,62,72,134
4720,4720,,15,1,3,4
4721,4721,,8,1,0,1
4722,4722,,23,0,4,4
4723,4723,,3,0,1,1
4724,4724,,8,15,35,50
4725,4725,,88,0,1,1
4726,4726,,23,7,9,16
4727,4727,,52,6,4,10
4728,4728,,8,10,1,11
4729,4729,,76,10,12,22
4730,4730,,23,33,45,78
4731,4731,,8,5,1,6
4732,4732,,11,1,0,1
4733,4733,,11,60,38,98
4734,4734,,23,16,65,81
4735,4735,,0,89,43,132
4736,4736,,45,16,16,32
4737,4737,,45,3,3,6
4738,4738,,45,0,2,2
4739,4739,,11,4,3,7
4740,4740,,0,15,14,29
4741,4741,,11,10,15,25
4742,4742,,45,0,3,3
4743,4743,,8,1,2,3
4744,4744,,8,4,3,7
4745,4745,,23,9,36,45
4746,4746,,8,8,40,48
4747,4747,,8,57,51,108
4748,4748,,43,11,6,17
4749,4749,,45,0,3,3
4750,4750,,105,2,1,3
4751,4751,,105,4,4,8
4752,4752,,23,3,3,6
4753,4753,,43,2,3,5
4754,4754,,105,1,24,25
4755,4755,,66,69,57,126
4756,4756,,3,3,0,3
4757,4757,,8,1,1,2
4758,4758,,5,16,26,42
4759,4759,,0,18,53,71
4760,4760,,21,12,32,44
4761,4761,,14,0,1,1
4762,4762,,14,3,6,9
4763,4763,,8,4,9,13
4764,4764,,127,2,5,7
4765,4765,,8,11,14,25
4766,4766,,88,8,28,36
4767,4767,,127,8,24,32
4768,4768,,88,13,6,19
4769,4769,,21,3,2,5
4770,4770,,23,1,2,3
4771,4771,,14,7,7,14
4772,4772,,52,44,29,73
4773,4773,,43,31,7,38
4774,4774,,43,2,1,3
4775,4775,,43,6,6,12
4776,4776,,14,13,2,15
4777,4777,,0,82,60,142
4778,4778,,5,9,7,16
4779,4779,,43,0,6,6
4780,4780,,23,2,4,6
4781,4781,,43,4,0,4
4782,4782,,0,43,20,63
4783,4783,,23,0,2,2
4784,4784,,23,2,1,3
4785,4785,,111,1,3,4
4786,4786,,111,15,23,38
4787,4787,,0,15,4,19
4788,4788,,111,0,2,2
4789,4789,,3,9,9,18
4790,4790,,11,0,1,1
4791,4791,,11,4,2,6
4792,4792,,11,14,14,28
4793,4793,,23,3,2,5
4794,4794,,23,6,34,40
4795,4795,,14,0,2,2
4796,4796,,3,3,2,5
4797,4797,,15,2,8,10
4798,4798,,52,11,17,28
4799,4799,,23,1,1,2
4800,4800,,23,1,3,4
4801,4801,,127,0,2,2
4802,4802,,14,0,1,1
4803,4803,,11,4,5,9
4804,4804,,23,6,7,13
4805,4805,,11,16,22,38
4806,4806,,105,6,6,12
4807,4807,,0,5,6,11
4808,4808,,18,0,1,1
4809,4809,,120,1,3,4
4810,4810,,120,12,19,31
4811,4811,,0,5,2,7
4812,4812,,105,2,0,2
4813,4813,,23,18,9,27
4814,4814,,23,3,3,6
4815,4815,,23,17,23,40
4816,4816,,23,18,18,36
4817,4817,,23,1,1,2
4818,4818,,23,5,10,15
4819,4819,,23,12,28,40
4820,4820,,127,0,2,2
4821,4821,,105,1,3,4
4822,4822,,8,3,1,4
4823,4823,,120,10,4,14
4824,4824,,23,0,1,1
4825,4825,,43,1,2,3
4826,4826,,8,0,1,1
4827,4827,,23,5,7,12
4828,4828,,23,4,5,9
4829,4829,,43,1,2,3
4830,4830,,21,0,3,3
4831,4831,,21,6,6,12
4832,4832,,45,1,0,1
4833,4833,,45,1,0,1
4834,4834,,8,2,6,8
4835,4835,,23,18,18,36
4836,4836,,88,2,1,3
4837,4837,,88,4,3,7
4838,4838,,24,0,2,2
4839,4839,,15,4,2,6
4840,4840,,8,4,4,8
4841,4841,,8,0,2,2
4842,4842,,8,2,4,6
4843,4843,,8,7,8,15
4844,4844,,23,3,5,8
4845,4845,,0,13,50,63
4846,4846,,8,1,0,1
4847,4847,,8,33,56,89
4848,4848,,76,1,1,2
4849,4849,,76,4,6,10
4850,4850,,23,10,17,27
4851,4851,,15,4,4,8
4852,4852,,23,2,30,32
4853,4853,,127,13,16,29
4854,4854,,3,3,3,6
4855,4855,,8,1,1,2
4856,4856,,15,111,70,181
4857,4857,,127,1,4,5
4858,4858,,127,5,6,11
4859,4859,,24,1,0,1
4860,4860,,15,7,5,12
4861,4861,,8,3,10,13
4862,4862,,15,24,17,41
4863,4863,,23,10,14,24
4864,4864,,23,6,7,13
4865,4865,,23,6,7,13
4866,4866,,76,5,3,8
4867,4867,,14,1,5,6
4868,4868,,23,9,59,68
4869,4869,,23,3,2,5
4870,4870,,0,1,0,1
4871,4871,,8,0,1,1
4872,4872,,31,16,21,37
4873,4873,,8,14,39,53
4874,4874,,8,3,3,6
4875,4875,,23,3,2,5
4876,4876,,76,9,7,16
4877,4877,,23,2,2,4
4878,4878,,111,14,9,23
4879,4879,,21,8,7,15
4880,4880,,21,1,0,1
4881,4881,,0,15,7,22
4882,4882,,8,9,7,16
4883,4883,,105,3,1,4
4884,4884,,24,0,1,1
4885,4885,,111,0,5,5
4886,4886,,43,1,3,4
4887,4887,,23,6,3,9
4888,4888,,11,16,44,60
4889,4889,,23,5,7,12
4890,4890,,23,3,20,23
4891,4891,,8,41,38,79
4892,4892,,8,2,0,2
4893,4893,,6,68,16,84
4894,4894,,6,3,1,4
4895,4895,,23,19,39,58
4896,4896,,105,6,13,19
4897,4897,,11,10,51,61
4898,4898,,11,3,1,4
4899,4899,,11,8,16,24
4900,4900,,18,3,13,16
4901,4901,,18,1,0,1
4902,4902,,14,1,0,1
4903,4903,,5,23,30,53
4904,4904,,5,9,9,18
4905,4905,,23,17,26,43
4906,4906,,23,2,7,9
4907,4907,,23,1,2,3
4908,4908,,23,116,144,260
4909,4909,,8,7,21,28
4910,4910,,0,20,27,47
4911,4911,,11,1,7,8
4912,4912,,8,4,4,8
4913,4913,,8,1,5,6
4914,4914,,11,20,14,34
4915,4915,,14,1,0,1
4916,4916,,0,3,1,4
4917,4917,,0,2,2,4
4918,4918,,8,16,0,16
4919,4919,,194,4,12,16
4920,4920,,11,36,6,42
4921,4921,,8,0,2,2
4922,4922,,8,1,5,6
4923,4923,,23,58,42,100
4924,4924,,15,4,1,5
4925,4925,,23,6,12,18
4926,4926,,15,11,7,18
4927,4927,,76,0,3,3
4928,4928,,3,46,36,82
4929,4929,,8,44,15,59
4930,4930,,31,12,7,19
4931,4931,,127,2,0,2
4932,4932,,23,37,15,52
4933,4933,,21,1,1,2
4934,4934,,111,3,6,9
4935,4935,,14,21,27,48
4936,4936,,105,0,1,1
4937,4937,,105,2,0,2
4938,4938,,21,15,30,45
4939,4939,,21,18,14,32
4940,4940,,11,2,20,22
4941,4941,,11,2,0,2
4942,4942,,14,4,3,7
4943,4943,,105,6,8,14
4944,4944,,23,2,2,4
4945,4945,,23,0,1,1
4946,4946,,5,11,2,13
4947,4947,,105,3,15,18
4948,4948,,127,44,66,110
4949,4949,,11,2,7,9
4950,4950,,11,2,0,2
4951,4951,,3,38,30,68
4952,4952,,23,1,10,11
4953,4953,,8,0,3,3
4954,4954,,111,23,37,60
4955,4955,,111,10,5,15
4956,4956,,8,3,2,5
4957,4957,,8,6,4,10
4958,4958,,43,0,1,1
4959,4959,,43,1,1,2
4960,4960,,31,0,2,2
4961,4961,,127,8,8,16
4962,4962,,31,13,0,13
4963,4963,,6,4,4,8
4964,4964,,23,5,5,10
4965,4965,,18,4,6,10
4966,4966,,11,5,7,12
4967,4967,,11,6,1,7
4968,4968,,31,9,10,19
4969,4969,,8,4,3,7
4970,4970,,24,12,18,30
4971,4971,,23,9,18,27
4972,4972,,23,7,4,11
4973,4973,,21,0,1,1
4974,4974,,23,1,0,1
4975,4975,,23,3,0,3
4976,4976,,76,0,2,2
4977,4977,,23,125,71,196
4978,4978,,8,6,8,14
4979,4979,,0,8,4,12
4980,4980,,5,20,24,44
4981,4981,,21,22,24,46
4982,4982,,23,4,22,26
4983,4983,,18,1,6,7
4984,4984,,18,1,0,1
4985,4985,,8,3,4,7
4986,4986,,45,23,36,59
4987,4987,,8,1,2,3
4988,4988,,24,5,0,5
4989,4989,,23,6,3,9
4990,4990,,8,12,8,20
4991,4991,,23,55,34,89
4992,4992,,45,2,2,4
4993,4993,,45,4,4,8
4994,4994,,45,9,2,11
4995,4995,,45,2,1,3
4996,4996,,8,0,9,9
4997,4997,,21,2,10,12
4998,4998,,66,3,6,9
4999,4999,,11,2,1,3
5000,5000,,11,0,2,2
5001,5001,,11,1,1,2
5002,5002,,52,3,0,3
5003,5003,,23,2,9,11
5004,5004,,105,21,31,52
5005,5005,,45,0,1,1
5006,5006,,45,25,12,37
5007,5007,,45,38,26,64
5008,5008,,45,1,0,1
5009,5009,,23,7,5,12
5010,5010,,8,10,19,29
5011,5011,,18,0,2,2
5012,5012,,23,6,5,11
5013,5013,,23,10,10,20
5014,5014,,15,5,4,9
5015,5015,,21,15,14,29
5016,5016,,18,3,4,7
5017,5017,,18,2,3,5
5018,5018,,45,2,2,4
5019,5019,,15,6,8,14
5020,5020,,23,1,1,2
5021,5021,,23,32,8,40
5022,5022,,21,22,8,30
5023,5023,,31,5,4,9
5024,5024,,43,1,1,2
5025,5025,,23,2,5,7
5026,5026,,0,8,2,10
5027,5027,,15,4,1,5
5028,5028,,15,1,4,5
5029,5029,,111,14,12,26
5030,5030,,21,3,3,6
5031,5031,,21,5,4,9
5032,5032,,6,29,18,47
5033,5033,,16,0,1,1
5034,5034,,16,1,0,1
5035,5035,,8,4,0,4
5036,5036,,15,3,2,5
5037,5037,,0,2,19,21
5038,5038,,0,1,0,1
5039,5039,,0,3,1,4
5040,5040,,23,0,1,1
5041,5041,,0,93,115,208
5042,5042,,0,8,7,15
5043,5043,,0,18,75,93
5044,5044,,21,2,1,3
5045,5045,,3,3,14,17
5046,5046,,66,2,0,2
5047,5047,,14,10,8,18
5048,5048,,14,20,24,44
5049,5049,,21,7,18,25
5050,5050,,3,2,0,2
5051,5051,,3,1,4,5
5052,5052,,23,0,1,1
5053,5053,,24,1,4,5
5054,5054,,24,2,5,7
5055,5055,,8,6,5,11
5056,5056,,23,9,3,12
5057,5057,,11,42,44,86
5058,5058,,66,0,4,4
5059,5059,,43,0,1,1
5060,5060,,43,20,40,60
5061,5061,,43,9,5,14
5062,5062,,43,21,57,78
5063,5063,,8,20,23,43
5064,5064,,66,0,1,1
5065,5065,,66,4,3,7
5066,5066,,23,7,0,7
5067,5067,,21,6,4,10
5068,5068,,23,0,1,1
5069,5069,,21,4,7,11
5070,5070,,21,16,14,30
5071,5071,,31,3,0,3
5072,5072,,31,2,2,4
5073,5073,,21,1,17,18
5074,5074,,5,30,16,46
5075,5075,,15,23,33,56
5076,5076,,15,6,5,11
5077,5077,,23,10,17,27
5078,5078,,105,2,1,3
5079,5079,,11,9,20,29
5080,5080,,21,7,5,12
5081,5081,,21,17,27,44
5082,5082,,21,1,0,1
5083,5083,,21,0,2,2
5084,5084,,21,7,7,14
5085,5085,,15,1,5,6
5086,5086,,43,1,4,5
5087,5087,,127,4,6,10
5088,5088,,21,2,12,14
5089,5089,,43,12,12,24
5090,5090,,21,11,41,52
5091,5091,,21,2,1,3
5092,5092,,21,2,3,5
5093,5093,,21,9,4,13
5094,5094,,43,35,54,89
5095,5095,,0,5,2,7
5096,5096,,23,7,0,7
5097,5097,,43,19,10,29
5098,5098,,66,4,2,6
5099,5099,,66,3,11,14
5100,5100,,3,6,2,8
5101,5101,,3,2,1,3
5102,5102,,8,16,3,19
5103,5103,,23,1,0,1
5104,5104,,43,47,68,115
5105,5105,,43,8,2,10
5106,5106,,43,8,10,18
5107,5107,,43,0,2,2
5108,5108,,3,6,12,18
5109,5109,,3,2,4,6
5110,5110,,23,45,43,88
5111,5111,,8,4,0,4
5112,5112,,21,1,2,3
5113,5113,,76,54,62,116
5114,5114,,45,1,6,7
5115,5115,,14,26,21,47
5116,5116,,111,0,3,3
5117,5117,,21,1,1,2
5118,5118,,21,23,16,39
5119,5119,,23,35,28,63
5120,5120,,76,1,1,2
5121,5121,,8,10,25,35
5122,5122,,14,4,10,14
5123,5123,,14,44,19,63
5124,5124,,8,0,1,1
5125,5125,,11,0,1,1
5126,5126,,23,14,17,31
5127,5127,,24,3,13,16
5128,5128,,23,0,1,1
5129,5129,,23,4,4,8
5130,5130,,3,1,10,11
5131,5131,,3,14,25,39
5132,5132,,3,10,6,16
5133,5133,,23,2,1,3
5134,5134,,31,1,1,2
5135,5135,,14,3,2,5
5136,5136,,105,0,2,2
5137,5137,,21,17,9,26
5138,5138,,52,11,21,32
5139,5139,,23,16,26,42
5140,5140,,23,4,4,8
5141,5141,,14,0,4,4
5142,5142,,8,23,29,52
5143,5143,,23,7,0,7
5144,5144,,31,1,0,1
5145,5145,,31,4,4,8
5146,5146,,120,10,12,22
5147,5147,,120,6,6,12
5148,5148,,23,2,3,5
5149,5149,,23,6,6,12
5150,5150,,5,2,7,9
5151,5151,,5,1,0,1
5152,5152,,18,31,29,60
5153,5153,,43,6,30,36
5154,5154,,43,4,2,6
5155,5155,,15,1,0,1
5156,5156,,23,6,9,15
5157,5157,,23,1,0,1
5158,5158,,15,0,2,2
5159,5159,,111,5,14,19
5160,5160,,23,1,3,4
5161,5161,,23,67,92,159
5162,5162,,23,20,33,53
5163,5163,,18,1,2,3
5164,5164,,14,0,1,1
5165,5165,,0,11,3,14
5166,5166,,8,0,3,3
5167,5167,,15,0,3,3
5168,5168,,8,1,10,11
5169,5169,,31,0,1,1
5170,5170,,0,2,2,4
5171,5171,,0,2,2,4
5172,5172,,0,2,2,4
5173,5173,,6,0,3,3
5174,5174,,11,11,4,15
5175,5175,,15,1,3,4
5176,5176,,15,0,2,2
5177,5177,,15,22,3,25
5178,5178,,15,1,2,3
5179,5179,,127,0,2,2
5180,5180,,14,0,3,3
5181,5181,,105,10,5,15
5182,5182,,0,19,2,21
5183,5183,,127,4,9,13
5184,5184,,127,3,0,3
5185,5185,,52,18,39,57
5186,5186,,23,30,28,58
5187,5187,,127,0,1,1
5188,5188,,15,33,66,99
5189,5189,,15,4,2,6
5190,5190,,8,37,47,84
5191,5191,,0,5,5,10
5192,5192,,8,3,1,4
5193,5193,,111,2,1,3
5194,5194,,111,0,1,1
5195,5195,,23,0,1,1
5196,5196,,23,3,1,4
5197,5197,,3,54,34,88
5198,5198,,0,9,25,34
5199,5199,,15,11,6,17
5200,5200,,5,0,2,2
5201,5201,,5,28,74,102
5202,5202,,43,0,1,1
5203,5203,,127,6,8,14
5204,5204,,76,2,0,2
5205,5205,,14,8,12,20
5206,5206,,11,2,2,4
5207,5207,,15,9,18,27
5208,5208,,23,20,22,42
5209,5209,,88,18,17,35
5210,5210,,15,6,5,11
5211,5211,,111,0,1,1
5212,5212,,15,6,0,6
5213,5213,,23,47,73,120
5214,5214,,8,2,1,3
5215,5215,,23,4,15,19
5216,5216,,88,4,0,4
5217,5217,,11,24,44,68
5218,5218,,23,1,1,2
5219,5219,,31,1,1,2
5220,5220,,11,0,1,1
5221,5221,,11,1,1,2
5222,5222,,15,5,17,22
5223,5223,,15,0,2,2
5224,5224,,15,1,0,1
5225,5225,,23,5,5,10
5226,5226,,23,2,3,5
5227,5227,,18,5,11,16
5228,5228,,23,5,1,6
5229,5229,,23,18,47,65
5230,5230,,15,2,2,4
5231,5231,,18,2,12,14
5232,5232,,18,5,5,10
5233,5233,,45,0,4,4
5234,5234,,23,12,4,16
5235,5235,,31,24,19,43
5236,5236,,15,3,4,7
5237,5237,,14,6,4,10
5238,5238,,23,0,1,1
5239,5239,,52,134,143,277
5240,5240,,18,1,6,7
5241,5241,,15,45,63,108
5242,5242,,14,2,3,5
5243,5243,,15,23,38,61
5244,5244,,23,22,36,58
5245,5245,,23,2,2,4
5246,5246,,8,2,3,5
5247,5247,,8,3,10,13
5248,5248,,3,29,36,65
5249,5249,,3,4,8,12
5250,5250,,23,1,1,2
5251,5251,,23,21,27,48
5252,5252,,23,1,4,5
5253,5253,,23,16,8,24
5254,5254,,45,16,20,36
5255,5255,,66,1,3,4
5256,5256,,15,0,2,2
5257,5257,,15,5,6,11
5258,5258,,11,20,1,21
5259,5259,,127,10,4,14
5260,5260,,127,2,4,6
5261,5261,,127,3,3,6
5262,5262,,127,5,9,14
5263,5263,,15,14,7,21
5264,5264,,127,9,23,32
5265,5265,,11,5,6,11
5266,5266,,11,15,17,32
5267,5267,,45,10,0,10
5268,5268,,45,0,2,2
5269,5269,,45,1,0,1
5270,5270,,23,1,2,3
5271,5271,,23,22,7,29
5272,5272,,88,11,11,22
5273,5273,,43,0,2,2
5274,5274,,23,7,7,14
5275,5275,,15,176,243,419
5276,5276,,23,0,1,1
5277,5277,,23,2,3,5
5278,5278,,0,6,4,10
5279,5279,,8,0,1,1
5280,5280,,23,4,2,6
5281,5281,,23,1,13,14
5282,5282,,105,6,5,11
5283,5283,,24,3,1,4
5284,5284,,111,1,5,6
5285,5285,,43,0,3,3
5286,5286,,8,0,1,1
5287,5287,,43,1,7,8
5288,5288,,52,1,2,3
5289,5289,,18,4,5,9
5290,5290,,23,9,3,12
5291,5291,,111,12,7,19
5292,5292,,15,15,15,30
5293,5293,,15,13,6,19
5294,5294,,15,1,1,2
5295,5295,,23,0,1,1
5296,5296,,3,13,3,16
5297,5297,,3,5,0,5
5298,5298,,52,22,48,70
5299,5299,,52,73,76,149
5300,5300,,52,2,3,5
5301,5301,,0,4,2,6
5302,5302,,105,35,23,58
5303,5303,,8,4,3,7
5304,5304,,11,16,2,18
5305,5305,,15,17,9,26
5306,5306,,127,17,16,33
5307,5307,,15,6,0,6
5308,5308,,23,1,1,2
5309,5309,,88,1,0,1
5310,5310,,88,0,1,1
5311,5311,,8,8,6,14
5312,5312,,23,13,25,38
5313,5313,,23,1,8,9
5314,5314,,8,0,1,1
5315,5315,,8,2,0,2
5316,5316,,21,2,0,2
5317,5317,,8,0,2,2
5318,5318,,127,3,5,8
5319,5319,,127,2,1,3
5320,5320,,21,5,12,17
5321,5321,,0,55,24,79
5322,5322,,8,4,3,7
5323,5323,,15,0,2,2
5324,5324,,15,1,1,2
5325,5325,,15,4,12,16
5326,5326,,127,1,0,1
5327,5327,,23,4,2,6
5328,5328,,45,0,1,1
5329,5329,,45,11,6,17
5330,5330,,8,0,1,1
5331,5331,,8,1,2,3
5332,5332,,14,9,5,14
5333,5333,,21,1,12,13
5334,5334,,43,1,0,1
5335,5335,,43,25,63,88
5336,5336,,43,2,7,9
5337,5337,,23,11,26,37
5338,5338,,120,32,18,50
5339,5339,,3,1,2,3
5340,5340,,127,0,4,4
5341,5341,,127,29,26,55
5342,5342,,8,10,10,20
5343,5343,,23,0,1,1
5344,5344,,21,2,3,5
5345,5345,,21,1,0,1
5346,5346,,23,75,62,137
5347,5347,,11,2,4,6
5348,5348,,0,8,30,38
5349,5349,,23,7,8,15
5350,5350,,0,5,6,11
5351,5351,,8,5,5,10
5352,5352,,3,3,1,4
5353,5353,,3,0,2,2
5354,5354,,3,6,9,15
5355,5355,,88,2,14,16
5356,5356,,88,7,4,11
5357,5357,,15,2,1,3
5358,5358,,3,1,2,3
5359,5359,,15,0,1,1
5360,5360,,11,5,11,16
5361,5361,,23,40,28,68
5362,5362,,127,0,5,5
5363,5363,,127,2,1,3
5364,5364,,14,1,1,2
5365,5365,,3,0,14,14
5366,5366,,127,0,2,2
5367,5367,,8,8,6,14
5368,5368,,21,5,6,11
5369,5369,,21,33,39,72
5370,5370,,52,20,7,27
5371,5371,,43,7,0,7
5372,5372,,14,1,0,1
5373,5373,,14,8,5,13
5374,5374,,14,9,4,13
5375,5375,,8,29,17,46
5376,5376,,105,7,8,15
5377,5377,,23,6,2,8
5378,5378,,3,9,12,21
5379,5379,,3,1,0,1
5380,5380,,0,20,2,22
5381,5381,,76,22,6,28
5382,5382,,3,7,9,16
5383,5383,,14,166,263,429
5384,5384,,23,23,35,58
5385,5385,,127,4,3,7
5386,5386,,14,4,7,11
5387,5387,,14,1,2,3
5388,5388,,14,3,7,10
5389,5389,,14,7,6,13
5390,5390,,8,14,20,34
5391,5391,,8,2,0,2
5392,5392,,8,1,6,7
5393,5393,,0,6,10,16
5394,5394,,23,5,21,26
5395,5395,,0,0,1,1
5396,5396,,111,6,11,17
5397,5397,,111,9,40,49
5398,5398,,111,53,50,103
5399,5399,,105,1,0,1
5400,5400,,14,2,0,2
5401,5401,,8,6,10,16
5402,5402,,3,0,1,1
5403,5403,,3,4,5,9
5404,5404,,3,5,4,9
5405,5405,,15,3,2,5
5406,5406,,14,20,13,33
5407,5407,,127,0,6,6
5408,5408,,120,20,21,41
5409,5409,,14,16,2,18
5410,5410,,15,18,17,35
5411,5411,,14,9,6,15
5412,5412,,14,1,0,1
5413,5413,,105,1,5,6
5414,5414,,105,1,0,1
5415,5415,,23,0,1,1
5416,5416,,127,0,27,27
5417,5417,,127,13,10,23
5418,5418,,31,5,7,12
5419,5419,,31,8,13,21
5420,5420,,31,4,6,10
5421,5421,,120,8,7,15
5422,5422,,23,3,2,5
5423,5423,,23,1,4,5
5424,5424,,23,4,3,7
5425,5425,,23,65,51,116
5426,5426,,15,4,4,8
5427,5427,,23,65,7,72
5428,5428,,15,0,3,3
5429,5429,,21,1,2,3
5430,5430,,15,0,1,1
5431,5431,,23,3,3,6
5432,5432,,24,5,4,9
5433,5433,,23,3,13,16
5434,5434,,23,6,0,6
5435,5435,,8,0,1,1
5436,5436,,23,36,42,78
5437,5437,,23,11,18,29
5438,5438,,11,6,10,16
5439,5439,,21,3,0,3
5440,5440,,23,129,56,185
5441,5441,,8,2,0,2
5442,5442,,31,1,2,3
5443,5443,,31,0,5,5
5444,5444,,23,17,30,47
5445,5445,,23,35,49,84
5446,5446,,45,1,2,3
5447,5447,,45,1,2,3
5448,5448,,23,9,7,16
5449,5449,,23,3,0,3
5450,5450,,23,3,0,3
5451,5451,,23,1,0,1
5452,5452,,8,0,1,1
5453,5453,,23,1,10,11
5454,5454,,127,1,2,3
5455,5455,,120,61,22,83
5456,5456,,120,11,9,20
5457,5457,,15,1,8,9
5458,5458,,15,15,17,32
5459,5459,,23,43,15,58
5460,5460,,8,4,4,8
5461,5461,,15,2,3,5
5462,5462,,18,6,10,16
5463,5463,,18,12,7,19
5464,5464,,45,7,6,13
5465,5465,,8,1,2,3
5466,5466,,111,3,3,6
5467,5467,,127,3,9,12
5468,5468,,18,14,4,18
5469,5469,,8,11,11,22
5470,5470,,23,0,1,1
5471,5471,,21,0,3,3
5472,5472,,23,15,12,27
5473,5473,,88,1,1,2
5474,5474,,76,0,1,1
5475,5475,,76,4,2,6
5476,5476,,8,2,16,18
5477,5477,,23,0,1,1
5478,5478,,23,15,5,20
5479,5479,,23,0,1,1
5480,5480,,23,0,2,2
5481,5481,,23,4,2,6
5482,5482,,15,3,1,4
5483,5483,,15,3,2,5
5484,5484,,15,7,13,20
5485,5485,,8,1,2,3
5486,5486,,23,0,4,4
5487,5487,,8,2,9,11
5488,5488,,8,2,0,2
5489,5489,,23,1,1,2
5490,5490,,45,2,3,5
5491,5491,,127,2,1,3
5492,5492,,15,35,14,49
5493,5493,,8,2,0,2
5494,5494,,23,13,21,34
5495,5495,,23,1,0,1
5496,5496,,15,3,4,7
5497,5497,,105,5,13,18
5498,5498,,23,0,1,1
5499,5499,,0,1,2,3
5500,5500,,111,12,12,24
5501,5501,,23,22,39,61
5502,5502,,8,91,63,154
5503,5503,,11,6,8,14
5504,5504,,76,0,2,2
5505,5505,,6,11,18,29
5506,5506,,23,1,5,6
5507,5507,,14,5,13,18
5508,5508,,23,2,2,4
5509,5509,,15,4,11,15
5510,5510,,15,1,0,1
5511,5511,,111,1,4,5
5512,5512,,3,5,7,12
5513,5513,,3,4,0,4
5514,5514,,0,11,8,19
5515,5515,,18,2,1,3
5516,5516,,15,2,7,9
5517,5517,,15,3,1,4
5518,5518,,23,1,1,2
5519,5519,,43,0,4,4
5520,5520,,66,5,8,13
5521,5521,,0,0,1,1
5522,5522,,31,0,5,5
5523,5523,,8,6,2,8
5524,5524,,14,0,1,1
5525,5525,,23,11,12,23
5526,5526,,23,2,1,3
5527,5527,,23,7,8,15
5528,5528,,88,24,9,33
5529,5529,,52,4,3,7
5530,5530,,76,2,13,15
5531,5531,,76,1,6,7
5532,5532,,76,28,25,53
5533,5533,,11,16,4,20
5534,5534,,23,21,32,53
5535,5535,,23,10,9,19
5536,5536,,23,10,25,35
5537,5537,,0,13,19,32
5538,5538,,88,1,1,2
5539,5539,,14,2,5,7
5540,5540,,23,2,15,17
5541,5541,,15,1,5,6
5542,5542,,15,7,16,23
5543,5543,,8,2,8,10
5544,5544,,8,5,4,9
5545,5545,,43,1,2,3
5546,5546,,127,2,3,5
5547,5547,,45,0,2,2
5548,5548,,45,6,5,11
5549,5549,,45,2,2,4
5550,5550,,23,1,2,3
5551,5551,,15,6,6,12
5552,5552,,0,0,3,3
5553,5553,,23,1,1,2
5554,5554,,23,2,1,3
5555,5555,,23,3,6,9
5556,5556,,23,2,2,4
5557,5557,,6,17,37,54
5558,5558,,8,5,2,7
5559,5559,,11,2,2,4
5560,5560,,11,1,0,1
5561,5561,,23,0,1,1
5562,5562,,111,2,1,3
5563,5563,,15,0,1,1
5564,5564,,45,15,56,71
5565,5565,,23,7,9,16
5566,5566,,0,5,8,13
5567,5567,,8,0,2,2
5568,5568,,15,1,1,2
5569,5569,,43,0,5,5
5570,5570,,23,13,20,33
5571,5571,,23,15,11,26
5572,5572,,3,0,1,1
5573,5573,,15,0,4,4
5574,5574,,8,0,1,1
5575,5575,,8,5,4,9
5576,5576,,127,6,3,9
5577,5577,,8,10,8,18
5578,5578,,8,5,7,12
5579,5579,,8,4,1,5
5580,5580,,8,1,6,7
5581,5581,,43,5,3,8
5582,5582,,127,3,5,8
5583,5583,,8,2,3,5
5584,5584,,23,1,0,1
5585,5585,,23,1,4,5
5586,5586,,23,10,4,14
5587,5587,,15,9,15,24
5588,5588,,23,3,2,5
5589,5589,,23,21,16,37
5590,5590,,52,14,4,18
5591,5591,,52,1,6,7
5592,5592,,5,2,7,9
5593,5593,,52,22,19,41
5594,5594,,21,2,0,2
5595,5595,,52,140,170,310
5596,5596,,24,12,8,20
5597,5597,,43,0,1,1
5598,5598,,8,10,10,20
5599,5599,,111,10,2,12
5600,5600,,111,1,5,6
5601,5601,,111,4,0,4
5602,5602,,21,7,8,15
5603,5603,,0,26,30,56
5604,5604,,52,4,8,12
5605,5605,,11,2,12,14
5606,5606,,11,4,0,4
5607,5607,,0,0,11,11
5608,5608,,88,24,29,53
5609,5609,,8,1,2,3
5610,5610,,23,6,7,13
5611,5611,,23,4,5,9
5612,5612,,3,11,28,39
5613,5613,,21,33,44,77
5614,5614,,0,33,41,74
5615,5615,,15,20,21,41
5616,5616,,88,5,5,10
5617,5617,,15,2,5,7
5618,5618,,8,2,1,3
5619,5619,,0,0,1,1
5620,5620,,45,15,1,16
5621,5621,,23,4,2,6
5622,5622,,0,2,8,10
5623,5623,,45,7,8,15
5624,5624,,66,0,6,6
5625,5625,,66,2,0,2
5626,5626,,18,2,2,4
5627,5627,,45,2,2,4
5628,5628,,127,22,38,60
5629,5629,,14,4,6,10
5630,5630,,21,7,1,8
5631,5631,,5,1,11,12
5632,5632,,23,3,2,5
5633,5633,,111,4,11,15
5634,5634,,45,5,9,14
5635,5635,,8,1,2,3
5636,5636,,8,1,2,3
5637,5637,,8,1,0,1
5638,5638,,21,7,8,15
5639,5639,,8,24,19,43
5640,5640,,43,35,10,45
5641,5641,,43,3,1,4
5642,5642,,43,2,0,2
5643,5643,,43,27,41,68
5644,5644,,43,1,0,1
5645,5645,,23,7,4,11
5646,5646,,43,18,11,29
5647,5647,,43,2,1,3
5648,5648,,43,2,0,2
5649,5649,,127,4,13,17
5650,5650,,43,15,58,73
5651,5651,,43,14,9,23
5652,5652,,43,9,11,20
5653,5653,,43,5,5,10
5654,5654,,8,2,0,2
5655,5655,,23,0,1,1
5656,5656,,23,1,1,2
5657,5657,,127,1,0,1
5658,5658,,23,0,3,3
5659,5659,,23,4,5,9
5660,5660,,23,2,0,2
5661,5661,,23,5,4,9
5662,5662,,66,0,3,3
5663,5663,,66,3,6,9
5664,5664,,66,2,0,2
5665,5665,,0,7,11,18
5666,5666,,14,3,0,3
5667,5667,,8,1,0,1
5668,5668,,3,8,32,40
5669,5669,,3,3,0,3
5670,5670,,8,6,6,12
5671,5671,,14,5,3,8
5672,5672,,14,1,0,1
5673,5673,,88,2,12,14
5674,5674,,88,20,10,30
5675,5675,,88,21,6,27
5676,5676,,88,0,1,1
5677,5677,,23,4,6,10
5678,5678,,3,3,14,17
5679,5679,,3,4,3,7
5680,5680,,127,0,1,1
5681,5681,,15,3,6,9
5682,5682,,23,27,34,61
5683,5683,,23,0,1,1
5684,5684,,5,0,1,1
5685,5685,,11,5,1,6
5686,5686,,52,12,10,22
5687,5687,,111,3,6,9
5688,5688,,21,3,7,10
5689,5689,,8,16,13,29
5690,5690,,23,4,3,7
5691,5691,,23,16,23,39
5692,5692,,23,3,4,7
5693,5693,,15,1,1,2
5694,5694,,88,3,1,4
5695,5695,,11,3,7,10
5696,5696,,43,14,14,28
5697,5697,,14,29,18,47
5698,5698,,14,1,8,9
5699,5699,,43,7,9,16
5700,5700,,52,6,4,10
5701,5701,,52,2,1,3
5702,5702,,23,14,13,27
5703,5703,,43,66,136,202
5704,5704,,43,9,6,15
5705,5705,,43,3,16,19
5706,5706,,43,8,41,49
5707,5707,,43,8,18,26
5708,5708,,66,12,14,26
5709,5709,,3,4,2,6
5710,5710,,15,3,4,7
5711,5711,,18,4,3,7
5712,5712,,127,3,1,4
5713,5713,,127,1,1,2
5714,5714,,76,4,3,7
5715,5715,,23,17,25,42
5716,5716,,14,1,2,3
5717,5717,,14,36,57,93
5718,5718,,14,26,29,55
5719,5719,,14,3,2,5
5720,5720,,14,10,2,12
5721,5721,,14,66,134,200
5722,5722,,14,2,4,6
5723,5723,,23,1,1,2
5724,5724,,111,0,1,1
5725,5725,,111,6,11,17
5726,5726,,111,11,10,21
5727,5727,,76,0,1,1
5728,5728,,76,3,5,8
5729,5729,,76,14,6,20
5730,5730,,14,26,16,42
5731,5731,,127,18,8,26
5732,5732,,52,0,5,5
5733,5733,,0,1,2,3
5734,5734,,3,6,9,15
5735,5735,,8,0,1,1
5736,5736,,15,3,2,5
5737,5737,,76,15,4,19
5738,5738,,8,3,11,14
5739,5739,,127,1,0,1
5740,5740,,31,2,2,4
5741,5741,,23,2,1,3
5742,5742,,0,10,10,20
5743,5743,,105,1,1,2
5744,5744,,31,2,3,5
5745,5745,,8,16,8,24
5746,5746,,52,2,0,2
5747,5747,,8,0,4,4
5748,5748,,8,1,1,2
5749,5749,,8,1,2,3
5750,5750,,8,1,0,1
5751,5751,,0,0,4,4
5752,5752,,6,60,87,147
5753,5753,,17,0,1,1
5754,5754,,17,1,0,1
5755,5755,,0,12,8,20
5756,5756,,15,6,7,13
5757,5757,,31,23,13,36
5758,5758,,31,49,5,54
5759,5759,,8,2,2,4
5760,5760,,76,1,1,2
5761,5761,,105,18,15,33
5762,5762,,5,12,3,15
5763,5763,,45,12,3,15
5764,5764,,111,1,0,1
5765,5765,,23,1,2,3
5766,5766,,105,3,9,12
5767,5767,,5,1,1,2
5768,5768,,105,0,2,2
5769,5769,,23,11,7,18
5770,5770,,8,3,1,4
5771,5771,,31,2,2,4
5772,5772,,15,0,2,2
5773,5773,,88,2,0,2
5774,5774,,52,6,11,17
5775,5775,,127,2,0,2
5776,5776,,23,0,1,1
5777,5777,,23,43,47,90
5778,5778,,31,3,3,6
5779,5779,,111,8,12,20
5780,5780,,105,11,1,12
5781,5781,,8,1,0,1
5782,5782,,8,0,1,1
5783,5783,,111,2,3,5
5784,5784,,105,12,4,16
5785,5785,,23,15,19,34
5786,5786,,76,0,1,1
5787,5787,,0,1,2,3
5788,5788,,43,16,15,31
5789,5789,,21,0,4,4
5790,5790,,14,2,9,11
5791,5791,,23,0,1,1
5792,5792,,11,3,1,4
5793,5793,,0,10,22,32
5794,5794,,15,14,21,35
5795,5795,,23,12,35,47
5796,5796,,18,11,14,25
5797,5797,,23,0,1,1
5798,5798,,15,7,5,12
5799,5799,,0,2,3,5
5800,5800,,23,3,3,6
5801,5801,,21,1,0,1
5802,5802,,5,12,7,19
5803,5803,,23,1,12,13
5804,5804,,45,4,6,10
5805,5805,,14,4,14,18
5806,5806,,23,1,10,11
5807,5807,,8,9,18,27
5808,5808,,23,13,19,32
5809,5809,,23,14,38,52
5810,5810,,52,41,32,73
5811,5811,,15,7,14,21
5812,5812,,23,5,0,5
5813,5813,,52,1,0,1
5814,5814,,127,2,7,9
5815,5815,,43,11,17,28
5816,5816,,23,1,1,2
5817,5817,,23,0,2,2
5818,5818,,23,0,1,1
5819,5819,,11,2,4,6
5820,5820,,11,5,0,5
5821,5821,,43,0,1,1
5822,5822,,43,1,7,8
5823,5823,,23,14,22,36
5824,5824,,8,15,2,17
5825,5825,,31,4,11,15
5826,5826,,31,12,33,45
5827,5827,,3,7,3,10
5828,5828,,23,2,1,3
5829,5829,,88,23,38,61
5830,5830,,23,25,36,61
5831,5831,,14,58,97,155
5832,5832,,14,1,5,6
5833,5833,,14,1,1,2
5834,5834,,14,19,34,53
5835,5835,,23,4,7,11
5836,5836,,14,3,2,5
5837,5837,,14,5,5,10
5838,5838,,52,3,9,12
5839,5839,,52,2,0,2
5840,5840,,76,7,20,27
5841,5841,,127,5,5,10
5842,5842,,127,1,1,2
5843,5843,,127,14,23,37
5844,5844,,15,1,1,2
5845,5845,,15,2,1,3
5846,5846,,11,35,14,49
5847,5847,,11,0,1,1
5848,5848,,23,9,13,22
5849,5849,,23,12,39,51
5850,5850,,0,6,15,21
5851,5851,,23,1,1,2
5852,5852,,18,11,32,43
5853,5853,,18,3,5,8
5854,5854,,8,1,3,4
5855,5855,,11,8,15,23
5856,5856,,23,9,8,17
5857,5857,,127,8,2,10
5858,5858,,111,18,15,33
5859,5859,,15,22,34,56
5860,5860,,15,1,1,2
5861,5861,,3,8,4,12
5862,5862,,23,1,0,1
5863,5863,,127,11,1,12
5864,5864,,43,1,1,2
5865,5865,,105,2,2,4
5866,5866,,21,12,21,33
5867,5867,,52,3,2,5
5868,5868,,52,11,3,14
5869,5869,,18,7,9,16
5870,5870,,18,1,0,1
5871,5871,,3,3,1,4
5872,5872,,23,2,2,4
5873,5873,,23,8,10,18
5874,5874,,23,17,15,32
5875,5875,,111,12,5,17
5876,5876,,111,1,4,5
5877,5877,,23,1,3,4
5878,5878,,127,2,3,5
5879,5879,,0,3,1,4
5880,5880,,23,1,5,6
5881,5881,,0,0,2,2
5882,5882,,45,8,15,23
5883,5883,,45,0,1,1
5884,5884,,45,6,9,15
5885,5885,,45,1,4,5
5886,5886,,45,35,19,54
5887,5887,,11,3,3,6
5888,5888,,3,8,5,13
5889,5889,,127,12,22,34
5890,5890,,21,13,14,27
5891,5891,,111,5,3,8
5892,5892,,0,2,5,7
5893,5893,,0,4,9,13
5894,5894,,0,1,0,1
5895,5895,,0,2,6,8
5896,5896,,0,6,0,6
5897,5897,,3,46,36,82
5898,5898,,23,0,1,1
5899,5899,,3,16,22,38
5900,5900,,0,0,4,4
5901,5901,,127,51,89,140
5902,5902,,14,6,8,14
5903,5903,,14,3,4,7
5904,5904,,14,8,3,11
5905,5905,,14,4,1,5
5906,5906,,14,1,0,1
5907,5907,,43,10,27,37
5908,5908,,43,21,68,89
5909,5909,,105,10,4,14
5910,5910,,0,2,2,4
5911,5911,,43,2,2,4
5912,5912,,43,27,24,51
5913,5913,,43,7,6,13
5914,5914,,23,7,7,14
5915,5915,,0,5,4,9
5916,5916,,5,3,50,53
5917,5917,,0,2,2,4
5918,5918,,52,71,125,196
5919,5919,,52,30,64,94
5920,5920,,43,2,16,18
5921,5921,,14,1,4,5
5922,5922,,14,2,0,2
5923,5923,,14,0,3,3
5924,5924,,88,2,3,5
5925,5925,,88,2,3,5
5926,5926,,88,10,12,22
5927,5927,,88,0,8,8
5928,5928,,88,8,5,13
5929,5929,,88,55,42,97
5930,5930,,52,45,24,69
5931,5931,,23,18,29,47
5932,5932,,23,4,9,13
5933,5933,,23,9,21,30
5934,5934,,88,0,4,4
5935,5935,,5,46,21,67
5936,5936,,45,0,3,3
5937,5937,,5,4,1,5
5938,5938,,23,4,1,5
5939,5939,,66,2,0,2
5940,5940,,43,4,0,4
5941,5941,,21,1,3,4
5942,5942,,0,28,23,51
5943,5943,,14,2,1,3
5944,5944,,23,2,7,9
5945,5945,,43,18,14,32
5946,5946,,8,8,3,11
5947,5947,,43,3,9,12
5948,5948,,43,11,15,26
5949,5949,,111,14,8,22
5950,5950,,111,2,10,12
5951,5951,,11,8,12,20
5952,5952,,11,0,1,1
5953,5953,,21,10,10,20
5954,5954,,0,0,7,7
5955,5955,,88,25,8,33
5956,5956,,88,0,2,2
5957,5957,,88,1,1,2
5958,5958,,88,1,3,4
5959,5959,,43,2,2,4
5960,5960,,76,3,3,6
5961,5961,,76,2,0,2
5962,5962,,76,1,5,6
5963,5963,,76,41,31,72
5964,5964,,76,11,10,21
5965,5965,,76,2,4,6
5966,5966,,52,34,28,62
5967,5967,,21,2,2,4
5968,5968,,21,1,1,2
5969,5969,,18,14,39,53
5970,5970,,18,17,1,18
5971,5971,,127,1,0,1
5972,5972,,23,3,15,18
5973,5973,,3,1,1,2
5974,5974,,23,16,6,22
5975,5975,,0,156,95,251
5976,5976,,14,1,7,8
5977,5977,,5,9,7,16
5978,5978,,8,0,1,1
5979,5979,,111,10,16,26
5980,5980,,111,0,5,5
5981,5981,,111,2,1,3
5982,5982,,3,9,4,13
5983,5983,,3,3,1,4
5984,5984,,3,5,2,7
5985,5985,,127,3,5,8
5986,5986,,111,2,1,3
5987,5987,,105,19,5,24
5988,5988,,105,2,0,2
5989,5989,,21,6,8,14
5990,5990,,52,18,5,23
5991,5991,,52,9,6,15
5992,5992,,15,1,2,3
5993,5993,,111,9,15,24
5994,5994,,31,0,3,3
5995,5995,,31,3,2,5
5996,5996,,127,26,39,65
5997,5997,,127,15,8,23
5998,5998,,23,0,1,1
5999,5999,,111,2,0,2
6000,6000,,0,2,2,4
6001,6001,,111,0,8,8
6002,6002,,8,2,3,5
6003,6003,,23,8,24,32
6004,6004,,15,5,8,13
6005,6005,,23,0,11,11
6006,6006,,23,2,13,15
6007,6007,,3,1,1,2
6008,6008,,23,1,1,2
6009,6009,,23,8,15,23
6010,6010,,105,1,2,3
6011,6011,,105,1,0,1
6012,6012,,23,16,22,38
6013,6013,,23,1,0,1
6014,6014,,31,1,0,1
6015,6015,,23,6,7,13
6016,6016,,88,4,3,7
6017,6017,,23,3,6,9
6018,6018,,23,12,13,25
6019,6019,,23,5,3,8
6020,6020,,23,15,30,45
6021,6021,,23,10,5,15
6022,6022,,105,2,0,2
6023,6023,,0,1,0,1
6024,6024,,23,1,10,11
6025,6025,,23,10,1,11
6026,6026,,11,16,7,23
6027,6027,,45,0,1,1
6028,6028,,45,1,0,1
6029,6029,,45,1,0,1
6030,6030,,111,53,90,143
6031,6031,,111,1,0,1
6032,6032,,8,2,8,10
6033,6033,,8,3,0,3
6034,6034,,23,0,1,1
6035,6035,,6,3,0,3
6036,6036,,14,8,2,10
6037,6037,,14,3,4,7
6038,6038,,21,4,7,11
6039,6039,,8,3,3,6
6040,6040,,14,14,20,34
6041,6041,,31,9,4,13
6042,6042,,111,3,4,7
6043,6043,,127,5,2,7
6044,6044,,23,5,9,14
6045,6045,,23,11,34,45
6046,6046,,105,2,12,14
6047,6047,,19,0,1,1
6048,6048,,19,1,0,1
6049,6049,,15,15,6,21
6050,6050,,15,0,1,1
6051,6051,,8,2,0,2
6052,6052,,8,10,0,10
6053,6053,,127,3,6,9
6054,6054,,23,2,6,8
6055,6055,,43,0,5,5
6056,6056,,23,1,1,2
6057,6057,,8,7,12,19
6058,6058,,8,4,2,6
6059,6059,,8,2,9,11
6060,6060,,8,0,1,1
6061,6061,,111,9,11,20
6062,6062,,43,0,1,1
6063,6063,,18,9,7,16
6064,6064,,23,0,5,5
6065,6065,,8,4,2,6
6066,6066,,8,3,5,8
6067,6067,,23,6,13,19
6068,6068,,8,6,7,13
6069,6069,,88,1,3,4
6070,6070,,43,27,25,52
6071,6071,,8,1,3,4
6072,6072,,18,3,8,11
6073,6073,,23,0,2,2
6074,6074,,23,27,7,34
6075,6075,,52,1,0,1
6076,6076,,111,40,3,43
6077,6077,,8,1,9,10
6078,6078,,8,0,3,3
6079,6079,,23,14,18,32
6080,6080,,45,12,7,19
6081,6081,,45,1,4,5
6082,6082,,14,32,29,61
6083,6083,,6,21,9,30
6084,6084,,15,1,0,1
6085,6085,,43,4,0,4
6086,6086,,23,5,9,14
6087,6087,,23,2,0,2
6088,6088,,105,1,0,1
6089,6089,,15,1,0,1
6090,6090,,3,9,4,13
6091,6091,,45,0,2,2
6092,6092,,8,1,1,2
6093,6093,,0,6,5,11
6094,6094,,23,2,5,7
6095,6095,,23,5,17,22
6096,6096,,0,1,0,1
6097,6097,,6,9,26,35
6098,6098,,6,132,134,266
6099,6099,,0,3,1,4
6100,6100,,43,54,40,94
6101,6101,,8,1,1,2
6102,6102,,127,4,3,7
6103,6103,,23,5,1,6
6104,6104,,23,18,17,35
6105,6105,,8,2,1,3
6106,6106,,8,2,0,2
6107,6107,,52,21,6,27
6108,6108,,23,11,14,25
6109,6109,,21,3,1,4
6110,6110,,15,4,5,9
6111,6111,,18,0,2,2
6112,6112,,127,4,3,7
6113,6113,,23,2,6,8
6114,6114,,23,1,0,1
6115,6115,,11,3,0,3
6116,6116,,23,0,2,2
6117,6117,,23,2,0,2
6118,6118,,45,0,3,3
6119,6119,,45,1,3,4
6120,6120,,21,20,25,45
6121,6121,,23,12,16,28
6122,6122,,23,7,6,13
6123,6123,,88,14,9,23
6124,6124,,88,0,2,2
6125,6125,,88,1,0,1
6126,6126,,31,0,11,11
6127,6127,,18,3,7,10
6128,6128,,15,2,4,6
6129,6129,,43,6,10,16
6130,6130,,15,1,1,2
6131,6131,,23,5,1,6
6132,6132,,52,4,6,10
6133,6133,,43,0,4,4
6134,6134,,8,0,2,2
6135,6135,,111,2,2,4
6136,6136,,111,5,2,7
6137,6137,,45,1,1,2
6138,6138,,8,32,38,70
6139,6139,,0,4,28,32
6140,6140,,6,0,5,5
6141,6141,,0,0,16,16
6142,6142,,23,9,9,18
6143,6143,,11,4,1,5
6144,6144,,11,13,22,35
6145,6145,,8,0,1,1
6146,6146,,8,3,4,7
6147,6147,,23,3,4,7
6148,6148,,0,17,13,30
6149,6149,,15,4,12,16
6150,6150,,23,1,1,2
6151,6151,,11,0,9,9
6152,6152,,43,1,1,2
6153,6153,,105,0,1,1
6154,6154,,43,0,8,8
6155,6155,,43,21,31,52
6156,6156,,43,1,4,5
6157,6157,,43,3,1,4
6158,6158,,23,0,4,4
6159,6159,,23,5,4,9
6160,6160,,23,5,9,14
6161,6161,,0,10,16,26
6162,6162,,8,2,1,3
6163,6163,,0,10,0,10
6164,6164,,23,8,3,11
6165,6165,,8,0,3,3
6166,6166,,8,3,3,6
6167,6167,,5,0,1,1
6168,6168,,23,3,12,15
6169,6169,,5,15,15,30
6170,6170,,8,1,7,8
6171,6171,,8,7,10,17
6172,6172,,52,1,1,2
6173,6173,,88,3,6,9
6174,6174,,88,4,9,13
6175,6175,,88,15,8,23
6176,6176,,88,2,0,2
6177,6177,,20,0,1,1
6178,6178,,20,1,0,1
6179,6179,,52,9,16,25
6180,6180,,8,36,12,48
6181,6181,,43,0,1,1
6182,6182,,43,46,46,92
6183,6183,,23,1,1,2
6184,6184,,43,3,1,4
6185,6185,,43,67,130,197
6186,6186,,43,8,10,18
6187,6187,,8,5,6,11
6188,6188,,120,3,0,3
6189,6189,,43,0,2,2
6190,6190,,43,15,30,45
6191,6191,,0,1,1,2
6192,6192,,120,0,4,4
6193,6193,,43,2,8,10
6194,6194,,11,3,2,5
6195,6195,,11,1,3,4
6196,6196,,21,18,15,33
6197,6197,,0,7,3,10
6198,6198,,3,0,2,2
6199,6199,,15,0,1,1
6200,6200,,105,0,2,2
6201,6201,,88,17,1,18
6202,6202,,23,1,1,2
6203,6203,,23,25,22,47
6204,6204,,23,9,19,28
6205,6205,,23,1,1,2
6206,6206,,43,16,18,34
6207,6207,,43,5,3,8
6208,6208,,45,0,1,1
6209,6209,,14,12,3,15
6210,6210,,8,15,1,16
6211,6211,,14,2,3,5
6212,6212,,127,22,23,45
6213,6213,,8,17,13,30
6214,6214,,3,5,2,7
6215,6215,,3,2,2,4
6216,6216,,8,5,7,12
6217,6217,,15,1,1,2
6218,6218,,23,5,6,11
6219,6219,,23,5,5,10
6220,6220,,14,1,1,2
6221,6221,,8,1,0,1
6222,6222,,6,47,103,150
6223,6223,,18,0,1,1
6224,6224,,23,4,0,4
6225,6225,,0,0,2,2
6226,6226,,14,6,9,15
6227,6227,,14,2,4,6
6228,6228,,8,1,2,3
6229,6229,,3,9,17,26
6230,6230,,3,4,9,13
6231,6231,,21,1,1,2
6232,6232,,5,10,3,13
6233,6233,,5,6,1,7
6234,6234,,0,12,17,29
6235,6235,,43,1,1,2
6236,6236,,23,8,2,10
6237,6237,,14,1,2,3
6238,6238,,111,3,1,4
6239,6239,,111,4,10,14
6240,6240,,6,5,1,6
6241,6241,,15,2,3,5
6242,6242,,15,11,45,56
6243,6243,,0,3,3,6
6244,6244,,23,2,1,3
6245,6245,,0,1,0,1
6246,6246,,45,8,12,20
6247,6247,,5,10,5,15
6248,6248,,76,41,12,53
6249,6249,,15,19,32,51
6250,6250,,15,8,1,9
6251,6251,,23,5,0,5
6252,6252,,11,20,8,28
6253,6253,,11,7,5,12
6254,6254,,45,7,4,11
6255,6255,,3,0,4,4
6256,6256,,111,39,10,49
6257,6257,,11,1,1,2
6258,6258,,8,4,15,19
6259,6259,,8,5,0,5
6260,6260,,18,35,28,63
6261,6261,,18,6,7,13
6262,6262,,66,3,5,8
6263,6263,,105,4,4,8
6264,6264,,0,2,4,6
6265,6265,,8,3,3,6
6266,6266,,23,0,4,4
6267,6267,,8,5,5,10
6268,6268,,0,48,37,85
6269,6269,,11,0,1,1
6270,6270,,11,2,0,2
6271,6271,,23,19,39,58
6272,6272,,43,1,0,1
6273,6273,,15,8,12,20
6274,6274,,88,20,43,63
6275,6275,,8,10,9,19
6276,6276,,8,13,17,30
6277,6277,,8,0,1,1
6278,6278,,45,4,11,15
6279,6279,,66,1,1,2
6280,6280,,23,0,1,1
6281,6281,,43,0,3,3
6282,6282,,11,1,2,3
6283,6283,,8,12,7,19
6284,6284,,14,5,7,12
6285,6285,,3,5,7,12
6286,6286,,66,4,4,8
6287,6287,,11,6,2,8
6288,6288,,11,48,88,136
6289,6289,,66,2,4,6
6290,6290,,23,2,0,2
6291,6291,,3,1,13,14
6292,6292,,66,0,5,5
6293,6293,,43,16,29,45
6294,6294,,120,3,17,20
6295,6295,,43,0,1,1
6296,6296,,105,3,1,4
6297,6297,,43,17,59,76
6298,6298,,21,0,1,1
6299,6299,,21,4,2,6
6300,6300,,76,9,23,32
6301,6301,,14,3,10,13
6302,6302,,43,10,3,13
6303,6303,,105,2,3,5
6304,6304,,76,0,5,5
6305,6305,,76,1,0,1
6306,6306,,21,13,36,49
6307,6307,,127,7,2,9
6308,6308,,105,1,0,1
6309,6309,,23,22,26,48
6310,6310,,8,2,0,2
6311,6311,,0,2,3,5
6312,6312,,127,1,1,2
6313,6313,,45,0,1,1
6314,6314,,23,9,12,21
6315,6315,,23,3,0,3
6316,6316,,105,3,17,20
6317,6317,,76,0,1,1
6318,6318,,8,7,4,11
6319,6319,,0,5,15,20
6320,6320,,0,7,1,8
6321,6321,,105,0,6,6
6322,6322,,22,0,1,1
6323,6323,,22,1,0,1
6324,6324,,0,1,6,7
6325,6325,,23,0,4,4
6326,6326,,23,9,0,9
6327,6327,,23,2,0,2
6328,6328,,43,5,14,19
6329,6329,,11,2,2,4
6330,6330,,23,4,2,6
6331,6331,,3,0,3,3
6332,6332,,3,3,2,5
6333,6333,,21,2,7,9
6334,6334,,23,7,25,32
6335,6335,,8,3,11,14
6336,6336,,23,3,0,3
6337,6337,,15,1,0,1
6338,6338,,23,1,4,5
6339,6339,,31,9,8,17
6340,6340,,21,15,31,46
6341,6341,,23,2,7,9
6342,6342,,23,3,0,3
6343,6343,,43,0,5,5
6344,6344,,45,0,4,4
6345,6345,,0,1,2,3
6346,6346,,23,0,1,1
6347,6347,,43,0,1,1
6348,6348,,23,8,7,15
6349,6349,,24,22,14,36
6350,6350,,45,0,10,10
6351,6351,,45,1,17,18
6352,6352,,45,7,2,9
6353,6353,,66,7,16,23
6354,6354,,3,1,0,1
6355,6355,,15,6,5,11
6356,6356,,43,1,13,14
6357,6357,,0,0,1,1
6358,6358,,23,15,5,20
6359,6359,,8,9,8,17
6360,6360,,52,2,6,8
6361,6361,,3,2,7,9
6362,6362,,15,11,16,27
6363,6363,,76,2,14,16
6364,6364,,76,1,1,2
6365,6365,,76,1,2,3
6366,6366,,76,2,2,4
6367,6367,,45,0,5,5
6368,6368,,45,1,2,3
6369,6369,,45,1,0,1
6370,6370,,23,2,2,4
6371,6371,,3,2,0,2
6372,6372,,8,17,15,32
6373,6373,,8,2,8,10
6374,6374,,8,7,1,8
6375,6375,,8,12,21,33
6376,6376,,8,2,0,2
6377,6377,,11,0,1,1
6378,6378,,52,21,18,39
6379,6379,,52,26,17,43
6380,6380,,23,2,6,8
6381,6381,,11,1,4,5
6382,6382,,76,4,3,7
6383,6383,,3,2,1,3
6384,6384,,23,2,2,4
6385,6385,,3,1,1,2
6386,6386,,3,15,9,24
6387,6387,,8,2,3,5
6388,6388,,23,4,4,8
6389,6389,,0,8,3,11
6390,6390,,127,1,3,4
6391,6391,,76,6,1,7
6392,6392,,8,0,1,1
6393,6393,,43,4,4,8
6394,6394,,52,3,6,9
6395,6395,,52,1,1,2
6396,6396,,8,3,9,12
6397,6397,,8,1,3,4
6398,6398,,8,4,2,6
6399,6399,,66,9,4,13
6400,6400,,66,4,11,15
6401,6401,,66,2,4,6
6402,6402,,21,1,1,2
6403,6403,,0,1,4,5
6404,6404,,23,21,10,31
6405,6405,,14,4,5,9
6406,6406,,14,6,0,6
6407,6407,,18,15,2,17
6408,6408,,43,7,14,21
6409,6409,,8,4,1,5
6410,6410,,127,2,9,11
6411,6411,,127,8,9,17
6412,6412,,23,1,1,2
6413,6413,,43,1,0,1
6414,6414,,43,13,7,20
6415,6415,,105,3,19,22
6416,6416,,66,1,4,5
6417,6417,,23,9,13,22
6418,6418,,66,12,17,29
6419,6419,,52,10,30,40
6420,6420,,23,8,3,11
6421,6421,,11,1,4,5
6422,6422,,43,9,9,18
6423,6423,,23,18,9,27
6424,6424,,21,0,1,1
6425,6425,,21,4,2,6
6426,6426,,0,4,6,10
6427,6427,,8,0,2,2
6428,6428,,111,9,7,16
6429,6429,,111,26,10,36
6430,6430,,8,1,2,3
6431,6431,,8,0,1,1
6432,6432,,23,18,13,31
6433,6433,,3,1,3,4
6434,6434,,3,5,3,8
6435,6435,,3,1,0,1
6436,6436,,23,7,17,24
6437,6437,,52,5,6,11
6438,6438,,52,1,5,6
6439,6439,,52,5,2,7
6440,6440,,14,0,1,1
6441,6441,,31,19,9,28
6442,6442,,31,0,4,4
6443,6443,,31,0,7,7
6444,6444,,31,0,1,1
6445,6445,,31,1,1,2
6446,6446,,23,23,21,44
6447,6447,,0,3,0,3
6448,6448,,8,0,9,9
6449,6449,,31,1,2,3
6450,6450,,14,1,0,1
6451,6451,,14,3,1,4
6452,6452,,15,2,6,8
6453,6453,,8,0,2,2
6454,6454,,23,5,10,15
6455,6455,,8,0,3,3
6456,6456,,45,21,40,61
6457,6457,,15,2,1,3
6458,6458,,18,0,5,5
6459,6459,,18,14,13,27
6460,6460,,6,1,3,4
6461,6461,,11,45,29,74
6462,6462,,11,0,1,1
6463,6463,,31,1,4,5
6464,6464,,14,3,1,4
6465,6465,,18,20,4,24
6466,6466,,23,0,71,71
6467,6467,,23,20,47,67
6468,6468,,14,0,2,2
6469,6469,,0,0,1,1
6470,6470,,105,13,5,18
6471,6471,,43,9,2,11
6472,6472,,0,2,1,3
6473,6473,,6,17,12,29
6474,6474,,11,1,0,1
6475,6475,,105,6,28,34
6476,6476,,120,10,4,14
6477,6477,,3,2,2,4
6478,6478,,76,1,1,2
6479,6479,,23,60,75,135
6480,6480,,23,5,11,16
6481,6481,,11,0,1,1
6482,6482,,0,3,5,8
6483,6483,,11,3,11,14
6484,6484,,8,14,17,31
6485,6485,,14,1,1,2
6486,6486,,127,0,1,1
6487,6487,,0,13,11,24
6488,6488,,23,51,53,104
6489,6489,,43,5,15,20
6490,6490,,88,0,2,2
6491,6491,,6,5,15,20
6492,6492,,111,11,22,33
6493,6493,,8,10,1,11
6494,6494,,0,17,2,19
6495,6495,,11,15,52,67
6496,6496,,31,3,2,5
6497,6497,,8,5,5,10
6498,6498,,43,0,1,1
6499,6499,,23,3,8,11
6500,6500,,8,8,8,16
6501,6501,,8,1,2,3
6502,6502,,24,10,7,17
6503,6503,,8,2,0,2
6504,6504,,18,2,5,7
6505,6505,,18,14,0,14
6506,6506,,127,4,2,6
6507,6507,,8,1,2,3
6508,6508,,14,5,6,11
6509,6509,,127,0,1,1
6510,6510,,127,4,3,7
6511,6511,,11,17,28,45
6512,6512,,23,0,1,1
6513,6513,,0,2,19,21
6514,6514,,8,9,10,19
6515,6515,,15,1,3,4
6516,6516,,15,19,18,37
6517,6517,,8,0,1,1
6518,6518,,88,13,4,17
6519,6519,,23,4,6,10
6520,6520,,11,40,31,71
6521,6521,,23,60,40,100
6522,6522,,14,2,0,2
6523,6523,,0,1,0,1
6524,6524,,14,0,1,1
6525,6525,,14,8,2,10
6526,6526,,11,0,5,5
6527,6527,,31,3,6,9
6528,6528,,23,2,0,2
6529,6529,,23,0,1,1
6530,6530,,23,1,1,2
6531,6531,,23,37,5,42
6532,6532,,15,8,20,28
6533,6533,,11,0,1,1
6534,6534,,14,3,4,7
6535,6535,,14,0,2,2
6536,6536,,14,7,1,8
6537,6537,,66,4,1,5
6538,6538,,8,0,4,4
6539,6539,,8,1,1,2
6540,6540,,8,11,18,29
6541,6541,,8,1,0,1
6542,6542,,88,1,0,1
6543,6543,,31,23,1,24
6544,6544,,21,5,6,11
6545,6545,,23,4,4,8
6546,6546,,23,40,35,75
6547,6547,,23,9,21,30
6548,6548,,15,2,2,4
6549,6549,,0,8,3,11
6550,6550,,0,6,0,6
6551,6551,,52,5,0,5
6552,6552,,18,4,7,11
6553,6553,,88,1,6,7
6554,6554,,88,3,0,3
6555,6555,,23,1,1,2
6556,6556,,23,3,9,12
6557,6557,,127,2,2,4
6558,6558,,0,2,2,4
6559,6559,,15,5,7,12
6560,6560,,43,0,6,6
6561,6561,,23,4,2,6
6562,6562,,11,2,0,2
6563,6563,,111,10,26,36
6564,6564,,8,1,0,1
6565,6565,,15,29,47,76
6566,6566,,23,10,7,17
6567,6567,,21,10,24,34
6568,6568,,43,0,4,4
6569,6569,,8,6,7,13
6570,6570,,52,3,10,13
6571,6571,,23,1,1,2
6572,6572,,18,2,0,2
6573,6573,,15,10,2,12
6574,6574,,8,0,1,1
6575,6575,,23,1,0,1
6576,6576,,127,2,1,3
6577,6577,,21,7,14,21
6578,6578,,11,3,4,7
6579,6579,,111,1,5,6
6580,6580,,45,3,1,4
6581,6581,,8,1,6,7
6582,6582,,8,3,5,8
6583,6583,,23,2,8,10
6584,6584,,23,0,1,1
6585,6585,,0,1,0,1
6586,6586,,11,1,2,3
6587,6587,,23,0,1,1
6588,6588,,52,24,45,69
6589,6589,,18,1,1,2
6590,6590,,18,2,0,2
6591,6591,,52,1,4,5
6592,6592,,23,2,1,3
6593,6593,,8,1,0,1
6594,6594,,11,0,1,1
6595,6595,,14,3,1,4
6596,6596,,11,1,3,4
6597,6597,,8,18,25,43
6598,6598,,45,0,2,2
6599,6599,,52,8,6,14
6600,6600,,111,5,3,8
6601,6601,,23,13,19,32
6602,6602,,23,0,1,1
6603,6603,,21,10,8,18
6604,6604,,15,9,10,19
6605,6605,,23,4,6,10
6606,6606,,43,1,3,4
6607,6607,,5,4,25,29
6608,6608,,21,1,1,2
6609,6609,,21,0,1,1
6610,6610,,21,4,1,5
6611,6611,,43,4,2,6
6612,6612,,23,0,1,1
6613,6613,,43,0,1,1
6614,6614,,105,2,3,5
6615,6615,,8,7,0,7
6616,6616,,43,12,5,17
6617,6617,,105,1,1,2
6618,6618,,43,6,13,19
6619,6619,,43,4,3,7
6620,6620,,43,17,6,23
6621,6621,,43,0,3,3
6622,6622,,23,6,5,11
6623,6623,,23,10,11,21
6624,6624,,0,2,7,9
6625,6625,,0,6,13,19
6626,6626,,23,1,0,1
6627,6627,,8,3,2,5
6628,6628,,23,13,7,20
6629,6629,,24,1,1,2
6630,6630,,24,3,2,5
6631,6631,,15,0,5,5
6632,6632,,3,10,11,21
6633,6633,,23,2,3,5
6634,6634,,43,1,2,3
6635,6635,,11,0,1,1
6636,6636,,8,1,7,8
6637,6637,,8,11,16,27
6638,6638,,14,1,1,2
6639,6639,,23,0,1,1
6640,6640,,23,45,50,95
6641,6641,,14,5,9,14
6642,6642,,14,1,0,1
6643,6643,,14,2,0,2
6644,6644,,88,0,2,2
6645,6645,,88,1,1,2
6646,6646,,5,0,2,2
6647,6647,,24,10,3,13
6648,6648,,127,2,6,8
6649,6649,,21,6,6,12
6650,6650,,23,43,39,82
6651,6651,,127,4,0,4
6652,6652,,52,6,5,11
6653,6653,,23,0,2,2
6654,6654,,23,1,8,9
6655,6655,,43,1,0,1
6656,6656,,43,2,0,2
6657,6657,,120,2,10,12
6658,6658,,120,2,12,14
6659,6659,,14,25,5,30
6660,6660,,8,1,6,7
6661,6661,,120,9,1,10
6662,6662,,52,27,10,37
6663,6663,,23,0,1,1
6664,6664,,52,1,2,3
6665,6665,,8,5,4,9
6666,6666,,43,32,19,51
6667,6667,,8,3,2,5
6668,6668,,23,14,31,45
6669,6669,,0,0,13,13
6670,6670,,0,9,22,31
6671,6671,,3,3,10,13
6672,6672,,111,6,5,11
6673,6673,,111,1,5,6
6674,6674,,111,15,12,27
6675,6675,,3,1,2,3
6676,6676,,3,8,1,9
6677,6677,,127,1,2,3
6678,6678,,11,3,1,4
6679,6679,,52,12,25,37
6680,6680,,23,0,2,2
6681,6681,,14,2,2,4
6682,6682,,31,5,2,7
6683,6683,,31,7,3,10
6684,6684,,31,3,2,5
6685,6685,,31,3,8,11
6686,6686,,18,2,3,5
6687,6687,,23,4,2,6
6688,6688,,45,9,9,18
6689,6689,,14,2,9,11
6690,6690,,23,1,0,1
6691,6691,,8,5,5,10
6692,6692,,8,19,14,33
6693,6693,,23,0,2,2
6694,6694,,14,6,4,10
6695,6695,,8,2,4,6
6696,6696,,6,0,1,1
6697,6697,,6,1,0,1
6698,6698,,76,1,2,3
6699,6699,,11,0,1,1
6700,6700,,18,0,1,1
6701,6701,,8,0,5,5
6702,6702,,31,6,28,34
6703,6703,,76,0,1,1
6704,6704,,8,12,9,21
6705,6705,,14,6,12,18
6706,6706,,127,2,3,5
6707,6707,,23,0,1,1
6708,6708,,23,10,24,34
6709,6709,,23,7,3,10
6710,6710,,8,0,2,2
6711,6711,,8,4,2,6
6712,6712,,23,34,40,74
6713,6713,,23,7,3,10
6714,6714,,6,24,35,59
6715,6715,,3,5,3,8
6716,6716,,8,10,3,13
6717,6717,,43,19,5,24
6718,6718,,23,4,11,15
6719,6719,,23,28,15,43
6720,6720,,15,11,0,11
6721,6721,,88,2,2,4
6722,6722,,8,14,8,22
6723,6723,,111,1,1,2
6724,6724,,111,1,3,4
6725,6725,,127,2,0,2
6726,6726,,23,2,2,4
6727,6727,,8,6,7,13
6728,6728,,23,2,1,3
6729,6729,,105,3,10,13
6730,6730,,105,1,1,2
6731,6731,,14,26,27,53
6732,6732,,111,4,0,4
6733,6733,,111,0,2,2
6734,6734,,111,1,2,3
6735,6735,,3,15,16,31
6736,6736,,23,1,3,4
6737,6737,,11,1,1,2
6738,6738,,23,8,5,13
6739,6739,,15,3,3,6
6740,6740,,18,0,3,3
6741,6741,,15,8,8,16
6742,6742,,15,4,2,6
6743,6743,,14,1,1,2
6744,6744,,43,14,12,26
6745,6745,,8,1,0,1
6746,6746,,23,26,40,66
6747,6747,,14,1,3,4
6748,6748,,23,5,4,9
6749,6749,,15,3,5,8
6750,6750,,18,2,2,4
6751,6751,,45,0,2,2
6752,6752,,24,15,30,45
6753,6753,,8,13,10,23
6754,6754,,15,2,1,3
6755,6755,,52,55,51,106
6756,6756,,8,0,1,1
6757,6757,,8,1,2,3
6758,6758,,8,2,20,22
6759,6759,,3,3,2,5
6760,6760,,127,0,5,5
6761,6761,,6,1,4,5
6762,6762,,11,0,10,10
6763,6763,,11,2,3,5
6764,6764,,8,4,6,10
6765,6765,,11,6,5,11
6766,6766,,23,6,7,13
6767,6767,,76,2,11,13
6768,6768,,76,4,19,23
6769,6769,,23,4,6,10
6770,6770,,14,22,50,72
6771,6771,,14,17,19,36
6772,6772,,8,1,0,1
6773,6773,,76,3,5,8
6774,6774,,15,0,1,1
6775,6775,,15,14,18,32
6776,6776,,8,1,3,4
6777,6777,,14,0,1,1
6778,6778,,23,3,5,8
6779,6779,,66,0,2,2
6780,6780,,66,1,0,1
6781,6781,,23,2,5,7
6782,6782,,45,0,3,3
6783,6783,,18,2,0,2
6784,6784,,52,27,29,56
6785,6785,,23,1,0,1
6786,6786,,8,1,1,2
6787,6787,,18,1,0,1
6788,6788,,21,5,7,12
6789,6789,,23,11,8,19
6790,6790,,15,5,6,11
6791,6791,,23,2,3,5
6792,6792,,45,4,1,5
6793,6793,,15,16,11,27
6794,6794,,11,3,12,15
6795,6795,,23,1,1,2
6796,6796,,111,6,24,30
6797,6797,,31,45,31,76
6798,6798,,23,1,1,2
6799,6799,,15,0,1,1
6800,6800,,127,11,8,19
6801,6801,,8,145,140,285
6802,6802,,127,2,3,5
6803,6803,,127,1,3,4
6804,6804,,11,8,10,18
6805,6805,,111,1,2,3
6806,6806,,0,1,0,1
6807,6807,,23,23,38,61
6808,6808,,6,1,1,2
6809,6809,,23,0,3,3
6810,6810,,23,0,2,2
6811,6811,,0,12,15,27
6812,6812,,111,4,3,7
6813,6813,,8,4,0,4
6814,6814,,0,2,22,24
6815,6815,,23,0,1,1
6816,6816,,8,29,17,46
6817,6817,,23,0,1,1
6818,6818,,0,5,2,7
6819,6819,,0,1,0,1
6820,6820,,23,16,13,29
6821,6821,,8,1,2,3
6822,6822,,15,5,8,13
6823,6823,,43,0,1,1
6824,6824,,3,0,5,5
6825,6825,,3,13,4,17
6826,6826,,8,1,2,3
6827,6827,,8,0,8,8
6828,6828,,43,1,1,2
6829,6829,,52,2,9,11
6830,6830,,52,0,3,3
6831,6831,,52,7,10,17
6832,6832,,88,0,2,2
6833,6833,,21,5,2,7
6834,6834,,111,4,2,6
6835,6835,,23,2,2,4
6836,6836,,23,7,11,18
6837,6837,,23,5,0,5
6838,6838,,45,2,1,3
6839,6839,,45,5,2,7
6840,6840,,23,1,3,4
6841,6841,,23,0,1,1
6842,6842,,23,7,22,29
6843,6843,,45,4,4,8
6844,6844,,8,1,1,2
6845,6845,,8,1,2,3
6846,6846,,11,1,2,3
6847,6847,,5,5,3,8
6848,6848,,23,5,1,6
6849,6849,,66,14,5,19
6850,6850,,24,0,2,2
6851,6851,,24,22,20,42
6852,6852,,31,10,15,25
6853,6853,,3,10,13,23
6854,6854,,11,17,10,27
6855,6855,,21,26,13,39
6856,6856,,43,3,6,9
6857,6857,,43,10,3,13
6858,6858,,43,6,26,32
6859,6859,,88,7,8,15
6860,6860,,0,1,3,4
6861,6861,,66,6,3,9
6862,6862,,88,2,3,5
6863,6863,,5,0,4,4
6864,6864,,5,13,11,24
6865,6865,,76,8,19,27
6866,6866,,21,29,21,50
6867,6867,,23,10,14,24
6868,6868,,23,1,0,1
6869,6869,,88,2,0,2
6870,6870,,8,0,2,2
6871,6871,,21,6,16,22
6872,6872,,43,2,0,2
6873,6873,,88,0,2,2
6874,6874,,88,2,8,10
6875,6875,,8,6,13,19
6876,6876,,8,1,0,1
6877,6877,,23,1,1,2
6878,6878,,0,8,1,9
6879,6879,,23,0,2,2
6880,6880,,127,10,12,22
6881,6881,,23,10,12,22
6882,6882,,43,6,4,10
6883,6883,,8,4,6,10
6884,6884,,43,1,10,11
6885,6885,,43,9,10,19
6886,6886,,14,1,1,2
6887,6887,,14,14,12,26
6888,6888,,8,1,2,3
6889,6889,,43,0,2,2
6890,6890,,14,1,5,6
6891,6891,,111,1,2,3
6892,6892,,111,4,5,9
6893,6893,,111,1,2,3
6894,6894,,0,15,5,20
6895,6895,,8,10,13,23
6896,6896,,23,2,0,2
6897,6897,,8,1,1,2
6898,6898,,23,1,1,2
6899,6899,,23,1,0,1
6900,6900,,43,2,4,6
6901,6901,,8,5,1,6
6902,6902,,8,2,7,9
6903,6903,,8,2,5,7
6904,6904,,23,4,22,26
6905,6905,,31,2,9,11
6906,6906,,31,1,0,1
6907,6907,,31,5,5,10
6908,6908,,31,9,20,29
6909,6909,,31,7,16,23
6910,6910,,31,1,4,5
6911,6911,,23,9,13,22
6912,6912,,14,26,19,45
6913,6913,,14,2,1,3
6914,6914,,14,1,0,1
6915,6915,,14,0,4,4
6916,6916,,14,12,4,16
6917,6917,,14,0,1,1
6918,6918,,43,6,2,8
6919,6919,,43,10,23,33
6920,6920,,43,1,3,4
6921,6921,,43,30,11,41
6922,6922,,43,2,1,3
6923,6923,,43,9,1,10
6924,6924,,23,1,0,1
6925,6925,,8,6,23,29
6926,6926,,0,3,4,7
6927,6927,,15,0,2,2
6928,6928,,43,0,1,1
6929,6929,,23,5,6,11
6930,6930,,127,29,51,80
6931,6931,,23,7,2,9
6932,6932,,23,8,4,12
6933,6933,,23,1,2,3
6934,6934,,15,4,0,4
6935,6935,,23,9,1,10
6936,6936,,23,18,24,42
6937,6937,,23,6,3,9
6938,6938,,23,0,1,1
6939,6939,,14,0,3,3
6940,6940,,23,3,2,5
6941,6941,,23,2,4,6
6942,6942,,105,36,13,49
6943,6943,,8,1,0,1
6944,6944,,31,7,9,16
6945,6945,,111,1,1,2
6946,6946,,23,6,9,15
6947,6947,,8,1,0,1
6948,6948,,11,0,4,4
6949,6949,,14,15,17,32
6950,6950,,25,0,1,1
6951,6951,,25,1,0,1
6952,6952,,8,0,1,1
6953,6953,,23,1,1,2
6954,6954,,23,0,1,1
6955,6955,,23,9,6,15
6956,6956,,0,4,0,4
6957,6957,,111,12,14,26
6958,6958,,15,4,0,4
6959,6959,,15,1,4,5
6960,6960,,15,20,9,29
6961,6961,,21,4,6,10
6962,6962,,14,2,7,9
6963,6963,,23,2,0,2
6964,6964,,15,3,11,14
6965,6965,,105,5,27,32
6966,6966,,88,2,0,2
6967,6967,,88,0,1,1
6968,6968,,88,1,1,2
6969,6969,,18,3,0,3
6970,6970,,18,5,4,9
6971,6971,,23,0,2,2
6972,6972,,21,3,3,6
6973,6973,,88,3,0,3
6974,6974,,11,13,1,14
6975,6975,,11,1,1,2
6976,6976,,8,1,0,1
6977,6977,,31,0,3,3
6978,6978,,31,0,3,3
6979,6979,,31,3,3,6
6980,6980,,31,13,23,36
6981,6981,,8,0,3,3
6982,6982,,120,0,11,11
6983,6983,,8,5,2,7
6984,6984,,8,1,0,1
6985,6985,,127,0,1,1
6986,6986,,105,1,0,1
6987,6987,,23,9,33,42
6988,6988,,23,10,5,15
6989,6989,,6,12,3,15
6990,6990,,18,3,0,3
6991,6991,,23,1,0,1
6992,6992,,14,1,8,9
6993,6993,,18,1,3,4
6994,6994,,23,0,1,1
6995,6995,,26,0,1,1
6996,6996,,26,1,0,1
6997,6997,,127,0,4,4
6998,6998,,127,5,1,6
6999,6999,,8,0,1,1
7000,7000,,43,7,0,7
7001,7001,,8,0,1,1
7002,7002,,3,4,10,14
7003,7003,,3,7,1,8
7004,7004,,23,13,3,16
7005,7005,,14,2,8,10
7006,7006,,6,3,15,18
7007,7007,,6,1,17,18
7008,7008,,8,14,17,31
7009,7009,,11,4,4,8
7010,7010,,76,4,1,5
7011,7011,,8,11,1,12
7012,7012,,14,9,12,21
7013,7013,,31,4,11,15
7014,7014,,31,1,0,1
7015,7015,,31,3,6,9
7016,7016,,14,5,3,8
7017,7017,,8,4,4,8
7018,7018,,23,1,0,1
7019,7019,,0,3,6,9
7020,7020,,88,1,0,1
7021,7021,,5,0,4,4
7022,7022,,45,27,27,54
7023,7023,,45,2,0,2
7024,7024,,23,0,2,2
7025,7025,,21,0,5,5
7026,7026,,31,18,86,104
7027,7027,,23,41,46,87
7028,7028,,3,13,20,33
7029,7029,,0,3,4,7
7030,7030,,31,5,3,8
7031,7031,,23,8,1,9
7032,7032,,15,15,10,25
7033,7033,,15,17,9,26
7034,7034,,8,7,3,10
7035,7035,,8,11,8,19
7036,7036,,23,2,4,6
7037,7037,,23,3,4,7
7038,7038,,52,6,4,10
7039,7039,,21,6,17,23
7040,7040,,88,3,5,8
7041,7041,,45,2,1,3
7042,7042,,45,1,1,2
7043,7043,,0,1,15,16
7044,7044,,23,20,22,42
7045,7045,,8,2,4,6
7046,7046,,88,5,17,22
7047,7047,,24,1,1,2
7048,7048,,11,2,2,4
7049,7049,,8,2,1,3
7050,7050,,15,3,8,11
7051,7051,,8,1,0,1
7052,7052,,11,9,3,12
7053,7053,,11,2,10,12
7054,7054,,21,3,3,6
7055,7055,,45,3,6,9
7056,7056,,23,0,1,1
7057,7057,,23,12,27,39
7058,7058,,23,0,1,1
7059,7059,,23,3,0,3
7060,7060,,23,3,2,5
7061,7061,,5,19,25,44
7062,7062,,43,4,1,5
7063,7063,,43,3,4,7
7064,7064,,76,1,0,1
7065,7065,,43,29,27,56
7066,7066,,43,4,1,5
7067,7067,,127,25,8,33
7068,7068,,43,1,1,2
7069,7069,,127,1,2,3
7070,7070,,21,3,11,14
7071,7071,,3,6,0,6
7072,7072,,3,1,1,2
7073,7073,,3,4,1,5
7074,7074,,3,3,0,3
7075,7075,,52,1,3,4
7076,7076,,8,0,2,2
7077,7077,,21,15,22,37
7078,7078,,127,0,3,3
7079,7079,,0,1,1,2
7080,7080,,0,1,2,3
7081,7081,,0,1,1,2
7082,7082,,14,0,8,8
7083,7083,,8,8,21,29
7084,7084,,88,6,12,18
7085,7085,,88,25,7,32
7086,7086,,88,3,4,7
7087,7087,,88,3,4,7
7088,7088,,8,12,17,29
7089,7089,,5,3,2,5
7090,7090,,127,1,0,1
7091,7091,,45,1,2,3
7092,7092,,14,2,11,13
7093,7093,,14,4,6,10
7094,7094,,43,2,0,2
7095,7095,,43,3,2,5
7096,7096,,127,0,1,1
7097,7097,,127,6,4,10
7098,7098,,0,3,0,3
7099,7099,,23,9,12,21
7100,7100,,8,1,2,3
7101,7101,,111,5,8,13
7102,7102,,23,0,1,1
7103,7103,,14,14,15,29
7104,7104,,105,2,0,2
7105,7105,,127,2,3,5
7106,7106,,88,0,1,1
7107,7107,,15,1,1,2
7108,7108,,43,4,9,13
7109,7109,,31,5,7,12
7110,7110,,6,3,3,6
7111,7111,,31,0,3,3
7112,7112,,15,1,3,4
7113,7113,,23,14,13,27
7114,7114,,23,10,11,21
7115,7115,,111,21,17,38
7116,7116,,3,2,2,4
7117,7117,,3,1,2,3
7118,7118,,45,1,0,1
7119,7119,,8,2,4,6
7120,7120,,8,1,1,2
7121,7121,,11,7,6,13
7122,7122,,8,1,1,2
7123,7123,,14,9,2,11
7124,7124,,6,4,3,7
7125,7125,,105,2,0,2
7126,7126,,0,5,3,8
7127,7127,,23,3,3,6
7128,7128,,23,4,2,6
7129,7129,,18,2,2,4
7130,7130,,23,0,1,1
7131,7131,,14,30,12,42
7132,7132,,127,0,1,1
7133,7133,,27,0,4,4
7134,7134,,27,2,0,2
7135,7135,,31,0,3,3
7136,7136,,3,10,11,21
7137,7137,,24,7,14,21
7138,7138,,23,12,25,37
7139,7139,,45,17,21,38
7140,7140,,23,18,8,26
7141,7141,,23,3,2,5
7142,7142,,23,4,15,19
7143,7143,,14,1,2,3
7144,7144,,11,1,5,6
7145,7145,,23,0,1,1
7146,7146,,28,0,1,1
7147,7147,,28,1,0,1
7148,7148,,76,2,2,4
7149,7149,,5,76,62,138
7150,7150,,15,18,29,47
7151,7151,,31,2,3,5
7152,7152,,31,5,4,9
7153,7153,,8,7,14,21
7154,7154,,6,8,2,10
7155,7155,,43,0,1,1
7156,7156,,43,1,4,5
7157,7157,,8,0,5,5
7158,7158,,14,12,10,22
7159,7159,,18,8,10,18
7160,7160,,23,6,32,38
7161,7161,,8,11,11,22
7162,7162,,111,3,5,8
7163,7163,,111,1,0,1
7164,7164,,0,0,1,1
7165,7165,,23,15,8,23
7166,7166,,23,5,15,20
7167,7167,,76,20,33,53
7168,7168,,76,1,0,1
7169,7169,,76,22,23,45
7170,7170,,76,1,1,2
7171,7171,,14,1,0,1
7172,7172,,23,1,2,3
7173,7173,,31,3,1,4
7174,7174,,14,1,10,11
7175,7175,,21,13,8,21
7176,7176,,23,3,2,5
7177,7177,,15,2,0,2
7178,7178,,23,2,0,2
7179,7179,,8,8,1,9
7180,7180,,88,0,3,3
7181,7181,,88,1,0,1
7182,7182,,0,2,6,8
7183,7183,,52,2,8,10
7184,7184,,14,26,26,52
7185,7185,,23,3,3,6
7186,7186,,8,2,1,3
7187,7187,,8,4,9,13
7188,7188,,43,10,7,17
7189,7189,,15,1,2,3
7190,7190,,24,1,0,1
7191,7191,,111,1,2,3
7192,7192,,29,1,1,2
7193,7193,,29,1,1,2
7194,7194,,14,5,2,7
7195,7195,,18,8,5,13
7196,7196,,31,10,24,34
7197,7197,,31,30,17,47
7198,7198,,15,22,22,44
7199,7199,,88,3,7,10
7200,7200,,11,11,10,21
7201,7201,,8,4,10,14
7202,7202,,21,4,12,16
7203,7203,,23,1,0,1
7204,7204,,21,4,2,6
7205,7205,,52,1,2,3
7206,7206,,31,5,3,8
7207,7207,,31,3,0,3
7208,7208,,15,1,1,2
7209,7209,,127,7,5,12
7210,7210,,127,1,5,6
7211,7211,,23,2,1,3
7212,7212,,127,18,12,30
7213,7213,,23,7,6,13
7214,7214,,23,1,0,1
7215,7215,,23,2,7,9
7216,7216,,23,2,0,2
7217,7217,,23,1,2,3
7218,7218,,23,25,17,42
7219,7219,,8,7,1,8
7220,7220,,21,25,40,65
7221,7221,,0,2,0,2
7222,7222,,31,0,4,4
7223,7223,,31,8,9,17
7224,7224,,15,11,18,29
7225,7225,,52,1,3,4
7226,7226,,52,5,6,11
7227,7227,,24,0,1,1
7228,7228,,23,1,0,1
7229,7229,,120,15,20,35
7230,7230,,23,8,9,17
7231,7231,,0,1,7,8
7232,7232,,45,1,0,1
7233,7233,,8,4,1,5
7234,7234,,3,2,3,5
7235,7235,,21,0,1,1
7236,7236,,21,7,5,12
7237,7237,,127,1,2,3
7238,7238,,127,1,2,3
7239,7239,,23,3,5,8
7240,7240,,14,1,3,4
7241,7241,,14,15,17,32
7242,7242,,14,13,11,24
7243,7243,,66,0,4,4
7244,7244,,23,0,11,11
7245,7245,,127,8,2,10
7246,7246,,23,1,3,4
7247,7247,,66,8,2,10
7248,7248,,8,19,15,34
7249,7249,,43,0,1,1
7250,7250,,43,2,1,3
7251,7251,,0,10,20,30
7252,7252,,23,1,1,2
7253,7253,,0,4,8,12
7254,7254,,15,6,6,12
7255,7255,,3,2,5,7
7256,7256,,23,6,19,25
7257,7257,,8,1,1,2
7258,7258,,15,3,2,5
7259,7259,,88,2,1,3
7260,7260,,14,5,5,10
7261,7261,,88,0,2,2
7262,7262,,88,1,6,7
7263,7263,,3,0,1,1
7264,7264,,23,5,5,10
7265,7265,,21,1,3,4
7266,7266,,5,2,4,6
7267,7267,,21,1,3,4
7268,7268,,14,1,0,1
7269,7269,,127,11,13,24
7270,7270,,23,1,15,16
7271,7271,,120,2,29,31
7272,7272,,14,1,4,5
7273,7273,,52,23,14,37
7274,7274,,120,3,3,6
7275,7275,,21,4,1,5
7276,7276,,14,5,1,6
7277,7277,,14,2,0,2
7278,7278,,66,0,3,3
7279,7279,,66,1,2,3
7280,7280,,43,7,6,13
7281,7281,,43,14,21,35
7282,7282,,43,4,2,6
7283,7283,,43,4,2,6
7284,7284,,127,0,1,1
7285,7285,,3,2,2,4
7286,7286,,3,1,2,3
7287,7287,,21,24,26,50
7288,7288,,23,6,2,8
7289,7289,,21,1,1,2
7290,7290,,111,0,6,6
7291,7291,,23,1,5,6
7292,7292,,14,5,11,16
7293,7293,,14,35,98,133
7294,7294,,111,13,20,33
7295,7295,,15,1,2,3
7296,7296,,15,17,2,19
7297,7297,,14,2,5,7
7298,7298,,3,5,5,10
7299,7299,,23,3,13,16
7300,7300,,23,0,1,1
7301,7301,,23,8,10,18
7302,7302,,5,0,2,2
7303,7303,,23,2,3,5
7304,7304,,23,4,4,8
7305,7305,,23,9,4,13
7306,7306,,23,1,1,2
7307,7307,,14,1,5,6
7308,7308,,14,5,8,13
7309,7309,,14,4,3,7
7310,7310,,15,0,8,8
7311,7311,,15,16,5,21
7312,7312,,21,10,27,37
7313,7313,,23,7,4,11
7314,7314,,14,1,2,3
7315,7315,,14,1,4,5
7316,7316,,3,0,4,4
7317,7317,,23,83,114,197
7318,7318,,15,6,16,22
7319,7319,,24,2,9,11
7320,7320,,43,3,2,5
7321,7321,,31,13,13,26
7322,7322,,31,0,1,1
7323,7323,,31,0,1,1
7324,7324,,8,16,2,18
7325,7325,,8,0,4,4
7326,7326,,31,14,22,36
7327,7327,,8,1,3,4
7328,7328,,8,1,0,1
7329,7329,,8,2,0,2
7330,7330,,8,0,2,2
7331,7331,,8,0,9,9
7332,7332,,3,10,13,23
7333,7333,,23,0,9,9
7334,7334,,0,1,0,1
7335,7335,,5,29,21,50
7336,7336,,15,1,0,1
7337,7337,,31,1,1,2
7338,7338,,31,1,2,3
7339,7339,,14,2,1,3
7340,7340,,21,0,1,1
7341,7341,,5,20,24,44
7342,7342,,21,3,2,5
7343,7343,,14,4,2,6
7344,7344,,14,0,2,2
7345,7345,,15,6,9,15
7346,7346,,23,7,10,17
7347,7347,,127,1,0,1
7348,7348,,23,2,6,8
7349,7349,,120,15,1,16
7350,7350,,43,7,1,8
7351,7351,,23,2,3,5
7352,7352,,23,2,1,3
7353,7353,,31,2,8,10
7354,7354,,31,1,6,7
7355,7355,,111,1,0,1
7356,7356,,14,0,2,2
7357,7357,,14,15,10,25
7358,7358,,8,2,3,5
7359,7359,,8,1,0,1
7360,7360,,8,0,3,3
7361,7361,,15,0,1,1
7362,7362,,14,2,0,2
7363,7363,,15,1,1,2
7364,7364,,15,0,4,4
7365,7365,,43,1,2,3
7366,7366,,23,0,4,4
7367,7367,,23,2,1,3
7368,7368,,15,1,1,2
7369,7369,,76,5,0,5
7370,7370,,15,2,5,7
7371,7371,,6,3,6,9
7372,7372,,23,0,1,1
7373,7373,,0,2,24,26
7374,7374,,23,0,3,3
7375,7375,,23,0,2,2
7376,7376,,43,0,1,1
7377,7377,,31,1,8,9
7378,7378,,31,1,1,2
7379,7379,,31,2,2,4
7380,7380,,15,2,1,3
7381,7381,,11,1,0,1
7382,7382,,23,1,0,1
7383,7383,,11,6,3,9
7384,7384,,11,1,0,1
7385,7385,,8,1,2,3
7386,7386,,8,8,0,8
7387,7387,,23,1,2,3
7388,7388,,111,0,2,2
7389,7389,,21,13,9,22
7390,7390,,18,21,3,24
7391,7391,,105,3,4,7
7392,7392,,15,1,6,7
7393,7393,,45,3,4,7
7394,7394,,43,12,11,23
7395,7395,,43,24,28,52
7396,7396,,127,2,1,3
7397,7397,,127,0,3,3
7398,7398,,23,1,1,2
7399,7399,,15,2,4,6
7400,7400,,15,2,0,2
7401,7401,,66,3,0,3
7402,7402,,8,0,1,1
7403,7403,,43,0,1,1
7404,7404,,5,2,8,10
7405,7405,,45,8,20,28
7406,7406,,127,5,2,7
7407,7407,,23,15,22,37
7408,7408,,8,3,2,5
7409,7409,,24,13,21,34
7410,7410,,45,1,0,1
7411,7411,,31,13,12,25
7412,7412,,127,6,14,20
7413,7413,,127,2,2,4
7414,7414,,3,3,2,5
7415,7415,,52,2,17,19
7416,7416,,24,0,3,3
7417,7417,,24,3,0,3
7418,7418,,24,6,0,6
7419,7419,,127,2,0,2
7420,7420,,23,3,3,6
7421,7421,,43,2,5,7
7422,7422,,105,0,1,1
7423,7423,,111,37,28,65
7424,7424,,111,18,12,30
7425,7425,,23,9,16,25
7426,7426,,105,0,2,2
7427,7427,,23,1,5,6
7428,7428,,23,2,5,7
7429,7429,,11,6,5,11
7430,7430,,0,6,23,29
7431,7431,,23,3,4,7
7432,7432,,23,0,2,2
7433,7433,,43,2,14,16
7434,7434,,11,0,8,8
7435,7435,,11,1,0,1
7436,7436,,11,3,1,4
7437,7437,,11,4,3,7
7438,7438,,15,5,8,13
7439,7439,,8,6,2,8
7440,7440,,23,7,6,13
7441,7441,,15,2,1,3
7442,7442,,15,8,9,17
7443,7443,,23,12,18,30
7444,7444,,23,8,9,17
7445,7445,,21,4,5,9
7446,7446,,43,0,1,1
7447,7447,,127,1,0,1
7448,7448,,8,1,0,1
7449,7449,,45,8,4,12
7450,7450,,21,1,2,3
7451,7451,,31,0,2,2
7452,7452,,23,3,2,5
7453,7453,,0,2,7,9
7454,7454,,23,0,2,2
7455,7455,,3,1,1,2
7456,7456,,3,1,3,4
7457,7457,,88,9,4,13
7458,7458,,127,9,8,17
7459,7459,,43,2,5,7
7460,7460,,43,4,7,11
7461,7461,,43,20,31,51
7462,7462,,8,9,20,29
7463,7463,,24,19,18,37
7464,7464,,88,7,0,7
7465,7465,,21,8,25,33
7466,7466,,15,3,3,6
7467,7467,,66,20,18,38
7468,7468,,23,1,0,1
7469,7469,,66,1,0,1
7470,7470,,23,3,4,7
7471,7471,,52,0,4,4
7472,7472,,23,21,25,46
7473,7473,,23,2,1,3
7474,7474,,23,3,7,10
7475,7475,,127,3,1,4
7476,7476,,23,1,0,1
7477,7477,,21,6,2,8
7478,7478,,23,1,2,3
7479,7479,,15,5,11,16
7480,7480,,11,10,12,22
7481,7481,,76,2,9,11
7482,7482,,3,0,2,2
7483,7483,,76,2,3,5
7484,7484,,23,1,0,1
7485,7485,,23,3,9,12
7486,7486,,43,0,1,1
7487,7487,,66,1,0,1
7488,7488,,8,6,6,12
7489,7489,,88,2,5,7
7490,7490,,8,0,2,2
7491,7491,,8,1,0,1
7492,7492,,120,4,4,8
7493,7493,,23,21,8,29
7494,7494,,43,1,0,1
7495,7495,,23,0,2,2
7496,7496,,23,2,0,2
7497,7497,,127,6,44,50
7498,7498,,127,17,9,26
7499,7499,,127,1,1,2
7500,7500,,23,4,5,9
7501,7501,,127,0,3,3
7502,7502,,23,7,1,8
7503,7503,,23,52,4,56
7504,7504,,23,0,1,1
7505,7505,,23,0,1,1
7506,7506,,43,81,127,208
7507,7507,,43,1,0,1
7508,7508,,18,3,3,6
7509,7509,,18,19,27,46
7510,7510,,5,5,15,20
7511,7511,,43,15,10,25
7512,7512,,23,13,12,25
7513,7513,,8,2,0,2
7514,7514,,18,0,1,1
7515,7515,,23,6,3,9
7516,7516,,8,1,2,3
7517,7517,,15,1,4,5
7518,7518,,14,3,2,5
7519,7519,,15,4,3,7
7520,7520,,23,1,0,1
7521,7521,,8,1,2,3
7522,7522,,8,0,4,4
7523,7523,,8,0,4,4
7524,7524,,8,4,1,5
7525,7525,,8,6,6,12
7526,7526,,105,1,0,1
7527,7527,,5,6,3,9
7528,7528,,15,4,6,10
7529,7529,,8,1,3,4
7530,7530,,8,1,0,1
7531,7531,,52,9,6,15
7532,7532,,127,3,0,3
7533,7533,,15,4,11,15
7534,7534,,18,2,1,3
7535,7535,,18,1,1,2
7536,7536,,21,24,11,35
7537,7537,,21,4,9,13
7538,7538,,8,1,2,3
7539,7539,,21,0,2,2
7540,7540,,21,0,7,7
7541,7541,,23,0,2,2
7542,7542,,21,2,8,10
7543,7543,,23,63,107,170
7544,7544,,15,0,1,1
7545,7545,,15,3,0,3
7546,7546,,21,14,15,29
7547,7547,,23,0,1,1
7548,7548,,43,1,10,11
7549,7549,,8,2,0,2
7550,7550,,8,2,3,5
7551,7551,,8,4,6,10
7552,7552,,127,8,10,18
7553,7553,,43,3,0,3
7554,7554,,8,11,0,11
7555,7555,,23,4,10,14
7556,7556,,88,3,3,6
7557,7557,,88,3,3,6
7558,7558,,43,2,9,11
7559,7559,,45,3,7,10
7560,7560,,23,7,1,8
7561,7561,,43,8,5,13
7562,7562,,30,0,1,1
7563,7563,,30,1,0,1
7564,7564,,8,0,8,8
7565,7565,,15,0,12,12
7566,7566,,8,4,12,16
7567,7567,,8,1,2,3
7568,7568,,8,0,1,1
7569,7569,,45,0,2,2
7570,7570,,127,1,0,1
7571,7571,,23,3,9,12
7572,7572,,127,2,2,4
7573,7573,,14,1,1,2
7574,7574,,14,3,3,6
7575,7575,,23,0,1,1
7576,7576,,11,10,4,14
7577,7577,,0,3,0,3
7578,7578,,105,0,2,2
7579,7579,,21,14,21,35
7580,7580,,14,26,23,49
7581,7581,,14,3,12,15
7582,7582,,14,11,14,25
7583,7583,,8,4,14,18
7584,7584,,23,2,5,7
7585,7585,,23,3,2,5
7586,7586,,127,19,6,25
7587,7587,,8,1,1,2
7588,7588,,8,0,12,12
7589,7589,,15,0,1,1
7590,7590,,15,5,1,6
7591,7591,,76,0,2,2
7592,7592,,23,10,19,29
7593,7593,,23,8,19,27
7594,7594,,3,13,7,20
7595,7595,,5,3,3,6
7596,7596,,11,1,13,14
7597,7597,,14,9,2,11
7598,7598,,11,0,1,1
7599,7599,,24,10,13,23
7600,7600,,23,0,2,2
7601,7601,,23,1,3,4
7602,7602,,23,4,6,10
7603,7603,,105,0,1,1
7604,7604,,5,3,9,12
7605,7605,,21,0,1,1
7606,7606,,15,5,2,7
7607,7607,,23,0,1,1
7608,7608,,23,4,3,7
7609,7609,,11,0,2,2
7610,7610,,11,1,4,5
7611,7611,,8,15,11,26
7612,7612,,127,0,1,1
7613,7613,,23,4,6,10
7614,7614,,8,8,7,15
7615,7615,,8,15,13,28
7616,7616,,14,10,2,12
7617,7617,,8,2,2,4
7618,7618,,0,2,7,9
7619,7619,,8,2,7,9
7620,7620,,43,4,12,16
7621,7621,,105,8,7,15
7622,7622,,3,22,8,30
7623,7623,,14,0,3,3
7624,7624,,3,21,20,41
7625,7625,,23,1,4,5
7626,7626,,111,0,2,2
7627,7627,,45,0,1,1
7628,7628,,45,3,0,3
7629,7629,,52,1,0,1
7630,7630,,21,1,2,3
7631,7631,,21,1,3,4
7632,7632,,120,2,0,2
7633,7633,,0,4,10,14
7634,7634,,52,6,30,36
7635,7635,,105,4,0,4
7636,7636,,5,2,2,4
7637,7637,,43,2,0,2
7638,7638,,21,1,0,1
7639,7639,,15,0,3,3
7640,7640,,111,15,26,41
7641,7641,,105,3,2,5
7642,7642,,76,0,3,3
7643,7643,,23,1,3,4
7644,7644,,43,0,3,3
7645,7645,,31,5,7,12
7646,7646,,31,4,0,4
7647,7647,,21,3,2,5
7648,7648,,18,5,17,22
7649,7649,,31,7,5,12
7650,7650,,15,0,1,1
7651,7651,,23,5,10,15
7652,7652,,23,0,1,1
7653,7653,,105,3,0,3
7654,7654,,8,0,1,1
7655,7655,,8,2,6,8
7656,7656,,14,2,3,5
7657,7657,,21,8,0,8
7658,7658,,127,12,3,15
7659,7659,,127,2,3,5
7660,7660,,127,1,1,2
7661,7661,,23,25,4,29
7662,7662,,23,0,1,1
7663,7663,,43,3,3,6
7664,7664,,8,0,1,1
7665,7665,,15,2,4,6
7666,7666,,88,4,1,5
7667,7667,,14,5,6,11
7668,7668,,23,1,0,1
7669,7669,,5,9,22,31
7670,7670,,11,4,11,15
7671,7671,,23,1,0,1
7672,7672,,8,3,6,9
7673,7673,,31,5,1,6
7674,7674,,11,8,4,12
7675,7675,,15,2,5,7
7676,7676,,8,7,7,14
7677,7677,,127,3,1,4
7678,7678,,45,11,10,21
7679,7679,,45,26,52,78
7680,7680,,45,4,6,10
7681,7681,,45,10,1,11
7682,7682,,31,6,1,7
7683,7683,,14,1,2,3
7684,7684,,127,0,7,7
7685,7685,,111,2,4,6
7686,7686,,111,1,1,2
7687,7687,,111,5,2,7
7688,7688,,21,6,10,16
7689,7689,,21,7,5,12
7690,7690,,15,0,6,6
7691,7691,,23,5,7,12
7692,7692,,23,10,10,20
7693,7693,,3,6,7,13
7694,7694,,8,7,4,11
7695,7695,,127,1,2,3
7696,7696,,18,0,1,1
7697,7697,,0,2,4,6
7698,7698,,127,1,1,2
7699,7699,,52,1,2,3
7700,7700,,23,3,3,6
7701,7701,,21,41,26,67
7702,7702,,23,4,0,4
7703,7703,,111,0,1,1
7704,7704,,14,1,0,1
7705,7705,,31,1,2,3
7706,7706,,23,2,3,5
7707,7707,,43,7,7,14
7708,7708,,23,2,0,2
7709,7709,,105,2,1,3
7710,7710,,31,1,1,2
7711,7711,,31,1,5,6
7712,7712,,23,4,6,10
7713,7713,,0,5,18,23
7714,7714,,23,1,3,4
7715,7715,,8,2,1,3
7716,7716,,8,2,1,3
7717,7717,,111,2,0,2
7718,7718,,45,0,1,1
7719,7719,,45,1,2,3
7720,7720,,23,32,25,57
7721,7721,,18,0,1,1
7722,7722,,18,5,1,6
7723,7723,,18,0,1,1
7724,7724,,18,2,3,5
7725,7725,,43,32,3,35
7726,7726,,105,3,12,15
7727,7727,,8,8,5,13
7728,7728,,23,2,5,7
7729,7729,,23,11,1,12
7730,7730,,127,0,3,3
7731,7731,,31,0,2,2
7732,7732,,15,4,8,12
7733,7733,,127,3,3,6
7734,7734,,127,2,3,5
7735,7735,,111,5,6,11
7736,7736,,11,1,4,5
7737,7737,,21,4,3,7
7738,7738,,11,22,27,49
7739,7739,,3,0,2,2
7740,7740,,3,14,10,24
7741,7741,,31,2,6,8
7742,7742,,31,12,12,24
7743,7743,,5,10,11,21
7744,7744,,3,3,1,4
7745,7745,,8,3,1,4
7746,7746,,11,0,3,3
7747,7747,,8,3,0,3
7748,7748,,8,0,3,3
7749,7749,,15,5,1,6
7750,7750,,8,2,14,16
7751,7751,,8,0,3,3
7752,7752,,21,3,2,5
7753,7753,,52,8,3,11
7754,7754,,0,7,5,12
7755,7755,,8,7,4,11
7756,7756,,8,4,5,9
7757,7757,,43,2,1,3
7758,7758,,43,1,1,2
7759,7759,,15,5,3,8
7760,7760,,24,5,10,15
7761,7761,,3,8,8,16
7762,7762,,23,2,0,2
7763,7763,,31,6,0,6
7764,7764,,15,2,0,2
7765,7765,,23,3,6,9
7766,7766,,8,12,18,30
7767,7767,,6,7,10,17
7768,7768,,66,1,0,1
7769,7769,,43,1,0,1
7770,7770,,127,14,16,30
7771,7771,,21,3,2,5
7772,7772,,14,3,11,14
7773,7773,,0,3,0,3
7774,7774,,23,0,6,6
7775,7775,,0,4,2,6
7776,7776,,21,14,17,31
7777,7777,,43,0,6,6
7778,7778,,43,1,2,3
7779,7779,,43,1,4,5
7780,7780,,43,3,8,11
7781,7781,,23,3,0,3
7782,7782,,66,1,1,2
7783,7783,,23,8,16,24
7784,7784,,23,1,2,3
7785,7785,,88,2,2,4
7786,7786,,88,0,3,3
7787,7787,,15,2,2,4
7788,7788,,66,1,6,7
7789,7789,,52,7,20,27
7790,7790,,15,4,6,10
7791,7791,,23,6,3,9
7792,7792,,43,5,9,14
7793,7793,,23,9,9,18
7794,7794,,127,11,13,24
7795,7795,,66,2,19,21
7796,7796,,18,32,38,70
7797,7797,,14,6,5,11
7798,7798,,43,2,6,8
7799,7799,,43,2,2,4
7800,7800,,43,18,7,25
7801,7801,,43,0,3,3
7802,7802,,23,1,1,2
7803,7803,,14,10,31,41
7804,7804,,14,0,3,3
7805,7805,,14,8,3,11
7806,7806,,14,2,4,6
7807,7807,,76,3,3,6
7808,7808,,24,1,3,4
7809,7809,,45,2,1,3
7810,7810,,0,0,1,1
7811,7811,,21,25,42,67
7812,7812,,21,2,6,8
7813,7813,,21,1,0,1
7814,7814,,31,3,6,9
7815,7815,,8,0,2,2
7816,7816,,8,2,0,2
7817,7817,,31,1,4,5
7818,7818,,31,3,4,7
7819,7819,,8,1,1,2
7820,7820,,8,3,5,8
7821,7821,,31,4,2,6
7822,7822,,45,3,6,9
7823,7823,,8,4,6,10
7824,7824,,8,4,1,5
7825,7825,,52,0,1,1
7826,7826,,52,1,1,2
7827,7827,,120,9,14,23
7828,7828,,14,6,11,17
7829,7829,,23,2,1,3
7830,7830,,21,11,3,14
7831,7831,,0,3,5,8
7832,7832,,21,4,3,7
7833,7833,,23,0,2,2
7834,7834,,127,6,2,8
7835,7835,,23,14,7,21
7836,7836,,8,0,1,1
7837,7837,,31,2,0,2
7838,7838,,31,3,2,5
7839,7839,,31,9,20,29
7840,7840,,31,5,5,10
7841,7841,,8,2,1,3
7842,7842,,31,0,5,5
7843,7843,,8,0,1,1
7844,7844,,127,1,0,1
7845,7845,,8,1,1,2
7846,7846,,8,5,1,6
7847,7847,,31,2,2,4
7848,7848,,24,1,4,5
7849,7849,,23,1,7,8
7850,7850,,8,1,1,2
7851,7851,,8,2,2,4
7852,7852,,21,0,2,2
7853,7853,,31,4,2,6
7854,7854,,111,0,1,1
7855,7855,,14,2,1,3
7856,7856,,14,1,0,1
7857,7857,,23,61,92,153
7858,7858,,23,9,12,21
7859,7859,,127,0,5,5
7860,7860,,43,1,1,2
7861,7861,,6,1,0,1
7862,7862,,8,1,1,2
7863,7863,,8,1,0,1
7864,7864,,8,0,4,4
7865,7865,,14,3,0,3
7866,7866,,120,2,2,4
7867,7867,,14,11,44,55
7868,7868,,111,7,13,20
7869,7869,,111,9,23,32
7870,7870,,8,8,12,20
7871,7871,,105,2,5,7
7872,7872,,11,0,2,2
7873,7873,,8,1,1,2
7874,7874,,111,0,5,5
7875,7875,,111,3,8,11
7876,7876,,8,1,5,6
7877,7877,,23,1,0,1
7878,7878,,14,0,6,6
7879,7879,,0,3,3,6
7880,7880,,8,4,3,7
7881,7881,,8,3,3,6
7882,7882,,120,5,3,8
7883,7883,,23,11,20,31
7884,7884,,23,1,1,2
7885,7885,,31,1,0,1
7886,7886,,127,2,4,6
7887,7887,,15,5,4,9
7888,7888,,24,0,2,2
7889,7889,,24,17,10,27
7890,7890,,23,1,3,4
7891,7891,,8,2,1,3
7892,7892,,24,3,2,5
7893,7893,,24,1,1,2
7894,7894,,8,0,1,1
7895,7895,,76,3,6,9
7896,7896,,76,1,2,3
7897,7897,,66,0,1,1
7898,7898,,23,2,7,9
7899,7899,,23,3,0,3
7900,7900,,23,14,27,41
7901,7901,,111,0,2,2
7902,7902,,111,2,0,2
7903,7903,,15,2,1,3
7904,7904,,23,1,2,3
7905,7905,,21,35,11,46
7906,7906,,43,0,1,1
7907,7907,,23,13,8,21
7908,7908,,23,3,3,6
7909,7909,,23,1,4,5
7910,7910,,45,6,19,25
7911,7911,,8,3,8,11
7912,7912,,11,1,16,17
7913,7913,,11,1,0,1
7914,7914,,3,1,2,3
7915,7915,,8,5,10,15
7916,7916,,21,2,5,7
7917,7917,,23,29,29,58
7918,7918,,8,2,3,5
7919,7919,,14,0,2,2
7920,7920,,14,2,12,14
7921,7921,,14,6,3,9
7922,7922,,23,14,10,24
7923,7923,,15,3,5,8
7924,7924,,88,0,1,1
7925,7925,,111,1,1,2
7926,7926,,23,4,2,6
7927,7927,,11,5,47,52
7928,7928,,15,1,2,3
7929,7929,,8,1,6,7
7930,7930,,45,3,5,8
7931,7931,,23,9,20,29
7932,7932,,23,0,1,1
7933,7933,,127,1,1,2
7934,7934,,111,8,13,21
7935,7935,,111,3,1,4
7936,7936,,8,0,1,1
7937,7937,,8,0,1,1
7938,7938,,8,1,1,2
7939,7939,,14,11,12,23
7940,7940,,23,1,0,1
7941,7941,,43,2,3,5
7942,7942,,15,2,0,2
7943,7943,,111,1,2,3
7944,7944,,76,7,11,18
7945,7945,,8,6,4,10
7946,7946,,8,1,0,1
7947,7947,,15,19,37,56
7948,7948,,23,6,2,8
7949,7949,,0,6,17,23
7950,7950,,8,1,0,1
7951,7951,,23,11,16,27
7952,7952,,52,13,25,38
7953,7953,,8,0,14,14
7954,7954,,23,8,16,24
7955,7955,,8,1,2,3
7956,7956,,8,2,2,4
7957,7957,,23,3,4,7
7958,7958,,3,0,4,4
7959,7959,,8,1,0,1
7960,7960,,21,4,4,8
7961,7961,,3,3,6,9
7962,7962,,23,7,8,15
7963,7963,,21,1,1,2
7964,7964,,8,6,1,7
7965,7965,,23,3,7,10
7966,7966,,23,3,0,3
7967,7967,,23,2,7,9
7968,7968,,23,2,2,4
7969,7969,,127,3,4,7
7970,7970,,23,0,1,1
7971,7971,,21,12,0,12
7972,7972,,15,9,7,16
7973,7973,,23,2,2,4
7974,7974,,8,7,8,15
7975,7975,,3,0,1,1
7976,7976,,105,4,5,9
7977,7977,,14,4,2,6
7978,7978,,127,0,1,1
7979,7979,,52,8,3,11
7980,7980,,5,2,1,3
7981,7981,,5,3,2,5
7982,7982,,88,0,1,1
7983,7983,,88,1,2,3
7984,7984,,5,0,1,1
7985,7985,,8,4,1,5
7986,7986,,45,1,1,2
7987,7987,,23,45,36,81
7988,7988,,52,6,18,24
7989,7989,,66,3,19,22
7990,7990,,43,3,6,9
7991,7991,,23,21,23,44
7992,7992,,52,32,8,40
7993,7993,,3,7,2,9
7994,7994,,0,15,24,39
7995,7995,,43,2,2,4
7996,7996,,88,15,14,29
7997,7997,,23,6,4,10
7998,7998,,88,1,0,1
7999,7999,,23,1,3,4
8000,8000,,3,1,1,2
8001,8001,,3,1,7,8
8002,8002,,76,5,10,15
8003,8003,,76,0,1,1
8004,8004,,18,2,4,6
8005,8005,,14,3,4,7
8006,8006,,8,1,3,4
8007,8007,,23,9,1,10
8008,8008,,23,1,0,1
8009,8009,,0,1,7,8
8010,8010,,0,5,0,5
8011,8011,,0,1,1,2
8012,8012,,111,0,1,1
8013,8013,,66,2,6,8
8014,8014,,3,6,10,16
8015,8015,,66,2,0,2
8016,8016,,21,4,3,7
8017,8017,,66,3,18,21
8018,8018,,21,5,0,5
8019,8019,,45,0,2,2
8020,8020,,45,2,3,5
8021,8021,,23,3,1,4
8022,8022,,8,2,5,7
8023,8023,,11,4,2,6
8024,8024,,24,5,15,20
8025,8025,,24,1,0,1
8026,8026,,45,4,12,16
8027,8027,,45,1,1,2
8028,8028,,45,2,0,2
8029,8029,,24,5,5,10
8030,8030,,76,3,3,6
8031,8031,,8,16,17,33
8032,8032,,23,2,5,7
8033,8033,,43,2,2,4
8034,8034,,76,3,5,8
8035,8035,,52,1,3,4
8036,8036,,21,3,0,3
8037,8037,,76,2,12,14
8038,8038,,127,3,9,12
8039,8039,,14,1,5,6
8040,8040,,14,1,0,1
8041,8041,,14,5,1,6
8042,8042,,11,1,0,1
8043,8043,,23,1,0,1
8044,8044,,5,2,3,5
8045,8045,,31,2,2,4
8046,8046,,31,0,4,4
8047,8047,,31,0,1,1
8048,8048,,8,0,7,7
8049,8049,,23,15,16,31
8050,8050,,31,3,0,3
8051,8051,,15,5,3,8
8052,8052,,8,2,4,6
8053,8053,,8,5,5,10
8054,8054,,31,4,12,16
8055,8055,,3,0,2,2
8056,8056,,8,8,11,19
8057,8057,,14,1,0,1
8058,8058,,23,3,1,4
8059,8059,,18,5,2,7
8060,8060,,18,12,7,19
8061,8061,,23,4,4,8
8062,8062,,8,9,4,13
8063,8063,,23,2,2,4
8064,8064,,23,1,0,1
8065,8065,,52,9,5,14
8066,8066,,14,1,1,2
8067,8067,,43,0,3,3
8068,8068,,0,8,1,9
8069,8069,,8,3,2,5
8070,8070,,8,6,4,10
8071,8071,,31,4,3,7
8072,8072,,14,1,0,1
8073,8073,,23,1,0,1
8074,8074,,8,0,3,3
8075,8075,,111,1,0,1
8076,8076,,15,0,1,1
8077,8077,,120,2,1,3
8078,8078,,127,2,0,2
8079,8079,,127,5,1,6
8080,8080,,105,1,2,3
8081,8081,,88,0,6,6
8082,8082,,31,0,1,1
8083,8083,,15,0,4,4
8084,8084,,15,1,2,3
8085,8085,,21,1,3,4
8086,8086,,21,1,1,2
8087,8087,,21,11,26,37
8088,8088,,105,1,1,2
8089,8089,,105,2,2,4
8090,8090,,111,78,34,112
8091,8091,,76,0,3,3
8092,8092,,24,2,5,7
8093,8093,,111,0,1,1
8094,8094,,111,1,1,2
8095,8095,,8,7,8,15
8096,8096,,111,0,1,1
8097,8097,,15,0,1,1
8098,8098,,43,0,1,1
8099,8099,,23,8,8,16
8100,8100,,15,2,0,2
8101,8101,,11,2,0,2
8102,8102,,15,7,7,14
8103,8103,,8,2,1,3
8104,8104,,0,5,3,8
8105,8105,,8,3,4,7
8106,8106,,23,0,7,7
8107,8107,,23,2,0,2
8108,8108,,15,1,1,2
8109,8109,,8,2,0,2
8110,8110,,8,1,4,5
8111,8111,,23,1,2,3
8112,8112,,3,2,4,6
8113,8113,,23,0,2,2
8114,8114,,11,5,0,5
8115,8115,,15,1,0,1
8116,8116,,8,14,10,24
8117,8117,,23,0,4,4
8118,8118,,23,76,98,174
8119,8119,,18,0,3,3
8120,8120,,111,3,0,3
8121,8121,,23,10,10,20
8122,8122,,8,0,2,2
8123,8123,,14,3,10,13
8124,8124,,88,6,7,13
8125,8125,,88,3,1,4
8126,8126,,0,5,3,8
8127,8127,,31,2,3,5
8128,8128,,3,2,0,2
8129,8129,,23,4,4,8
8130,8130,,3,3,0,3
8131,8131,,52,0,1,1
8132,8132,,31,10,1,11
8133,8133,,8,6,7,13
8134,8134,,14,2,4,6
8135,8135,,23,0,1,1
8136,8136,,0,4,1,5
8137,8137,,15,5,5,10
8138,8138,,15,2,0,2
8139,8139,,23,19,18,37
8140,8140,,11,17,4,21
8141,8141,,15,7,2,9
8142,8142,,8,1,0,1
8143,8143,,88,9,6,15
8144,8144,,15,3,3,6
8145,8145,,5,5,6,11
8146,8146,,52,5,11,16
8147,8147,,52,7,3,10
8148,8148,,105,6,4,10
8149,8149,,88,2,0,2
8150,8150,,8,2,5,7
8151,8151,,23,1,3,4
8152,8152,,15,0,1,1
8153,8153,,15,1,2,3
8154,8154,,18,2,8,10
8155,8155,,23,2,2,4
8156,8156,,127,5,17,22
8157,8157,,21,12,20,32
8158,8158,,8,4,0,4
8159,8159,,52,10,3,13
8160,8160,,111,0,1,1
8161,8161,,23,1,1,2
8162,8162,,8,2,2,4
8163,8163,,3,0,4,4
8164,8164,,23,0,3,3
8165,8165,,24,0,1,1
8166,8166,,105,2,2,4
8167,8167,,105,0,3,3
8168,8168,,8,0,1,1
8169,8169,,45,2,1,3
8170,8170,,45,0,2,2
8171,8171,,45,1,1,2
8172,8172,,45,0,3,3
8173,8173,,45,4,0,4
8174,8174,,23,2,8,10
8175,8175,,23,1,5,6
8176,8176,,8,6,29,35
8177,8177,,21,6,0,6
8178,8178,,8,0,3,3
8179,8179,,8,0,2,2
8180,8180,,8,13,23,36
8181,8181,,24,1,2,3
8182,8182,,11,1,0,1
8183,8183,,0,0,2,2
8184,8184,,21,3,3,6
8185,8185,,21,5,11,16
8186,8186,,23,0,2,2
8187,8187,,6,9,6,15
8188,8188,,8,0,1,1
8189,8189,,43,4,0,4
8190,8190,,43,1,4,5
8191,8191,,43,63,35,98
8192,8192,,43,0,1,1
8193,8193,,43,0,6,6
8194,8194,,8,0,4,4
8195,8195,,88,3,0,3
8196,8196,,21,6,8,14
8197,8197,,23,0,5,5
8198,8198,,52,17,32,49
8199,8199,,66,1,2,3
8200,8200,,43,0,4,4
8201,8201,,43,8,8,16
8202,8202,,43,1,0,1
8203,8203,,43,3,4,7
8204,8204,,24,3,4,7
8205,8205,,8,8,9,17
8206,8206,,8,1,0,1
8207,8207,,0,0,1,1
8208,8208,,127,3,2,5
8209,8209,,3,2,2,4
8210,8210,,88,1,6,7
8211,8211,,23,0,3,3
8212,8212,,14,5,3,8
8213,8213,,14,8,1,9
8214,8214,,15,3,2,5
8215,8215,,0,1,0,1
8216,8216,,127,3,1,4
8217,8217,,5,1,3,4
8218,8218,,21,0,1,1
8219,8219,,8,2,4,6
8220,8220,,32,2,2,4
8221,8221,,32,1,1,2
8222,8222,,127,2,1,3
8223,8223,,8,3,6,9
8224,8224,,24,1,1,2
8225,8225,,127,2,3,5
8226,8226,,11,0,6,6
8227,8227,,8,5,5,10
8228,8228,,8,4,8,12
8229,8229,,24,14,5,19
8230,8230,,24,5,7,12
8231,8231,,8,0,1,1
8232,8232,,23,0,1,1
8233,8233,,23,2,1,3
8234,8234,,6,19,7,26
8235,8235,,105,1,0,1
8236,8236,,105,3,4,7
8237,8237,,120,32,26,58
8238,8238,,76,15,4,19
8239,8239,,23,2,2,4
8240,8240,,24,1,2,3
8241,8241,,23,6,6,12
8242,8242,,8,7,1,8
8243,8243,,21,1,0,1
8244,8244,,23,10,15,25
8245,8245,,3,2,1,3
8246,8246,,3,2,2,4
8247,8247,,111,1,1,2
8248,8248,,43,4,2,6
8249,8249,,15,1,3,4
8250,8250,,127,1,2,3
8251,8251,,127,3,3,6
8252,8252,,111,1,0,1
8253,8253,,111,7,6,13
8254,8254,,105,1,1,2
8255,8255,,0,1,1,2
8256,8256,,6,0,4,4
8257,8257,,6,32,37,69
8258,8258,,6,9,7,16
8259,8259,,11,4,0,4
8260,8260,,8,12,11,23
8261,8261,,8,0,8,8
8262,8262,,8,1,1,2
8263,8263,,8,1,0,1
8264,8264,,8,1,0,1
8265,8265,,8,3,1,4
8266,8266,,8,18,2,20
8267,8267,,8,1,0,1
8268,8268,,8,7,7,14
8269,8269,,8,1,0,1
8270,8270,,43,1,2,3
8271,8271,,14,3,3,6
8272,8272,,52,30,6,36
8273,8273,,3,0,1,1
8274,8274,,23,0,3,3
8275,8275,,8,1,0,1
8276,8276,,8,1,1,2
8277,8277,,23,1,1,2
8278,8278,,23,2,3,5
8279,8279,,23,169,194,363
8280,8280,,43,1,0,1
8281,8281,,8,0,1,1
8282,8282,,88,1,1,2
8283,8283,,23,3,3,6
8284,8284,,0,4,3,7
8285,8285,,15,2,5,7
8286,8286,,14,0,1,1
8287,8287,,127,1,5,6
8288,8288,,105,2,4,6
8289,8289,,23,21,39,60
8290,8290,,23,1,0,1
8291,8291,,31,2,0,2
8292,8292,,76,0,3,3
8293,8293,,76,4,4,8
8294,8294,,76,0,2,2
8295,8295,,76,3,0,3
8296,8296,,105,2,1,3
8297,8297,,127,8,15,23
8298,8298,,127,4,2,6
8299,8299,,23,8,5,13
8300,8300,,127,2,0,2
8301,8301,,24,1,1,2
8302,8302,,127,3,5,8
8303,8303,,5,4,7,11
8304,8304,,14,22,36,58
8305,8305,,105,7,2,9
8306,8306,,8,0,7,7
8307,8307,,8,0,1,1
8308,8308,,111,0,1,1
8309,8309,,111,0,1,1
8310,8310,,127,0,5,5
8311,8311,,43,23,15,38
8312,8312,,8,2,4,6
8313,8313,,23,2,3,5
8314,8314,,11,4,0,4
8315,8315,,15,1,0,1
8316,8316,,15,3,0,3
8317,8317,,8,2,5,7
8318,8318,,11,12,12,24
8319,8319,,127,2,1,3
8320,8320,,31,0,1,1
8321,8321,,31,2,2,4
8322,8322,,6,9,9,18
8323,8323,,3,10,4,14
8324,8324,,23,5,2,7
8325,8325,,21,22,16,38
8326,8326,,21,8,3,11
8327,8327,,0,24,21,45
8328,8328,,127,0,2,2
8329,8329,,52,4,14,18
8330,8330,,52,3,3,6
8331,8331,,8,1,0,1
8332,8332,,111,1,1,2
8333,8333,,0,20,15,35
8334,8334,,23,3,2,5
8335,8335,,23,0,1,1
8336,8336,,8,1,2,3
8337,8337,,8,1,6,7
8338,8338,,8,1,0,1
8339,8339,,11,1,17,18
8340,8340,,43,6,4,10
8341,8341,,21,22,16,38
8342,8342,,45,1,0,1
8343,8343,,45,1,1,2
8344,8344,,33,0,1,1
8345,8345,,33,1,0,1
8346,8346,,45,15,4,19
8347,8347,,127,21,9,30
8348,8348,,45,11,0,11
8349,8349,,21,0,4,4
8350,8350,,34,0,1,1
8351,8351,,34,1,0,1
8352,8352,,23,47,71,118
8353,8353,,23,7,2,9
8354,8354,,21,4,3,7
8355,8355,,14,2,0,2
8356,8356,,14,9,10,19
8357,8357,,14,1,0,1
8358,8358,,14,5,5,10
8359,8359,,21,2,0,2
8360,8360,,23,0,1,1
8361,8361,,8,1,2,3
8362,8362,,31,5,3,8
8363,8363,,23,3,1,4
8364,8364,,5,0,1,1
8365,8365,,45,0,3,3
8366,8366,,23,1,1,2
8367,8367,,23,1,1,2
8368,8368,,3,11,8,19
8369,8369,,35,0,2,2
8370,8370,,35,2,0,2
8371,8371,,14,3,0,3
8372,8372,,23,26,36,62
8373,8373,,23,1,2,3
8374,8374,,88,0,1,1
8375,8375,,88,4,3,7
8376,8376,,23,1,0,1
8377,8377,,52,2,2,4
8378,8378,,14,0,3,3
8379,8379,,21,1,0,1
8380,8380,,120,1,2,3
8381,8381,,3,3,2,5
8382,8382,,23,1,0,1
8383,8383,,66,0,2,2
8384,8384,,43,7,6,13
8385,8385,,14,6,0,6
8386,8386,,23,4,3,7
8387,8387,,105,2,3,5
8388,8388,,14,6,7,13
8389,8389,,45,8,10,18
8390,8390,,45,2,2,4
8391,8391,,0,6,23,29
8392,8392,,5,33,41,74
8393,8393,,23,7,16,23
8394,8394,,23,2,7,9
8395,8395,,21,1,1,2
8396,8396,,21,2,0,2
8397,8397,,0,1,1,2
8398,8398,,127,3,1,4
8399,8399,,23,7,10,17
8400,8400,,127,9,5,14
8401,8401,,21,7,1,8
8402,8402,,11,1,1,2
8403,8403,,36,2,1,3
8404,8404,,5,4,11,15
8405,8405,,45,0,1,1
8406,8406,,11,15,0,15
8407,8407,,11,1,8,9
8408,8408,,5,3,4,7
8409,8409,,14,1,0,1
8410,8410,,111,3,3,6
8411,8411,,76,0,1,1
8412,8412,,76,0,3,3
8413,8413,,76,1,5,6
8414,8414,,76,0,2,2
8415,8415,,45,2,10,12
8416,8416,,45,14,29,43
8417,8417,,6,1,1,2
8418,8418,,11,5,2,7
8419,8419,,105,2,2,4
8420,8420,,45,1,1,2
8421,8421,,23,3,1,4
8422,8422,,23,14,23,37
8423,8423,,23,7,16,23
8424,8424,,3,1,3,4
8425,8425,,23,4,5,9
8426,8426,,15,9,6,15
8427,8427,,23,1,1,2
8428,8428,,31,3,15,18
8429,8429,,14,1,3,4
8430,8430,,45,48,17,65
8431,8431,,43,10,15,25
8432,8432,,3,1,0,1
8433,8433,,0,1,2,3
8434,8434,,127,5,2,7
8435,8435,,127,3,21,24
8436,8436,,127,3,1,4
8437,8437,,111,0,2,2
8438,8438,,21,6,14,20
8439,8439,,15,9,2,11
8440,8440,,23,46,15,61
8441,8441,,14,1,1,2
8442,8442,,45,37,14,51
8443,8443,,6,0,2,2
8444,8444,,31,2,2,4
8445,8445,,14,0,1,1
8446,8446,,15,2,2,4
8447,8447,,23,1,3,4
8448,8448,,37,0,2,2
8449,8449,,37,2,0,2
8450,8450,,8,1,0,1
8451,8451,,8,1,0,1
8452,8452,,31,4,4,8
8453,8453,,8,3,1,4
8454,8454,,23,0,6,6
8455,8455,,8,3,7,10
8456,8456,,24,3,4,7
8457,8457,,24,2,0,2
8458,8458,,8,0,1,1
8459,8459,,31,1,0,1
8460,8460,,23,5,5,10
8461,8461,,8,2,0,2
8462,8462,,23,1,0,1
8463,8463,,14,1,0,1
8464,8464,,8,1,0,1
8465,8465,,45,4,3,7
8466,8466,,15,2,4,6
8467,8467,,23,11,11,22
8468,8468,,23,1,5,6
8469,8469,,18,9,10,19
8470,8470,,8,1,3,4
8471,8471,,14,8,5,13
8472,8472,,111,1,1,2
8473,8473,,23,2,2,4
8474,8474,,76,0,6,6
8475,8475,,31,2,5,7
8476,8476,,127,1,1,2
8477,8477,,18,1,2,3
8478,8478,,43,2,0,2
8479,8479,,111,4,6,10
8480,8480,,127,2,1,3
8481,8481,,8,0,1,1
8482,8482,,8,4,10,14
8483,8483,,8,1,0,1
8484,8484,,111,2,0,2
8485,8485,,21,5,10,15
8486,8486,,23,4,2,6
8487,8487,,127,2,8,10
8488,8488,,0,14,21,35
8489,8489,,23,2,0,2
8490,8490,,23,1,1,2
8491,8491,,23,0,1,1
8492,8492,,23,1,1,2
8493,8493,,11,1,0,1
8494,8494,,43,2,5,7
8495,8495,,45,1,1,2
8496,8496,,14,3,2,5
8497,8497,,23,2,0,2
8498,8498,,23,1,2,3
8499,8499,,23,1,0,1
8500,8500,,14,6,2,8
8501,8501,,15,8,13,21
8502,8502,,15,1,6,7
8503,8503,,43,1,3,4
8504,8504,,43,2,0,2
8505,8505,,111,5,18,23
8506,8506,,45,0,1,1
8507,8507,,23,37,22,59
8508,8508,,15,10,9,19
8509,8509,,23,1,0,1
8510,8510,,127,3,1,4
8511,8511,,23,1,0,1
8512,8512,,0,4,5,9
8513,8513,,21,0,3,3
8514,8514,,21,2,2,4
8515,8515,,8,1,1,2
8516,8516,,21,2,4,6
8517,8517,,23,0,1,1
8518,8518,,8,3,8,11
8519,8519,,21,1,1,2
8520,8520,,15,11,9,20
8521,8521,,11,5,12,17
8522,8522,,52,0,2,2
8523,8523,,76,0,2,2
8524,8524,,76,10,1,11
8525,8525,,52,34,73,107
8526,8526,,8,1,4,5
8527,8527,,11,0,1,1
8528,8528,,23,2,1,3
8529,8529,,21,4,6,10
8530,8530,,15,5,10,15
8531,8531,,23,1,1,2
8532,8532,,8,2,1,3
8533,8533,,21,6,9,15
8534,8534,,24,0,1,1
8535,8535,,24,3,2,5
8536,8536,,14,6,1,7
8537,8537,,5,0,3,3
8538,8538,,15,2,2,4
8539,8539,,15,1,1,2
8540,8540,,15,2,5,7
8541,8541,,15,9,9,18
8542,8542,,23,2,7,9
8543,8543,,43,0,1,1
8544,8544,,43,2,1,3
8545,8545,,66,10,7,17
8546,8546,,23,4,1,5
8547,8547,,23,2,0,2
8548,8548,,66,2,1,3
8549,8549,,66,6,2,8
8550,8550,,88,2,3,5
8551,8551,,14,0,2,2
8552,8552,,43,2,5,7
8553,8553,,5,1,7,8
8554,8554,,14,1,2,3
8555,8555,,3,0,1,1
8556,8556,,52,7,9,16
8557,8557,,52,0,2,2
8558,8558,,0,1,3,4
8559,8559,,23,4,3,7
8560,8560,,66,2,1,3
8561,8561,,43,7,4,11
8562,8562,,23,3,7,10
8563,8563,,45,1,6,7
8564,8564,,45,10,6,16
8565,8565,,45,6,4,10
8566,8566,,127,5,2,7
8567,8567,,3,2,2,4
8568,8568,,3,2,5,7
8569,8569,,23,3,3,6
8570,8570,,0,1,2,3
8571,8571,,0,1,0,1
8572,8572,,21,0,2,2
8573,8573,,21,4,5,9
8574,8574,,21,5,9,14
8575,8575,,21,3,2,5
8576,8576,,21,8,8,16
8577,8577,,21,0,3,3
8578,8578,,3,3,3,6
8579,8579,,3,14,24,38
8580,8580,,21,6,15,21
8581,8581,,21,1,0,1
8582,8582,,21,67,113,180
8583,8583,,21,114,181,295
8584,8584,,66,0,6,6
8585,8585,,8,5,0,5
8586,8586,,21,5,6,11
8587,8587,,5,7,18,25
8588,8588,,5,6,5,11
8589,8589,,5,12,21,33
8590,8590,,8,1,2,3
8591,8591,,38,0,1,1
8592,8592,,38,1,0,1
8593,8593,,15,4,0,4
8594,8594,,8,0,1,1
8595,8595,,23,6,8,14
8596,8596,,76,13,15,28
8597,8597,,52,1,3,4
8598,8598,,23,1,0,1
8599,8599,,0,0,7,7
8600,8600,,14,3,24,27
8601,8601,,14,3,4,7
8602,8602,,21,2,2,4
8603,8603,,8,2,2,4
8604,8604,,15,2,2,4
8605,8605,,45,1,5,6
8606,8606,,45,4,6,10
8607,8607,,8,1,0,1
8608,8608,,6,2,1,3
8609,8609,,0,2,0,2
8610,8610,,45,1,3,4
8611,8611,,24,2,6,8
8612,8612,,23,4,2,6
8613,8613,,0,13,1,14
8614,8614,,11,0,3,3
8615,8615,,11,2,0,2
8616,8616,,15,2,4,6
8617,8617,,21,3,4,7
8618,8618,,111,6,25,31
8619,8619,,23,3,0,3
8620,8620,,14,1,0,1
8621,8621,,15,0,1,1
8622,8622,,23,6,2,8
8623,8623,,127,23,13,36
8624,8624,,21,5,12,17
8625,8625,,24,1,2,3
8626,8626,,23,6,5,11
8627,8627,,8,1,0,1
8628,8628,,11,0,1,1
8629,8629,,5,17,3,20
8630,8630,,23,0,2,2
8631,8631,,43,1,6,7
8632,8632,,3,4,4,8
8633,8633,,0,1,3,4
8634,8634,,3,2,1,3
8635,8635,,52,11,12,23
8636,8636,,5,2,9,11
8637,8637,,21,4,1,5
8638,8638,,43,4,3,7
8639,8639,,43,0,1,1
8640,8640,,3,21,20,41
8641,8641,,76,0,1,1
8642,8642,,43,0,2,2
8643,8643,,43,2,10,12
8644,8644,,43,1,5,6
8645,8645,,43,0,1,1
8646,8646,,43,0,1,1
8647,8647,,5,77,86,163
8648,8648,,23,11,8,19
8649,8649,,23,0,4,4
8650,8650,,23,12,16,28
8651,8651,,23,3,10,13
8652,8652,,43,10,14,24
8653,8653,,8,0,1,1
8654,8654,,11,0,1,1
8655,8655,,11,1,1,2
8656,8656,,127,7,22,29
8657,8657,,11,6,3,9
8658,8658,,88,0,2,2
8659,8659,,8,5,7,12
8660,8660,,127,4,3,7
8661,8661,,88,2,0,2
8662,8662,,23,4,0,4
8663,8663,,23,4,1,5
8664,8664,,23,0,10,10
8665,8665,,23,1,14,15
8666,8666,,52,2,0,2
8667,8667,,23,1,1,2
8668,8668,,45,3,5,8
8669,8669,,23,8,4,12
8670,8670,,23,7,3,10
8671,8671,,23,1,1,2
8672,8672,,8,2,10,12
8673,8673,,3,0,7,7
8674,8674,,6,1,2,3
8675,8675,,6,5,15,20
8676,8676,,23,1,0,1
8677,8677,,105,1,3,4
8678,8678,,0,2,5,7
8679,8679,,18,0,5,5
8680,8680,,18,1,1,2
8681,8681,,23,2,1,3
8682,8682,,15,5,22,27
8683,8683,,45,6,3,9
8684,8684,,45,7,7,14
8685,8685,,127,2,0,2
8686,8686,,127,2,0,2
8687,8687,,23,1,1,2
8688,8688,,3,1,3,4
8689,8689,,127,2,1,3
8690,8690,,52,2,0,2
8691,8691,,15,2,3,5
8692,8692,,31,6,7,13
8693,8693,,8,7,1,8
8694,8694,,88,4,6,10
8695,8695,,23,0,4,4
8696,8696,,23,2,5,7
8697,8697,,23,1,0,1
8698,8698,,0,0,2,2
8699,8699,,23,31,28,59
8700,8700,,43,2,0,2
8701,8701,,43,0,1,1
8702,8702,,43,2,2,4
8703,8703,,14,7,5,12
8704,8704,,14,2,1,3
8705,8705,,14,1,0,1
8706,8706,,23,6,1,7
8707,8707,,43,4,4,8
8708,8708,,76,5,4,9
8709,8709,,14,6,11,17
8710,8710,,8,11,0,11
8711,8711,,43,1,0,1
8712,8712,,45,0,4,4
8713,8713,,45,2,8,10
8714,8714,,43,1,4,5
8715,8715,,45,8,4,12
8716,8716,,21,1,3,4
8717,8717,,14,0,3,3
8718,8718,,14,3,2,5
8719,8719,,14,0,1,1
8720,8720,,3,1,3,4
8721,8721,,3,3,2,5
8722,8722,,3,1,1,2
8723,8723,,45,6,7,13
8724,8724,,43,11,5,16
8725,8725,,43,4,14,18
8726,8726,,43,0,4,4
8727,8727,,14,9,2,11
8728,8728,,43,3,5,8
8729,8729,,21,2,1,3
8730,8730,,21,2,1,3
8731,8731,,21,0,1,1
8732,8732,,21,7,11,18
8733,8733,,21,2,4,6
8734,8734,,21,2,0,2
8735,8735,,0,15,11,26
8736,8736,,45,2,9,11
8737,8737,,8,3,0,3
8738,8738,,0,1,0,1
8739,8739,,11,2,1,3
8740,8740,,111,4,12,16
8741,8741,,111,3,1,4
8742,8742,,111,0,1,1
8743,8743,,21,1,1,2
8744,8744,,76,2,1,3
8745,8745,,120,6,4,10
8746,8746,,120,2,0,2
8747,8747,,23,2,2,4
8748,8748,,14,3,7,10
8749,8749,,21,1,0,1
8750,8750,,52,1,2,3
8751,8751,,120,24,16,40
8752,8752,,14,2,4,6
8753,8753,,23,0,14,14
8754,8754,,8,1,2,3
8755,8755,,52,1,9,10
8756,8756,,31,12,15,27
8757,8757,,24,8,1,9
8758,8758,,14,9,22,31
8759,8759,,23,2,2,4
8760,8760,,5,2,1,3
8761,8761,,120,13,7,20
8762,8762,,14,1,0,1
8763,8763,,6,1,2,3
8764,8764,,23,0,1,1
8765,8765,,76,11,11,22
8766,8766,,14,7,8,15
8767,8767,,31,2,0,2
8768,8768,,21,1,1,2
8769,8769,,23,2,2,4
8770,8770,,31,2,5,7
8771,8771,,8,0,9,9
8772,8772,,8,13,16,29
8773,8773,,45,0,1,1
8774,8774,,111,1,2,3
8775,8775,,43,6,10,16
8776,8776,,23,1,2,3
8777,8777,,23,0,5,5
8778,8778,,3,8,3,11
8779,8779,,8,0,2,2
8780,8780,,23,1,1,2
8781,8781,,11,1,2,3
8782,8782,,8,12,15,27
8783,8783,,8,2,3,5
8784,8784,,8,0,3,3
8785,8785,,8,5,2,7
8786,8786,,14,20,46,66
8787,8787,,45,3,0,3
8788,8788,,8,5,3,8
8789,8789,,111,2,2,4
8790,8790,,8,2,2,4
8791,8791,,105,11,14,25
8792,8792,,23,6,11,17
8793,8793,,21,8,9,17
8794,8794,,23,1,1,2
8795,8795,,15,3,8,11
8796,8796,,31,0,2,2
8797,8797,,0,3,4,7
8798,8798,,15,13,18,31
8799,8799,,15,0,2,2
8800,8800,,23,1,1,2
8801,8801,,23,5,11,16
8802,8802,,88,1,3,4
8803,8803,,15,5,7,12
8804,8804,,8,14,9,23
8805,8805,,15,1,2,3
8806,8806,,76,7,8,15
8807,8807,,15,9,1,10
8808,8808,,23,0,1,1
8809,8809,,31,1,2,3
8810,8810,,23,1,1,2
8811,8811,,127,0,1,1
8812,8812,,18,2,0,2
8813,8813,,18,4,3,7
8814,8814,,45,3,3,6
8815,8815,,45,2,2,4
8816,8816,,3,5,3,8
8817,8817,,11,2,2,4
8818,8818,,11,23,4,27
8819,8819,,23,1,1,2
8820,8820,,23,1,5,6
8821,8821,,23,0,1,1
8822,8822,,43,7,7,14
8823,8823,,43,1,0,1
8824,8824,,23,1,2,3
8825,8825,,43,1,1,2
8826,8826,,31,7,6,13
8827,8827,,52,1,1,2
8828,8828,,14,8,24,32
8829,8829,,0,6,0,6
8830,8830,,0,7,4,11
8831,8831,,127,2,1,3
8832,8832,,43,1,3,4
8833,8833,,23,14,8,22
8834,8834,,105,0,1,1
8835,8835,,105,0,3,3
8836,8836,,43,0,1,1
8837,8837,,23,0,1,1
8838,8838,,31,6,0,6
8839,8839,,45,0,5,5
8840,8840,,8,0,2,2
8841,8841,,8,1,0,1
8842,8842,,8,9,12,21
8843,8843,,8,11,19,30
8844,8844,,6,17,4,21
8845,8845,,43,1,3,4
8846,8846,,43,13,6,19
8847,8847,,21,2,1,3
8848,8848,,8,0,2,2
8849,8849,,23,0,2,2
8850,8850,,18,4,1,5
8851,8851,,14,2,6,8
8852,8852,,45,0,1,1
8853,8853,,45,1,0,1
8854,8854,,23,6,8,14
8855,8855,,6,4,6,10
8856,8856,,8,1,0,1
8857,8857,,45,4,12,16
8858,8858,,31,5,16,21
8859,8859,,11,10,6,16
8860,8860,,88,2,2,4
8861,8861,,15,4,4,8
8862,8862,,15,1,2,3
8863,8863,,23,1,0,1
8864,8864,,0,1,0,1
8865,8865,,43,0,3,3
8866,8866,,43,1,0,1
8867,8867,,127,0,1,1
8868,8868,,8,7,7,14
8869,8869,,52,2,7,9
8870,8870,,127,3,8,11
8871,8871,,23,4,4,8
8872,8872,,23,0,2,2
8873,8873,,23,0,1,1
8874,8874,,23,1,2,3
8875,8875,,15,16,27,43
8876,8876,,45,1,0,1
8877,8877,,15,0,3,3
8878,8878,,15,1,0,1
8879,8879,,105,1,0,1
8880,8880,,45,0,1,1
8881,8881,,45,4,1,5
8882,8882,,45,0,1,1
8883,8883,,23,1,5,6
8884,8884,,23,18,13,31
8885,8885,,45,17,6,23
8886,8886,,21,7,3,10
8887,8887,,15,3,4,7
8888,8888,,23,19,11,30
8889,8889,,52,0,2,2
8890,8890,,66,0,2,2
8891,8891,,66,2,0,2
8892,8892,,14,8,2,10
8893,8893,,14,10,8,18
8894,8894,,45,0,1,1
8895,8895,,3,2,0,2
8896,8896,,66,1,0,1
8897,8897,,0,0,2,2
8898,8898,,45,12,12,24
8899,8899,,23,7,0,7
8900,8900,,23,7,11,18
8901,8901,,11,1,0,1
8902,8902,,43,8,4,12
8903,8903,,43,1,2,3
8904,8904,,5,4,0,4
8905,8905,,43,17,4,21
8906,8906,,23,2,2,4
8907,8907,,23,2,3,5
8908,8908,,3,5,7,12
8909,8909,,88,1,1,2
8910,8910,,88,1,2,3
8911,8911,,88,3,2,5
8912,8912,,14,0,2,2
8913,8913,,66,6,2,8
8914,8914,,66,1,0,1
8915,8915,,14,5,6,11
8916,8916,,14,0,3,3
8917,8917,,23,1,0,1
8918,8918,,39,0,1,1
8919,8919,,39,1,0,1
8920,8920,,43,15,4,19
8921,8921,,15,2,1,3
8922,8922,,21,3,5,8
8923,8923,,21,2,2,4
8924,8924,,43,0,1,1
8925,8925,,8,4,3,7
8926,8926,,111,0,2,2
8927,8927,,3,2,1,3
8928,8928,,3,2,2,4
8929,8929,,105,7,9,16
8930,8930,,76,1,2,3
8931,8931,,8,13,8,21
8932,8932,,3,5,12,17
8933,8933,,0,3,10,13
8934,8934,,8,13,1,14
8935,8935,,66,5,3,8
8936,8936,,66,0,1,1
8937,8937,,3,1,0,1
8938,8938,,3,2,2,4
8939,8939,,127,3,4,7
8940,8940,,127,2,3,5
8941,8941,,45,1,4,5
8942,8942,,0,1,2,3
8943,8943,,43,0,1,1
8944,8944,,43,2,1,3
8945,8945,,45,1,0,1
8946,8946,,8,1,2,3
8947,8947,,8,6,3,9
8948,8948,,45,0,4,4
8949,8949,,45,1,0,1
8950,8950,,8,1,0,1
8951,8951,,14,1,0,1
8952,8952,,111,3,5,8
8953,8953,,52,10,25,35
8954,8954,,105,10,1,11
8955,8955,,43,2,3,5
8956,8956,,0,0,1,1
8957,8957,,31,3,4,7
8958,8958,,21,0,2,2
8959,8959,,23,1,1,2
8960,8960,,23,0,3,3
8961,8961,,23,4,4,8
8962,8962,,8,0,1,1
8963,8963,,21,6,7,13
8964,8964,,21,1,1,2
8965,8965,,14,5,2,7
8966,8966,,18,0,1,1
8967,8967,,23,3,1,4
8968,8968,,8,1,2,3
8969,8969,,18,1,0,1
8970,8970,,23,3,1,4
8971,8971,,23,17,25,42
8972,8972,,18,1,3,4
8973,8973,,18,2,2,4
8974,8974,,8,0,1,1
8975,8975,,8,0,5,5
8976,8976,,127,2,3,5
8977,8977,,45,1,0,1
8978,8978,,127,0,1,1
8979,8979,,14,1,2,3
8980,8980,,111,4,6,10
8981,8981,,127,2,2,4
8982,8982,,105,0,1,1
8983,8983,,23,5,1,6
8984,8984,,111,7,4,11
8985,8985,,24,2,1,3
8986,8986,,8,1,1,2
8987,8987,,15,3,2,5
8988,8988,,52,2,1,3
8989,8989,,105,1,0,1
8990,8990,,15,0,3,3
8991,8991,,8,1,0,1
8992,8992,,8,0,1,1
8993,8993,,111,2,3,5
8994,8994,,6,254,391,645
8995,8995,,111,1,7,8
8996,8996,,3,1,1,2
8997,8997,,8,2,5,7
8998,8998,,23,3,0,3
8999,8999,,31,3,8,11
9000,9000,,23,0,3,3
9001,9001,,0,0,1,1
9002,9002,,8,0,2,2
9003,9003,,18,1,1,2
9004,9004,,105,1,0,1
9005,9005,,76,8,2,10
9006,9006,,8,0,3,3
9007,9007,,31,2,2,4
9008,9008,,23,2,7,9
9009,9009,,23,3,3,6
9010,9010,,0,11,9,20
9011,9011,,11,11,20,31
9012,9012,,43,3,0,3
9013,9013,,31,19,20,39
9014,9014,,23,19,11,30
9015,9015,,45,1,1,2
9016,9016,,15,2,1,3
9017,9017,,23,0,1,1
9018,9018,,23,0,1,1
9019,9019,,43,0,1,1
9020,9020,,6,14,17,31
9021,9021,,6,1,5,6
9022,9022,,14,6,6,12
9023,9023,,15,19,14,33
9024,9024,,11,1,0,1
9025,9025,,127,2,0,2
9026,9026,,6,1,1,2
9027,9027,,23,7,5,12
9028,9028,,23,1,1,2
9029,9029,,105,0,1,1
9030,9030,,76,5,10,15
9031,9031,,111,6,5,11
9032,9032,,14,1,3,4
9033,9033,,23,17,25,42
9034,9034,,127,3,2,5
9035,9035,,31,7,12,19
9036,9036,,52,2,4,6
9037,9037,,0,3,2,5
9038,9038,,23,1,1,2
9039,9039,,11,4,3,7
9040,9040,,23,9,10,19
9041,9041,,23,5,3,8
9042,9042,,8,0,5,5
9043,9043,,8,0,4,4
9044,9044,,8,2,5,7
9045,9045,,8,4,2,6
9046,9046,,14,32,35,67
9047,9047,,14,14,12,26
9048,9048,,14,4,3,7
9049,9049,,8,0,6,6
9050,9050,,111,3,3,6
9051,9051,,21,1,1,2
9052,9052,,21,4,5,9
9053,9053,,8,0,1,1
9054,9054,,8,0,3,3
9055,9055,,8,0,3,3
9056,9056,,11,2,4,6
9057,9057,,23,5,7,12
9058,9058,,3,1,4,5
9059,9059,,15,1,2,3
9060,9060,,23,179,112,291
9061,9061,,11,5,5,10
9062,9062,,23,6,3,9
9063,9063,,0,0,2,2
9064,9064,,15,2,1,3
9065,9065,,127,4,5,9
9066,9066,,43,6,21,27
9067,9067,,43,4,8,12
9068,9068,,43,1,2,3
9069,9069,,8,1,3,4
9070,9070,,23,2,3,5
9071,9071,,3,1,5,6
9072,9072,,23,0,1,1
9073,9073,,8,5,9,14
9074,9074,,23,0,1,1
9075,9075,,111,3,12,15
9076,9076,,43,0,4,4
9077,9077,,11,1,2,3
9078,9078,,8,1,1,2
9079,9079,,23,2,1,3
9080,9080,,88,6,5,11
9081,9081,,15,1,1,2
9082,9082,,0,2,2,4
9083,9083,,127,2,3,5
9084,9084,,11,3,0,3
9085,9085,,43,0,3,3
9086,9086,,43,0,31,31
9087,9087,,105,7,12,19
9088,9088,,8,0,3,3
9089,9089,,66,4,0,4
9090,9090,,23,4,5,9
9091,9091,,88,4,11,15
9092,9092,,45,1,4,5
9093,9093,,120,11,3,14
9094,9094,,43,2,6,8
9095,9095,,45,2,0,2
9096,9096,,14,1,0,1
9097,9097,,14,0,2,2
9098,9098,,8,18,25,43
9099,9099,,8,1,2,3
9100,9100,,0,1,1,2
9101,9101,,21,1,1,2
9102,9102,,21,6,3,9
9103,9103,,5,1,3,4
9104,9104,,21,5,9,14
9105,9105,,21,2,3,5
9106,9106,,21,0,2,2
9107,9107,,21,1,1,2
9108,9108,,8,0,2,2
9109,9109,,8,0,1,1
9110,9110,,8,4,1,5
9111,9111,,8,3,4,7
9112,9112,,11,9,6,15
9113,9113,,31,9,8,17
9114,9114,,15,1,8,9
9115,9115,,43,1,9,10
9116,9116,,127,0,1,1
9117,9117,,111,3,1,4
9118,9118,,21,1,0,1
9119,9119,,111,1,2,3
9120,9120,,111,4,3,7
9121,9121,,23,1,0,1
9122,9122,,120,5,4,9
9123,9123,,14,3,4,7
9124,9124,,23,8,8,16
9125,9125,,23,43,60,103
9126,9126,,23,4,0,4
9127,9127,,23,1,1,2
9128,9128,,127,1,1,2
9129,9129,,11,1,2,3
9130,9130,,111,1,1,2
9131,9131,,0,6,7,13
9132,9132,,8,3,1,4
9133,9133,,23,2,1,3
9134,9134,,8,0,2,2
9135,9135,,11,2,3,5
9136,9136,,111,1,1,2
9137,9137,,105,1,2,3
9138,9138,,23,0,3,3
9139,9139,,23,1,2,3
9140,9140,,8,1,3,4
9141,9141,,40,0,1,1
9142,9142,,40,1,0,1
9143,9143,,23,3,4,7
9144,9144,,45,1,4,5
9145,9145,,45,5,1,6
9146,9146,,45,0,1,1
9147,9147,,8,7,1,8
9148,9148,,43,1,1,2
9149,9149,,23,4,2,6
9150,9150,,15,1,1,2
9151,9151,,0,3,4,7
9152,9152,,23,3,4,7
9153,9153,,23,1,1,2
9154,9154,,23,0,4,4
9155,9155,,31,6,3,9
9156,9156,,8,2,5,7
9157,9157,,11,1,0,1
9158,9158,,21,5,18,23
9159,9159,,23,1,0,1
9160,9160,,8,1,1,2
9161,9161,,8,0,1,1
9162,9162,,14,3,7,10
9163,9163,,120,0,1,1
9164,9164,,120,5,26,31
9165,9165,,8,3,3,6
9166,9166,,23,1,2,3
9167,9167,,8,1,0,1
9168,9168,,23,9,17,26
9169,9169,,62,6,0,6
9170,9170,,120,13,6,19
9171,9171,,23,1,16,17
9172,9172,,23,1,0,1
9173,9173,,14,0,2,2
9174,9174,,0,1,1,2
9175,9175,,23,2,3,5
9176,9176,,23,8,9,17
9177,9177,,23,2,2,4
9178,9178,,41,2,1,3
9179,9179,,41,1,0,1
9180,9180,,105,4,6,10
9181,9181,,111,0,1,1
9182,9182,,111,1,1,2
9183,9183,,111,0,1,1
9184,9184,,8,0,1,1
9185,9185,,23,19,29,48
9186,9186,,23,1,1,2
9187,9187,,8,1,8,9
9188,9188,,3,0,1,1
9189,9189,,23,3,8,11
9190,9190,,23,2,1,3
9191,9191,,18,5,7,12
9192,9192,,8,3,3,6
9193,9193,,8,2,2,4
9194,9194,,6,18,11,29
9195,9195,,6,1,1,2
9196,9196,,6,1,1,2
9197,9197,,15,4,0,4
9198,9198,,11,4,4,8
9199,9199,,5,0,2,2
9200,9200,,111,2,1,3
9201,9201,,23,0,1,1
9202,9202,,21,1,1,2
9203,9203,,23,2,4,6
9204,9204,,15,0,1,1
9205,9205,,18,1,1,2
9206,9206,,15,9,10,19
9207,9207,,52,2,0,2
9208,9208,,23,1,0,1
9209,9209,,45,1,3,4
9210,9210,,8,2,3,5
9211,9211,,8,1,4,5
9212,9212,,8,1,0,1
9213,9213,,23,2,1,3
9214,9214,,23,8,12,20
9215,9215,,23,11,17,28
9216,9216,,23,4,2,6
9217,9217,,8,1,0,1
9218,9218,,23,3,7,10
9219,9219,,23,9,13,22
9220,9220,,8,4,0,4
9221,9221,,42,0,1,1
9222,9222,,42,1,0,1
9223,9223,,23,0,4,4
9224,9224,,8,1,3,4
9225,9225,,0,1,2,3
9226,9226,,11,4,3,7
9227,9227,,52,7,17,24
9228,9228,,52,0,2,2
9229,9229,,0,4,10,14
9230,9230,,8,2,14,16
9231,9231,,15,52,55,107
9232,9232,,52,0,1,1
9233,9233,,0,4,6,10
9234,9234,,0,1,0,1
9235,9235,,23,3,0,3
9236,9236,,8,2,0,2
9237,9237,,23,0,2,2
9238,9238,,11,0,1,1
9239,9239,,15,1,3,4
9240,9240,,0,3,0,3
9241,9241,,8,0,2,2
9242,9242,,8,11,12,23
9243,9243,,14,2,2,4
9244,9244,,8,1,3,4
9245,9245,,8,0,2,2
9246,9246,,8,2,0,2
9247,9247,,8,2,8,10
9248,9248,,0,1,1,2
9249,9249,,23,31,20,51
9250,9250,,43,4,3,7
9251,9251,,43,1,5,6
9252,9252,,3,0,2,2
9253,9253,,23,1,1,2
9254,9254,,23,8,10,18
9255,9255,,23,1,0,1
9256,9256,,14,1,8,9
9257,9257,,23,2,3,5
9258,9258,,0,1,8,9
9259,9259,,23,10,11,21
9260,9260,,43,0,1,1
9261,9261,,14,7,4,11
9262,9262,,14,6,1,7
9263,9263,,3,1,2,3
9264,9264,,23,1,5,6
9265,9265,,43,1,3,4
9266,9266,,43,15,26,41
9267,9267,,23,4,10,14
9268,9268,,127,3,2,5
9269,9269,,23,27,52,79
9270,9270,,0,3,1,4
9271,9271,,21,1,1,2
9272,9272,,21,0,1,1
9273,9273,,21,3,2,5
9274,9274,,21,9,5,14
9275,9275,,21,0,2,2
9276,9276,,31,2,2,4
9277,9277,,11,85,134,219
9278,9278,,11,1,3,4
9279,9279,,5,2,4,6
9280,9280,,23,9,7,16
9281,9281,,3,3,1,4
9282,9282,,0,1,0,1
9283,9283,,8,1,4,5
9284,9284,,127,2,0,2
9285,9285,,43,0,4,4
9286,9286,,45,41,3,44
9287,9287,,45,2,0,2
9288,9288,,43,0,2,2
9289,9289,,21,0,1,1
9290,9290,,111,0,2,2
9291,9291,,3,1,0,1
9292,9292,,76,1,1,2
9293,9293,,23,3,6,9
9294,9294,,127,3,5,8
9295,9295,,3,2,3,5
9296,9296,,76,4,4,8
9297,9297,,76,0,1,1
9298,9298,,23,2,12,14
9299,9299,,105,4,0,4
9300,9300,,31,8,2,10
9301,9301,,127,1,0,1
9302,9302,,14,7,9,16
9303,9303,,14,1,1,2
9304,9304,,66,3,2,5
9305,9305,,43,8,4,12
9306,9306,,6,7,15,22
9307,9307,,8,1,1,2
9308,9308,,43,1,0,1
9309,9309,,8,4,9,13
9310,9310,,23,2,3,5
9311,9311,,23,1,3,4
9312,9312,,127,9,13,22
9313,9313,,111,1,2,3
9314,9314,,8,0,3,3
9315,9315,,43,3,1,4
9316,9316,,45,7,11,18
9317,9317,,127,2,4,6
9318,9318,,6,0,1,1
9319,9319,,23,3,3,6
9320,9320,,8,0,1,1
9321,9321,,8,7,26,33
9322,9322,,23,11,13,24
9323,9323,,45,1,1,2
9324,9324,,8,0,3,3
9325,9325,,127,3,3,6
9326,9326,,8,0,7,7
9327,9327,,8,2,1,3
9328,9328,,6,2,4,6
9329,9329,,24,1,0,1
9330,9330,,23,0,1,1
9331,9331,,43,6,16,22
9332,9332,,23,3,5,8
9333,9333,,8,17,25,42
9334,9334,,23,1,0,1
9335,9335,,111,1,4,5
9336,9336,,111,4,13,17
9337,9337,,111,0,1,1
9338,9338,,111,1,3,4
9339,9339,,31,3,2,5
9340,9340,,23,4,5,9
9341,9341,,18,9,4,13
9342,9342,,0,3,0,3
9343,9343,,15,2,5,7
9344,9344,,111,4,39,43
9345,9345,,111,6,2,8
9346,9346,,8,1,0,1
9347,9347,,0,3,3,6
9348,9348,,14,1,0,1
9349,9349,,43,0,3,3
9350,9350,,15,1,2,3
9351,9351,,8,15,9,24
9352,9352,,127,0,1,1
9353,9353,,23,1,1,2
9354,9354,,6,1,1,2
9355,9355,,23,1,3,4
9356,9356,,14,2,0,2
9357,9357,,11,1,1,2
9358,9358,,76,15,9,24
9359,9359,,76,1,1,2
9360,9360,,23,1,1,2
9361,9361,,8,5,4,9
9362,9362,,8,4,5,9
9363,9363,,127,1,2,3
9364,9364,,127,0,3,3
9365,9365,,127,2,0,2
9366,9366,,127,2,2,4
9367,9367,,127,17,15,32
9368,9368,,21,5,1,6
9369,9369,,18,7,2,9
9370,9370,,23,1,0,1
9371,9371,,8,19,7,26
9372,9372,,45,2,2,4
9373,9373,,23,1,5,6
9374,9374,,23,1,0,1
9375,9375,,8,1,7,8
9376,9376,,31,1,5,6
9377,9377,,8,0,4,4
9378,9378,,88,11,13,24
9379,9379,,8,0,1,1
9380,9380,,23,1,1,2
9381,9381,,23,6,6,12
9382,9382,,3,1,1,2
9383,9383,,3,8,10,18
9384,9384,,76,13,12,25
9385,9385,,23,6,5,11
9386,9386,,23,1,0,1
9387,9387,,8,1,0,1
9388,9388,,8,14,20,34
9389,9389,,31,1,3,4
9390,9390,,52,2,5,7
9391,9391,,52,1,0,1
9392,9392,,127,1,0,1
9393,9393,,3,7,10,17
9394,9394,,43,8,4,12
9395,9395,,45,4,1,5
9396,9396,,45,3,0,3
9397,9397,,62,5,3,8
9398,9398,,31,1,1,2
9399,9399,,11,1,2,3
9400,9400,,5,0,1,1
9401,9401,,21,0,1,1
9402,9402,,21,7,4,11
9403,9403,,23,0,1,1
9404,9404,,23,3,5,8
9405,9405,,15,2,0,2
9406,9406,,21,4,6,10
9407,9407,,23,0,1,1
9408,9408,,3,4,4,8
9409,9409,,23,0,1,1
9410,9410,,8,4,3,7
9411,9411,,23,2,6,8
9412,9412,,14,5,1,6
9413,9413,,0,1,1,2
9414,9414,,105,0,2,2
9415,9415,,0,0,1,1
9416,9416,,0,3,4,7
9417,9417,,43,2,1,3
9418,9418,,21,11,8,19
9419,9419,,23,0,6,6
9420,9420,,0,0,1,1
9421,9421,,43,190,49,239
9422,9422,,3,1,0,1
9423,9423,,52,7,11,18
9424,9424,,43,1,2,3
9425,9425,,127,1,0,1
9426,9426,,23,0,1,1
9427,9427,,14,7,4,11
9428,9428,,23,1,0,1
9429,9429,,43,6,5,11
9430,9430,,127,0,1,1
9431,9431,,66,1,3,4
9432,9432,,21,3,4,7
9433,9433,,120,2,0,2
9434,9434,,0,0,2,2
9435,9435,,43,0,2,2
9436,9436,,8,3,3,6
9437,9437,,43,2,0,2
9438,9438,,8,2,3,5
9439,9439,,8,1,4,5
9440,9440,,14,8,1,9
9441,9441,,76,2,5,7
9442,9442,,21,11,0,11
9443,9443,,66,3,3,6
9444,9444,,21,1,2,3
9445,9445,,21,1,5,6
9446,9446,,8,2,0,2
9447,9447,,8,1,1,2
9448,9448,,111,3,1,4
9449,9449,,8,14,17,31
9450,9450,,8,1,3,4
9451,9451,,127,2,2,4
9452,9452,,127,4,2,6
9453,9453,,31,1,1,2
9454,9454,,45,3,2,5
9455,9455,,23,1,1,2
9456,9456,,11,1,2,3
9457,9457,,21,0,3,3
9458,9458,,76,2,3,5
9459,9459,,8,3,2,5
9460,9460,,76,1,2,3
9461,9461,,8,2,2,4
9462,9462,,127,11,7,18
9463,9463,,14,24,20,44
9464,9464,,127,2,0,2
9465,9465,,127,1,6,7
9466,9466,,66,2,2,4
9467,9467,,52,6,11,17
9468,9468,,52,1,2,3
9469,9469,,8,12,6,18
9470,9470,,31,5,10,15
9471,9471,,23,1,0,1
9472,9472,,111,4,3,7
9473,9473,,23,20,21,41
9474,9474,,23,7,5,12
9475,9475,,23,2,4,6
9476,9476,,23,1,3,4
9477,9477,,23,2,2,4
9478,9478,,45,1,2,3
9479,9479,,23,5,6,11
9480,9480,,23,3,8,11
9481,9481,,15,10,5,15
9482,9482,,23,3,0,3
9483,9483,,23,0,3,3
9484,9484,,111,5,1,6
9485,9485,,23,6,41,47
9486,9486,,23,9,7,16
9487,9487,,23,3,2,5
9488,9488,,8,1,2,3
9489,9489,,31,4,9,13
9490,9490,,8,2,2,4
9491,9491,,23,9,4,13
9492,9492,,111,3,1,4
9493,9493,,111,11,9,20
9494,9494,,8,3,1,4
9495,9495,,23,0,1,1
9496,9496,,14,5,6,11
9497,9497,,127,1,0,1
9498,9498,,15,8,5,13
9499,9499,,8,7,6,13
9500,9500,,8,9,4,13
9501,9501,,8,14,9,23
9502,9502,,8,2,1,3
9503,9503,,31,3,1,4
9504,9504,,111,0,1,1
9505,9505,,23,0,3,3
9506,9506,,8,0,6,6
9507,9507,,18,6,2,8
9508,9508,,18,1,1,2
9509,9509,,0,5,4,9
9510,9510,,23,8,11,19
9511,9511,,23,2,3,5
9512,9512,,23,7,5,12
9513,9513,,8,0,1,1
9514,9514,,111,4,0,4
9515,9515,,23,3,3,6
9516,9516,,23,0,1,1
9517,9517,,66,0,1,1
9518,9518,,66,2,1,3
9519,9519,,15,0,3,3
9520,9520,,23,2,0,2
9521,9521,,45,0,1,1
9522,9522,,45,1,1,2
9523,9523,,111,2,2,4
9524,9524,,111,2,0,2
9525,9525,,8,6,6,12
9526,9526,,23,12,11,23
9527,9527,,76,1,0,1
9528,9528,,23,3,3,6
9529,9529,,8,3,1,4
9530,9530,,31,1,1,2
9531,9531,,194,0,1,1
9532,9532,,194,0,1,1
9533,9533,,111,1,2,3
9534,9534,,88,2,2,4
9535,9535,,43,5,2,7
9536,9536,,8,5,1,6
9537,9537,,45,0,2,2
9538,9538,,15,1,0,1
9539,9539,,6,2,3,5
9540,9540,,15,5,1,6
9541,9541,,120,1,1,2
9542,9542,,23,2,8,10
9543,9543,,127,20,17,37
9544,9544,,23,9,1,10
9545,9545,,8,3,15,18
9546,9546,,111,2,0,2
9547,9547,,8,9,6,15
9548,9548,,21,26,39,65
9549,9549,,21,13,28,41
9550,9550,,88,1,3,4
9551,9551,,23,1,3,4
9552,9552,,11,0,2,2
9553,9553,,11,2,2,4
9554,9554,,11,3,1,4
9555,9555,,66,1,0,1
9556,9556,,52,0,2,2
9557,9557,,52,1,0,1
9558,9558,,31,0,4,4
9559,9559,,8,3,7,10
9560,9560,,15,4,3,7
9561,9561,,76,20,22,42
9562,9562,,88,1,0,1
9563,9563,,21,6,5,11
9564,9564,,0,2,5,7
9565,9565,,23,1,0,1
9566,9566,,45,5,11,16
9567,9567,,15,0,2,2
9568,9568,,15,1,2,3
9569,9569,,23,0,1,1
9570,9570,,0,4,3,7
9571,9571,,23,0,1,1
9572,9572,,23,1,5,6
9573,9573,,23,10,13,23
9574,9574,,24,1,2,3
9575,9575,,23,7,8,15
9576,9576,,8,1,0,1
9577,9577,,66,3,6,9
9578,9578,,127,9,19,28
9579,9579,,21,0,3,3
9580,9580,,0,2,2,4
9581,9581,,43,0,1,1
9582,9582,,23,3,2,5
9583,9583,,23,1,6,7
9584,9584,,44,0,3,3
9585,9585,,44,2,0,2
9586,9586,,24,1,1,2
9587,9587,,88,0,1,1
9588,9588,,5,1,0,1
9589,9589,,3,0,2,2
9590,9590,,23,4,0,4
9591,9591,,14,10,3,13
9592,9592,,8,6,5,11
9593,9593,,14,2,2,4
9594,9594,,23,5,6,11
9595,9595,,15,0,1,1
9596,9596,,3,0,2,2
9597,9597,,3,1,0,1
9598,9598,,8,4,0,4
9599,9599,,127,0,4,4
9600,9600,,43,0,4,4
9601,9601,,43,0,8,8
9602,9602,,21,5,1,6
9603,9603,,8,4,6,10
9604,9604,,8,2,0,2
9605,9605,,23,0,1,1
9606,9606,,23,4,7,11
9607,9607,,23,1,0,1
9608,9608,,127,8,11,19
9609,9609,,21,1,0,1
9610,9610,,8,1,4,5
9611,9611,,8,2,1,3
9612,9612,,5,1,5,6
9613,9613,,8,2,3,5
9614,9614,,8,5,13,18
9615,9615,,5,4,4,8
9616,9616,,6,2,5,7
9617,9617,,45,0,1,1
9618,9618,,45,6,10,16
9619,9619,,45,2,0,2
9620,9620,,43,1,2,3
9621,9621,,43,2,2,4
9622,9622,,76,3,0,3
9623,9623,,8,1,1,2
9624,9624,,23,0,3,3
9625,9625,,0,6,0,6
9626,9626,,8,0,4,4
9627,9627,,23,0,1,1
9628,9628,,21,1,3,4
9629,9629,,14,3,4,7
9630,9630,,11,0,2,2
9631,9631,,11,1,0,1
9632,9632,,88,2,0,2
9633,9633,,14,1,2,3
9634,9634,,23,16,23,39
9635,9635,,0,6,2,8
9636,9636,,8,7,3,10
9637,9637,,8,1,1,2
9638,9638,,105,2,0,2
9639,9639,,76,1,0,1
9640,9640,,14,2,0,2
9641,9641,,0,0,1,1
9642,9642,,23,1,0,1
9643,9643,,111,2,5,7
9644,9644,,24,0,1,1
9645,9645,,52,3,3,6
9646,9646,,15,3,11,14
9647,9647,,15,7,7,14
9648,9648,,0,2,0,2
9649,9649,,8,5,9,14
9650,9650,,45,52,14,66
9651,9651,,14,6,16,22
9652,9652,,14,6,11,17
9653,9653,,11,3,6,9
9654,9654,,18,6,2,8
9655,9655,,6,0,1,1
9656,9656,,5,9,13,22
9657,9657,,43,0,1,1
9658,9658,,52,2,5,7
9659,9659,,11,2,0,2
9660,9660,,24,5,15,20
9661,9661,,8,5,10,15
9662,9662,,23,1,0,1
9663,9663,,23,3,1,4
9664,9664,,15,1,1,2
9665,9665,,23,7,4,11
9666,9666,,5,3,4,7
9667,9667,,43,19,10,29
9668,9668,,31,3,3,6
9669,9669,,8,0,1,1
9670,9670,,43,0,1,1
9671,9671,,8,1,0,1
9672,9672,,8,2,0,2
9673,9673,,66,1,8,9
9674,9674,,66,1,0,1
9675,9675,,43,0,5,5
9676,9676,,23,14,27,41
9677,9677,,23,1,2,3
9678,9678,,21,1,2,3
9679,9679,,21,4,4,8
9680,9680,,5,4,3,7
9681,9681,,14,3,0,3
9682,9682,,31,2,5,7
9683,9683,,43,12,11,23
9684,9684,,43,17,9,26
9685,9685,,43,4,0,4
9686,9686,,8,7,2,9
9687,9687,,5,1,0,1
9688,9688,,8,8,14,22
9689,9689,,43,5,1,6
9690,9690,,76,0,1,1
9691,9691,,21,1,2,3
9692,9692,,31,2,4,6
9693,9693,,127,1,1,2
9694,9694,,8,4,4,8
9695,9695,,66,0,2,2
9696,9696,,8,9,5,14
9697,9697,,76,0,2,2
9698,9698,,14,9,11,20
9699,9699,,105,0,1,1
9700,9700,,23,7,2,9
9701,9701,,21,4,9,13
9702,9702,,23,3,1,4
9703,9703,,23,5,36,41
9704,9704,,45,9,13,22
9705,9705,,14,1,0,1
9706,9706,,43,5,4,9
9707,9707,,23,5,7,12
9708,9708,,23,0,2,2
9709,9709,,14,3,1,4
9710,9710,,14,1,0,1
9711,9711,,8,1,5,6
9712,9712,,14,4,4,8
9713,9713,,14,1,0,1
9714,9714,,14,4,1,5
9715,9715,,0,0,1,1
9716,9716,,5,4,6,10
9717,9717,,31,2,0,2
9718,9718,,76,0,4,4
9719,9719,,76,1,3,4
9720,9720,,8,8,1,9
9721,9721,,105,5,5,10
9722,9722,,46,0,1,1
9723,9723,,46,1,0,1
9724,9724,,88,1,0,1
9725,9725,,31,0,4,4
9726,9726,,31,1,5,6
9727,9727,,8,7,4,11
9728,9728,,76,2,0,2
9729,9729,,15,1,0,1
9730,9730,,31,0,4,4
9731,9731,,43,0,2,2
9732,9732,,15,0,1,1
9733,9733,,15,2,1,3
9734,9734,,8,1,5,6
9735,9735,,8,4,5,9
9736,9736,,23,0,3,3
9737,9737,,11,3,1,4
9738,9738,,43,1,2,3
9739,9739,,23,0,3,3
9740,9740,,21,0,1,1
9741,9741,,23,0,1,1
9742,9742,,14,17,10,27
9743,9743,,8,4,6,10
9744,9744,,15,5,4,9
9745,9745,,14,3,2,5
9746,9746,,8,10,8,18
9747,9747,,18,1,0,1
9748,9748,,11,2,2,4
9749,9749,,127,6,9,15
9750,9750,,14,1,0,1
9751,9751,,43,7,2,9
9752,9752,,43,1,3,4
9753,9753,,14,9,8,17
9754,9754,,43,2,1,3
9755,9755,,43,2,3,5
9756,9756,,14,3,8,11
9757,9757,,52,1,7,8
9758,9758,,3,0,3,3
9759,9759,,14,6,4,10
9760,9760,,8,4,1,5
9761,9761,,21,1,0,1
9762,9762,,21,1,2,3
9763,9763,,127,0,1,1
9764,9764,,127,2,5,7
9765,9765,,23,1,0,1
9766,9766,,8,3,3,6
9767,9767,,11,1,3,4
9768,9768,,11,6,1,7
9769,9769,,66,37,12,49
9770,9770,,76,3,2,5
9771,9771,,76,0,1,1
9772,9772,,76,0,3,3
9773,9773,,14,0,2,2
9774,9774,,105,12,16,28
9775,9775,,0,2,3,5
9776,9776,,31,6,2,8
9777,9777,,31,0,1,1
9778,9778,,23,8,5,13
9779,9779,,6,1,1,2
9780,9780,,31,0,2,2
9781,9781,,14,1,4,5
9782,9782,,23,1,1,2
9783,9783,,23,2,1,3
9784,9784,,23,0,7,7
9785,9785,,23,4,4,8
9786,9786,,23,13,19,32
9787,9787,,52,21,12,33
9788,9788,,23,12,9,21
9789,9789,,88,1,1,2
9790,9790,,23,1,0,1
9791,9791,,105,1,3,4
9792,9792,,8,0,1,1
9793,9793,,8,0,1,1
9794,9794,,8,2,0,2
9795,9795,,31,2,6,8
9796,9796,,8,7,13,20
9797,9797,,45,1,1,2
9798,9798,,14,0,2,2
9799,9799,,23,0,5,5
9800,9800,,23,1,1,2
9801,9801,,52,10,4,14
9802,9802,,15,1,1,2
9803,9803,,23,1,2,3
9804,9804,,45,1,4,5
9805,9805,,8,3,3,6
9806,9806,,23,3,3,6
9807,9807,,15,0,7,7
9808,9808,,21,6,7,13
9809,9809,,45,0,2,2
9810,9810,,0,23,3,26
9811,9811,,127,4,12,16
9812,9812,,127,3,4,7
9813,9813,,127,1,2,3
9814,9814,,105,3,9,12
9815,9815,,105,11,10,21
9816,9816,,8,2,2,4
9817,9817,,23,0,1,1
9818,9818,,23,1,0,1
9819,9819,,15,0,1,1
9820,9820,,15,1,0,1
9821,9821,,0,9,9,18
9822,9822,,0,1,1,2
9823,9823,,11,0,1,1
9824,9824,,0,1,2,3
9825,9825,,31,0,2,2
9826,9826,,23,1,0,1
9827,9827,,105,23,2,25
9828,9828,,43,0,2,2
9829,9829,,8,11,18,29
9830,9830,,127,4,3,7
9831,9831,,45,0,1,1
9832,9832,,23,2,1,3
9833,9833,,23,0,2,2
9834,9834,,127,0,1,1
9835,9835,,23,0,1,1
9836,9836,,18,9,10,19
9837,9837,,15,2,2,4
9838,9838,,31,0,2,2
9839,9839,,23,2,5,7
9840,9840,,15,0,4,4
9841,9841,,8,9,5,14
9842,9842,,14,1,0,1
9843,9843,,23,2,2,4
9844,9844,,111,0,4,4
9845,9845,,0,6,1,7
9846,9846,,0,7,10,17
9847,9847,,52,7,5,12
9848,9848,,23,1,2,3
9849,9849,,15,2,2,4
9850,9850,,18,3,1,4
9851,9851,,5,2,1,3
9852,9852,,23,2,10,12
9853,9853,,127,0,1,1
9854,9854,,23,0,1,1
9855,9855,,66,4,1,5
9856,9856,,23,3,0,3
9857,9857,,52,1,3,4
9858,9858,,52,3,5,8
9859,9859,,105,0,1,1
9860,9860,,0,0,1,1
9861,9861,,23,1,1,2
9862,9862,,111,1,0,1
9863,9863,,127,1,1,2
9864,9864,,23,4,4,8
9865,9865,,31,3,8,11
9866,9866,,23,0,1,1
9867,9867,,66,3,1,4
9868,9868,,3,1,0,1
9869,9869,,14,1,7,8
9870,9870,,14,4,5,9
9871,9871,,14,1,1,2
9872,9872,,8,3,8,11
9873,9873,,3,6,3,9
9874,9874,,0,2,5,7
9875,9875,,8,4,7,11
9876,9876,,3,0,2,2
9877,9877,,3,2,2,4
9878,9878,,43,1,0,1
9879,9879,,43,5,9,14
9880,9880,,43,10,4,14
9881,9881,,21,6,1,7
9882,9882,,45,5,11,16
9883,9883,,0,1,1,2
9884,9884,,31,1,2,3
9885,9885,,52,1,0,1
9886,9886,,76,1,1,2
9887,9887,,3,9,11,20
9888,9888,,0,3,10,13
9889,9889,,23,4,2,6
9890,9890,,52,5,1,6
9891,9891,,127,13,7,20
9892,9892,,8,12,2,14
9893,9893,,52,1,0,1
9894,9894,,14,1,10,11
9895,9895,,14,1,1,2
9896,9896,,43,1,0,1
9897,9897,,43,0,2,2
9898,9898,,43,2,6,8
9899,9899,,43,1,3,4
9900,9900,,8,0,1,1
9901,9901,,76,2,1,3
9902,9902,,52,1,0,1
9903,9903,,23,0,1,1
9904,9904,,15,0,1,1
9905,9905,,15,2,2,4
9906,9906,,0,5,5,10
9907,9907,,3,2,2,4
9908,9908,,47,0,3,3
9909,9909,,47,2,0,2
9910,9910,,0,22,40,62
9911,9911,,24,0,1,1
9912,9912,,24,2,4,6
9913,9913,,52,1,2,3
9914,9914,,23,0,1,1
9915,9915,,23,6,14,20
9916,9916,,23,5,4,9
9917,9917,,23,0,1,1
9918,9918,,23,1,0,1
9919,9919,,52,1,4,5
9920,9920,,6,23,16,39
9921,9921,,23,6,2,8
9922,9922,,23,3,7,10
9923,9923,,11,9,7,16
9924,9924,,105,0,1,1
9925,9925,,31,0,2,2
9926,9926,,8,8,1,9
9927,9927,,8,1,0,1
9928,9928,,11,0,2,2
9929,9929,,14,0,2,2
9930,9930,,15,1,1,2
9931,9931,,8,0,1,1
9932,9932,,8,3,3,6
9933,9933,,23,1,0,1
9934,9934,,24,0,7,7
9935,9935,,15,1,1,2
9936,9936,,105,0,5,5
9937,9937,,15,1,1,2
9938,9938,,45,0,3,3
9939,9939,,15,9,16,25
9940,9940,,23,17,20,37
9941,9941,,23,1,15,16
9942,9942,,0,0,1,1
9943,9943,,8,2,0,2
9944,9944,,23,3,12,15
9945,9945,,14,1,5,6
9946,9946,,14,2,2,4
9947,9947,,15,0,2,2
9948,9948,,23,0,1,1
9949,9949,,111,0,1,1
9950,9950,,111,2,0,2
9951,9951,,8,5,6,11
9952,9952,,15,2,3,5
9953,9953,,15,1,0,1
9954,9954,,52,0,1,1
9955,9955,,0,4,4,8
9956,9956,,0,2,9,11
9957,9957,,127,3,3,6
9958,9958,,66,10,1,11
9959,9959,,66,1,1,2
9960,9960,,23,2,1,3
9961,9961,,23,0,2,2
9962,9962,,23,1,1,2
9963,9963,,0,3,3,6
9964,9964,,23,6,4,10
9965,9965,,111,0,3,3
9966,9966,,31,4,6,10
9967,9967,,23,1,1,2
9968,9968,,23,0,1,1
9969,9969,,24,1,7,8
9970,9970,,23,2,3,5
9971,9971,,76,3,4,7
9972,9972,,105,2,1,3
9973,9973,,24,2,0,2
9974,9974,,23,1,20,21
9975,9975,,23,0,1,1
9976,9976,,0,3,3,6
9977,9977,,23,3,7,10
9978,9978,,8,1,0,1
9979,9979,,3,0,2,2
9980,9980,,8,3,2,5
9981,9981,,88,8,4,12
9982,9982,,23,4,6,10
9983,9983,,15,7,11,18
9984,9984,,0,7,2,9
9985,9985,,0,2,3,5
9986,9986,,52,3,4,7
9987,9987,,23,0,12,12
9988,9988,,23,0,5,5
9989,9989,,23,1,0,1
9990,9990,,62,2,11,13
9991,9991,,18,29,9,38
9992,9992,,0,6,2,8
9993,9993,,23,7,0,7
9994,9994,,23,13,4,17
9995,9995,,21,0,1,1
9996,9996,,15,0,2,2
9997,9997,,111,2,5,7
9998,9998,,15,3,1,4
9999,9999,,127,0,4,4
10000,10000,,23,0,1,1
10001,10001,,45,2,0,2
10002,10002,,11,2,3,5
10003,10003,,23,3,0,3
10004,10004,,5,6,24,30
10005,10005,,23,0,3,3
10006,10006,,14,24,17,41
10007,10007,,43,0,1,1
10008,10008,,43,0,2,2
10009,10009,,8,0,3,3
10010,10010,,43,3,0,3
10011,10011,,23,5,3,8
10012,10012,,0,2,1,3
10013,10013,,14,1,1,2
10014,10014,,15,2,0,2
10015,10015,,127,5,0,5
10016,10016,,52,7,3,10
10017,10017,,120,1,4,5
10018,10018,,43,0,1,1
10019,10019,,14,12,16,28
10020,10020,,127,1,1,2
10021,10021,,127,2,2,4
10022,10022,,3,0,6,6
10023,10023,,111,0,1,1
10024,10024,,111,0,1,1
10025,10025,,66,0,5,5
10026,10026,,111,0,2,2
10027,10027,,111,1,1,2
10028,10028,,8,2,2,4
10029,10029,,8,4,6,10
10030,10030,,45,3,4,7
10031,10031,,0,1,0,1
10032,10032,,23,5,5,10
10033,10033,,52,1,5,6
10034,10034,,23,1,0,1
10035,10035,,127,0,4,4
10036,10036,,21,10,0,10
10037,10037,,66,2,7,9
10038,10038,,11,8,8,16
10039,10039,,11,0,3,3
10040,10040,,127,2,3,5
10041,10041,,8,5,5,10
10042,10042,,8,1,1,2
10043,10043,,45,0,1,1
10044,10044,,105,1,1,2
10045,10045,,127,0,5,5
10046,10046,,23,0,1,1
10047,10047,,23,3,1,4
10048,10048,,43,0,1,1
10049,10049,,111,5,5,10
10050,10050,,31,1,0,1
10051,10051,,127,0,1,1
10052,10052,,105,1,0,1
10053,10053,,23,9,2,11
10054,10054,,5,0,1,1
10055,10055,,127,3,5,8
10056,10056,,3,10,10,20
10057,10057,,111,1,0,1
10058,10058,,23,1,2,3
10059,10059,,8,1,4,5
10060,10060,,8,6,1,7
10061,10061,,105,0,3,3
10062,10062,,43,1,0,1
10063,10063,,8,5,12,17
10064,10064,,3,2,0,2
10065,10065,,8,1,0,1
10066,10066,,15,1,1,2
10067,10067,,8,4,9,13
10068,10068,,105,18,12,30
10069,10069,,23,2,0,2
10070,10070,,3,11,14,25
10071,10071,,23,1,0,1
10072,10072,,23,1,1,2
10073,10073,,23,6,6,12
10074,10074,,23,1,0,1
10075,10075,,14,5,1,6
10076,10076,,111,0,5,5
10077,10077,,15,3,7,10
10078,10078,,76,1,13,14
10079,10079,,76,1,1,2
10080,10080,,18,2,0,2
10081,10081,,23,6,4,10
10082,10082,,15,1,0,1
10083,10083,,23,2,0,2
10084,10084,,8,3,26,29
10085,10085,,23,0,6,6
10086,10086,,23,7,1,8
10087,10087,,76,3,14,17
10088,10088,,8,1,0,1
10089,10089,,15,1,5,6
10090,10090,,11,6,3,9
10091,10091,,52,0,5,5
10092,10092,,23,1,0,1
10093,10093,,23,1,1,2
10094,10094,,127,4,1,5
10095,10095,,8,1,0,1
10096,10096,,127,0,2,2
10097,10097,,23,0,1,1
10098,10098,,76,2,0,2
10099,10099,,18,4,14,18
10100,10100,,21,4,0,4
10101,10101,,23,18,9,27
10102,10102,,23,3,4,7
10103,10103,,23,3,3,6
10104,10104,,0,17,2,19
10105,10105,,18,2,1,3
10106,10106,,0,0,3,3
10107,10107,,23,1,1,2
10108,10108,,0,0,4,4
10109,10109,,23,1,0,1
10110,10110,,15,3,8,11
10111,10111,,8,3,10,13
10112,10112,,111,1,2,3
10113,10113,,11,1,0,1
10114,10114,,105,1,0,1
10115,10115,,111,1,0,1
10116,10116,,23,1,1,2
10117,10117,,52,4,6,10
10118,10118,,52,0,4,4
10119,10119,,52,10,1,11
10120,10120,,52,0,1,1
10121,10121,,23,5,16,21
10122,10122,,21,0,1,1
10123,10123,,8,1,3,4
10124,10124,,8,3,7,10
10125,10125,,23,0,2,2
10126,10126,,11,0,1,1
10127,10127,,23,0,2,2
10128,10128,,3,5,6,11
10129,10129,,3,5,4,9
10130,10130,,23,0,1,1
10131,10131,,52,0,1,1
10132,10132,,15,0,3,3
10133,10133,,8,0,1,1
10134,10134,,24,2,0,2
10135,10135,,23,3,3,6
10136,10136,,127,2,1,3
10137,10137,,5,1,3,4
10138,10138,,111,0,1,1
10139,10139,,8,3,3,6
10140,10140,,43,1,4,5
10141,10141,,8,3,3,6
10142,10142,,43,5,1,6
10143,10143,,43,2,3,5
10144,10144,,43,0,1,1
10145,10145,,43,4,4,8
10146,10146,,127,2,2,4
10147,10147,,15,3,2,5
10148,10148,,52,0,2,2
10149,10149,,21,87,66,153
10150,10150,,76,0,1,1
10151,10151,,3,0,2,2
10152,10152,,43,1,1,2
10153,10153,,43,3,13,16
10154,10154,,43,0,1,1
10155,10155,,43,1,0,1
10156,10156,,14,20,13,33
10157,10157,,14,5,3,8
10158,10158,,3,1,2,3
10159,10159,,14,3,3,6
10160,10160,,8,1,1,2
10161,10161,,6,4,24,28
10162,10162,,23,1,0,1
10163,10163,,0,1,0,1
10164,10164,,0,0,2,2
10165,10165,,23,1,2,3
10166,10166,,21,20,2,22
10167,10167,,21,2,0,2
10168,10168,,66,0,1,1
10169,10169,,127,1,1,2
10170,10170,,21,0,1,1
10171,10171,,3,0,1,1
10172,10172,,21,0,2,2
10173,10173,,21,1,2,3
10174,10174,,8,4,0,4
10175,10175,,0,0,2,2
10176,10176,,8,1,0,1
10177,10177,,8,1,0,1
10178,10178,,11,1,1,2
10179,10179,,127,5,7,12
10180,10180,,127,1,0,1
10181,10181,,111,1,5,6
10182,10182,,3,0,1,1
10183,10183,,43,5,2,7
10184,10184,,23,20,16,36
10185,10185,,0,1,4,5
10186,10186,,23,3,7,10
10187,10187,,31,0,3,3
10188,10188,,31,2,5,7
10189,10189,,43,4,16,20
10190,10190,,23,10,3,13
10191,10191,,23,4,4,8
10192,10192,,23,1,0,1
10193,10193,,23,1,1,2
10194,10194,,43,0,6,6
10195,10195,,8,2,0,2
10196,10196,,52,0,7,7
10197,10197,,23,1,2,3
10198,10198,,23,2,0,2
10199,10199,,111,2,2,4
10200,10200,,23,9,19,28
10201,10201,,14,1,1,2
10202,10202,,111,5,5,10
10203,10203,,23,0,1,1
10204,10204,,23,4,6,10
10205,10205,,23,1,1,2
10206,10206,,23,1,1,2
10207,10207,,14,0,1,1
10208,10208,,88,23,10,33
10209,10209,,23,1,0,1
10210,10210,,23,2,2,4
10211,10211,,88,3,9,12
10212,10212,,21,2,1,3
10213,10213,,8,13,6,19
10214,10214,,8,1,0,1
10215,10215,,23,5,7,12
10216,10216,,23,1,1,2
10217,10217,,23,0,3,3
10218,10218,,11,7,10,17
10219,10219,,8,0,1,1
10220,10220,,105,3,9,12
10221,10221,,31,1,2,3
10222,10222,,23,1,0,1
10223,10223,,0,0,3,3
10224,10224,,23,2,0,2
10225,10225,,21,2,2,4
10226,10226,,8,1,1,2
10227,10227,,23,9,13,22
10228,10228,,48,0,1,1
10229,10229,,48,1,0,1
10230,10230,,8,7,6,13
10231,10231,,76,5,8,13
10232,10232,,52,2,0,2
10233,10233,,5,0,1,1
10234,10234,,23,4,7,11
10235,10235,,8,1,3,4
10236,10236,,21,3,4,7
10237,10237,,23,2,2,4
10238,10238,,15,4,3,7
10239,10239,,8,7,9,16
10240,10240,,23,0,2,2
10241,10241,,15,2,1,3
10242,10242,,66,11,1,12
10243,10243,,0,1,2,3
10244,10244,,0,1,1,2
10245,10245,,0,0,1,1
10246,10246,,23,0,2,2
10247,10247,,23,0,8,8
10248,10248,,21,2,4,6
10249,10249,,23,1,1,2
10250,10250,,43,6,4,10
10251,10251,,66,0,1,1
10252,10252,,0,7,7,14
10253,10253,,24,4,20,24
10254,10254,,21,1,1,2
10255,10255,,21,7,10,17
10256,10256,,45,1,0,1
10257,10257,,0,7,31,38
10258,10258,,3,1,3,4
10259,10259,,5,3,2,5
10260,10260,,5,2,6,8
10261,10261,,43,7,5,12
10262,10262,,43,24,5,29
10263,10263,,43,1,2,3
10264,10264,,43,4,10,14
10265,10265,,21,3,15,18
10266,10266,,21,1,4,5
10267,10267,,8,13,12,25
10268,10268,,88,1,0,1
10269,10269,,3,3,3,6
10270,10270,,23,10,7,17
10271,10271,,127,1,0,1
10272,10272,,23,1,1,2
10273,10273,,127,3,4,7
10274,10274,,43,2,2,4
10275,10275,,23,8,5,13
10276,10276,,3,1,4,5
10277,10277,,49,0,1,1
10278,10278,,49,1,0,1
10279,10279,,11,8,10,18
10280,10280,,11,1,0,1
10281,10281,,6,9,2,11
10282,10282,,0,0,2,2
10283,10283,,127,7,2,9
10284,10284,,66,4,1,5
10285,10285,,50,0,1,1
10286,10286,,50,1,0,1
10287,10287,,21,0,1,1
10288,10288,,66,0,1,1
10289,10289,,66,3,4,7
10290,10290,,111,29,7,36
10291,10291,,66,2,9,11
10292,10292,,11,3,2,5
10293,10293,,24,1,1,2
10294,10294,,45,1,1,2
10295,10295,,8,1,0,1
10296,10296,,8,0,5,5
10297,10297,,31,8,9,17
10298,10298,,24,2,3,5
10299,10299,,8,0,2,2
10300,10300,,8,9,7,16
10301,10301,,3,0,2,2
10302,10302,,3,2,1,3
10303,10303,,11,2,0,2
10304,10304,,76,7,2,9
10305,10305,,111,0,3,3
10306,10306,,111,4,4,8
10307,10307,,23,11,10,21
10308,10308,,23,1,4,5
10309,10309,,66,1,4,5
10310,10310,,76,1,0,1
10311,10311,,52,1,2,3
10312,10312,,120,4,7,11
10313,10313,,8,6,2,8
10314,10314,,31,0,4,4
10315,10315,,31,3,1,4
10316,10316,,127,4,6,10
10317,10317,,45,0,1,1
10318,10318,,14,3,0,3
10319,10319,,23,1,3,4
10320,10320,,8,5,1,6
10321,10321,,21,2,2,4
10322,10322,,23,83,9,92
10323,10323,,8,1,2,3
10324,10324,,21,0,1,1
10325,10325,,31,1,1,2
10326,10326,,8,0,3,3
10327,10327,,76,1,0,1
10328,10328,,8,0,1,1
10329,10329,,52,5,1,6
10330,10330,,194,1,2,3
10331,10331,,194,1,0,1
10332,10332,,194,1,0,1
10333,10333,,43,4,9,13
10334,10334,,127,1,3,4
10335,10335,,8,0,1,1
10336,10336,,23,0,1,1
10337,10337,,11,0,2,2
10338,10338,,43,1,0,1
10339,10339,,15,0,5,5
10340,10340,,15,2,0,2
10341,10341,,23,13,6,19
10342,10342,,23,1,1,2
10343,10343,,15,2,2,4
10344,10344,,23,1,1,2
10345,10345,,127,1,2,3
10346,10346,,15,1,0,1
10347,10347,,88,1,2,3
10348,10348,,111,0,1,1
10349,10349,,23,15,29,44
10350,10350,,6,2,2,4
10351,10351,,43,1,2,3
10352,10352,,111,4,6,10
10353,10353,,0,3,0,3
10354,10354,,8,2,0,2
10355,10355,,3,4,2,6
10356,10356,,15,2,3,5
10357,10357,,8,2,6,8
10358,10358,,8,0,3,3
10359,10359,,43,0,17,17
10360,10360,,51,0,1,1
10361,10361,,51,1,0,1
10362,10362,,111,2,0,2
10363,10363,,127,1,4,5
10364,10364,,23,1,1,2
10365,10365,,105,7,8,15
10366,10366,,21,3,1,4
10367,10367,,8,3,8,11
10368,10368,,8,1,1,2
10369,10369,,18,2,3,5
10370,10370,,18,4,2,6
10371,10371,,23,5,2,7
10372,10372,,23,0,3,3
10373,10373,,23,2,3,5
10374,10374,,23,16,24,40
10375,10375,,15,1,15,16
10376,10376,,3,1,2,3
10377,10377,,105,1,2,3
10378,10378,,43,2,1,3
10379,10379,,23,1,0,1
10380,10380,,21,2,0,2
10381,10381,,3,1,0,1
10382,10382,,88,4,3,7
10383,10383,,88,2,3,5
10384,10384,,23,19,25,44
10385,10385,,88,1,3,4
10386,10386,,88,2,3,5
10387,10387,,23,1,1,2
10388,10388,,23,19,1,20
10389,10389,,11,12,9,21
10390,10390,,66,3,0,3
10391,10391,,127,5,0,5
10392,10392,,23,1,0,1
10393,10393,,23,0,1,1
10394,10394,,111,1,1,2
10395,10395,,18,2,0,2
10396,10396,,111,2,5,7
10397,10397,,21,0,2,2
10398,10398,,21,1,0,1
10399,10399,,3,1,1,2
10400,10400,,127,7,16,23
10401,10401,,88,3,3,6
10402,10402,,11,20,4,24
10403,10403,,43,0,1,1
10404,10404,,111,15,3,18
10405,10405,,88,2,5,7
10406,10406,,21,4,2,6
10407,10407,,0,3,0,3
10408,10408,,23,6,1,7
10409,10409,,11,1,4,5
10410,10410,,21,4,5,9
10411,10411,,23,6,5,11
10412,10412,,0,5,7,12
10413,10413,,0,1,0,1
10414,10414,,8,0,3,3
10415,10415,,15,2,1,3
10416,10416,,127,2,0,2
10417,10417,,127,2,0,2
10418,10418,,0,1,0,1
10419,10419,,0,1,0,1
10420,10420,,43,16,3,19
10421,10421,,15,1,4,5
10422,10422,,23,1,3,4
10423,10423,,43,0,1,1
10424,10424,,0,17,4,21
10425,10425,,23,0,1,1
10426,10426,,127,6,9,15
10427,10427,,23,1,1,2
10428,10428,,23,2,7,9
10429,10429,,76,5,4,9
10430,10430,,43,0,1,1
10431,10431,,8,0,3,3
10432,10432,,8,3,0,3
10433,10433,,23,1,0,1
10434,10434,,8,1,0,1
10435,10435,,23,8,5,13
10436,10436,,111,6,2,8
10437,10437,,127,1,4,5
10438,10438,,127,13,33,46
10439,10439,,8,0,1,1
10440,10440,,14,2,1,3
10441,10441,,127,1,1,2
10442,10442,,66,2,2,4
10443,10443,,23,2,6,8
10444,10444,,127,1,1,2
10445,10445,,14,3,2,5
10446,10446,,23,1,0,1
10447,10447,,127,0,1,1
10448,10448,,11,5,4,9
10449,10449,,15,3,1,4
10450,10450,,52,2,4,6
10451,10451,,14,8,9,17
10452,10452,,14,14,23,37
10453,10453,,52,7,10,17
10454,10454,,15,1,3,4
10455,10455,,14,1,1,2
10456,10456,,43,9,16,25
10457,10457,,76,2,4,6
10458,10458,,14,1,3,4
10459,10459,,8,4,5,9
10460,10460,,43,9,7,16
10461,10461,,43,11,14,25
10462,10462,,43,3,3,6
10463,10463,,8,1,4,5
10464,10464,,43,1,0,1
10465,10465,,43,3,1,4
10466,10466,,43,2,3,5
10467,10467,,43,3,4,7
10468,10468,,8,1,0,1
10469,10469,,43,4,3,7
10470,10470,,105,25,11,36
10471,10471,,43,1,1,2
10472,10472,,21,1,0,1
10473,10473,,21,1,0,1
10474,10474,,111,1,0,1
10475,10475,,24,1,1,2
10476,10476,,111,4,3,7
10477,10477,,43,0,1,1
10478,10478,,23,3,9,12
10479,10479,,105,0,4,4
10480,10480,,23,5,3,8
10481,10481,,23,0,1,1
10482,10482,,8,0,3,3
10483,10483,,111,0,7,7
10484,10484,,0,1,1,2
10485,10485,,18,9,5,14
10486,10486,,15,3,4,7
10487,10487,,18,43,15,58
10488,10488,,18,8,15,23
10489,10489,,15,0,2,2
10490,10490,,15,2,0,2
10491,10491,,15,2,1,3
10492,10492,,43,1,1,2
10493,10493,,11,1,0,1
10494,10494,,18,0,1,1
10495,10495,,52,1,2,3
10496,10496,,15,3,2,5
10497,10497,,0,0,2,2
10498,10498,,15,1,0,1
10499,10499,,11,0,2,2
10500,10500,,11,1,0,1
10501,10501,,31,0,1,1
10502,10502,,52,2,2,4
10503,10503,,8,1,1,2
10504,10504,,23,12,12,24
10505,10505,,52,9,11,20
10506,10506,,18,7,1,8
10507,10507,,66,1,4,5
10508,10508,,11,1,0,1
10509,10509,,88,3,0,3
10510,10510,,14,0,3,3
10511,10511,,8,2,0,2
10512,10512,,0,19,18,37
10513,10513,,15,0,2,2
10514,10514,,23,0,1,1
10515,10515,,88,1,1,2
10516,10516,,23,3,7,10
10517,10517,,23,1,2,3
10518,10518,,21,1,1,2
10519,10519,,5,1,0,1
10520,10520,,21,4,3,7
10521,10521,,23,1,1,2
10522,10522,,23,1,2,3
10523,10523,,3,0,1,1
10524,10524,,88,8,8,16
10525,10525,,11,1,0,1
10526,10526,,11,0,1,1
10527,10527,,11,3,2,5
10528,10528,,11,2,0,2
10529,10529,,45,0,3,3
10530,10530,,8,1,4,5
10531,10531,,52,2,0,2
10532,10532,,5,2,2,4
10533,10533,,76,1,0,1
10534,10534,,52,1,3,4
10535,10535,,14,1,6,7
10536,10536,,0,7,8,15
10537,10537,,8,0,1,1
10538,10538,,23,2,3,5
10539,10539,,18,1,3,4
10540,10540,,8,1,0,1
10541,10541,,45,3,0,3
10542,10542,,31,4,3,7
10543,10543,,23,4,4,8
10544,10544,,18,7,0,7
10545,10545,,8,14,11,25
10546,10546,,23,9,17,26
10547,10547,,6,5,1,6
10548,10548,,8,2,2,4
10549,10549,,127,1,1,2
10550,10550,,127,2,1,3
10551,10551,,127,1,27,28
10552,10552,,8,0,1,1
10553,10553,,8,1,1,2
10554,10554,,14,2,2,4
10555,10555,,111,6,2,8
10556,10556,,18,7,14,21
10557,10557,,14,1,8,9
10558,10558,,111,6,3,9
10559,10559,,31,2,6,8
10560,10560,,111,3,2,5
10561,10561,,8,1,2,3
10562,10562,,31,2,0,2
10563,10563,,52,11,2,13
10564,10564,,127,9,8,17
10565,10565,,127,1,0,1
10566,10566,,8,1,11,12
10567,10567,,8,1,2,3
10568,10568,,23,3,2,5
10569,10569,,23,1,0,1
10570,10570,,15,2,0,2
10571,10571,,23,1,1,2
10572,10572,,8,3,4,7
10573,10573,,23,0,2,2
10574,10574,,8,1,3,4
10575,10575,,8,17,5,22
10576,10576,,8,1,6,7
10577,10577,,8,2,1,3
10578,10578,,23,1,0,1
10579,10579,,76,0,2,2
10580,10580,,111,4,0,4
10581,10581,,3,0,1,1
10582,10582,,88,5,7,12
10583,10583,,23,0,1,1
10584,10584,,52,45,36,81
10585,10585,,8,4,1,5
10586,10586,,23,1,0,1
10587,10587,,0,0,1,1
10588,10588,,15,0,7,7
10589,10589,,15,1,2,3
10590,10590,,111,1,1,2
10591,10591,,52,2,0,2
10592,10592,,6,7,10,17
10593,10593,,15,1,1,2
10594,10594,,15,4,10,14
10595,10595,,11,7,3,10
10596,10596,,11,2,0,2
10597,10597,,21,1,4,5
10598,10598,,52,1,4,5
10599,10599,,8,0,1,1
10600,10600,,8,1,8,9
10601,10601,,21,4,8,12
10602,10602,,127,0,1,1
10603,10603,,127,1,0,1
10604,10604,,14,0,5,5
10605,10605,,14,3,3,6
10606,10606,,15,1,9,10
10607,10607,,43,1,1,2
10608,10608,,127,4,4,8
10609,10609,,5,3,1,4
10610,10610,,43,16,1,17
10611,10611,,21,0,3,3
10612,10612,,21,0,2,2
10613,10613,,31,3,4,7
10614,10614,,21,4,5,9
10615,10615,,21,1,0,1
10616,10616,,23,1,0,1
10617,10617,,14,5,0,5
10618,10618,,127,4,3,7
10619,10619,,127,3,2,5
10620,10620,,23,2,0,2
10621,10621,,0,0,1,1
10622,10622,,88,1,4,5
10623,10623,,127,0,1,1
10624,10624,,21,1,0,1
10625,10625,,53,1,1,2
10626,10626,,53,1,1,2
10627,10627,,127,0,2,2
10628,10628,,14,23,19,42
10629,10629,,43,1,1,2
10630,10630,,45,1,0,1
10631,10631,,45,0,1,1
10632,10632,,43,1,4,5
10633,10633,,43,8,2,10
10634,10634,,43,8,5,13
10635,10635,,52,3,2,5
10636,10636,,0,1,1,2
10637,10637,,3,2,4,6
10638,10638,,23,1,2,3
10639,10639,,21,6,6,12
10640,10640,,3,4,3,7
10641,10641,,21,1,0,1
10642,10642,,45,0,1,1
10643,10643,,127,1,1,2
10644,10644,,8,1,1,2
10645,10645,,11,1,0,1
10646,10646,,52,3,0,3
10647,10647,,76,1,1,2
10648,10648,,52,1,3,4
10649,10649,,3,0,1,1
10650,10650,,23,12,8,20
10651,10651,,76,6,4,10
10652,10652,,120,10,4,14
10653,10653,,23,1,1,2
10654,10654,,5,1,5,6
10655,10655,,23,6,1,7
10656,10656,,8,3,1,4
10657,10657,,31,3,7,10
10658,10658,,31,1,1,2
10659,10659,,31,1,0,1
10660,10660,,14,0,1,1
10661,10661,,66,9,6,15
10662,10662,,66,1,0,1
10663,10663,,0,1,3,4
10664,10664,,14,1,0,1
10665,10665,,8,1,2,3
10666,10666,,8,4,1,5
10667,10667,,8,5,1,6
10668,10668,,8,21,13,34
10669,10669,,76,0,1,1
10670,10670,,54,0,1,1
10671,10671,,54,1,0,1
10672,10672,,45,0,1,1
10673,10673,,23,1,0,1
10674,10674,,8,1,0,1
10675,10675,,23,1,2,3
10676,10676,,23,1,3,4
10677,10677,,8,7,3,10
10678,10678,,23,0,1,1
10679,10679,,15,13,1,14
10680,10680,,14,0,2,2
10681,10681,,14,1,1,2
10682,10682,,14,1,2,3
10683,10683,,14,1,1,2
10684,10684,,23,0,1,1
10685,10685,,8,1,0,1
10686,10686,,23,0,1,1
10687,10687,,127,0,1,1
10688,10688,,127,4,1,5
10689,10689,,43,2,5,7
10690,10690,,105,0,1,1
10691,10691,,23,6,7,13
10692,10692,,8,0,1,1
10693,10693,,23,1,2,3
10694,10694,,8,0,1,1
10695,10695,,15,1,1,2
10696,10696,,11,0,2,2
10697,10697,,8,16,13,29
10698,10698,,120,2,4,6
10699,10699,,23,3,0,3
10700,10700,,8,2,2,4
10701,10701,,8,1,1,2
10702,10702,,76,6,2,8
10703,10703,,43,2,1,3
10704,10704,,52,0,1,1
10705,10705,,52,3,2,5
10706,10706,,3,2,0,2
10707,10707,,52,0,1,1
10708,10708,,0,3,3,6
10709,10709,,76,2,0,2
10710,10710,,111,0,3,3
10711,10711,,111,1,1,2
10712,10712,,52,2,1,3
10713,10713,,23,6,0,6
10714,10714,,23,8,4,12
10715,10715,,23,4,4,8
10716,10716,,23,4,1,5
10717,10717,,15,8,19,27
10718,10718,,23,1,4,5
10719,10719,,8,4,1,5
10720,10720,,0,3,0,3
10721,10721,,55,1,1,2
10722,10722,,55,1,1,2
10723,10723,,111,8,4,12
10724,10724,,11,3,0,3
10725,10725,,23,1,1,2
10726,10726,,23,2,4,6
10727,10727,,23,1,2,3
10728,10728,,43,0,1,1
10729,10729,,21,0,2,2
10730,10730,,111,0,2,2
10731,10731,,127,0,1,1
10732,10732,,21,0,2,2
10733,10733,,8,2,1,3
10734,10734,,23,1,2,3
10735,10735,,45,0,1,1
10736,10736,,21,1,0,1
10737,10737,,8,2,6,8
10738,10738,,21,15,23,38
10739,10739,,23,0,2,2
10740,10740,,23,0,6,6
10741,10741,,18,4,2,6
10742,10742,,52,3,2,5
10743,10743,,8,1,2,3
10744,10744,,8,0,1,1
10745,10745,,8,5,3,8
10746,10746,,111,3,4,7
10747,10747,,18,4,10,14
10748,10748,,18,2,0,2
10749,10749,,6,1,1,2
10750,10750,,0,2,4,6
10751,10751,,3,0,1,1
10752,10752,,127,1,1,2
10753,10753,,127,4,8,12
10754,10754,,8,5,2,7
10755,10755,,14,1,3,4
10756,10756,,15,1,0,1
10757,10757,,43,0,1,1
10758,10758,,8,3,4,7
10759,10759,,56,1,1,2
10760,10760,,56,2,1,3
10761,10761,,3,1,0,1
10762,10762,,14,3,8,11
10763,10763,,45,2,3,5
10764,10764,,45,2,0,2
10765,10765,,120,10,13,23
10766,10766,,0,2,0,2
10767,10767,,14,0,1,1
10768,10768,,8,5,3,8
10769,10769,,111,1,0,1
10770,10770,,43,3,3,6
10771,10771,,66,2,0,2
10772,10772,,14,1,0,1
10773,10773,,43,1,4,5
10774,10774,,24,6,2,8
10775,10775,,76,0,1,1
10776,10776,,8,1,0,1
10777,10777,,0,4,7,11
10778,10778,,0,4,3,7
10779,10779,,3,2,1,3
10780,10780,,21,0,1,1
10781,10781,,21,0,2,2
10782,10782,,11,1,0,1
10783,10783,,23,0,1,1
10784,10784,,15,22,24,46
10785,10785,,8,0,1,1
10786,10786,,11,3,6,9
10787,10787,,0,6,8,14
10788,10788,,24,0,1,1
10789,10789,,11,3,1,4
10790,10790,,23,0,4,4
10791,10791,,14,2,2,4
10792,10792,,3,0,1,1
10793,10793,,23,6,4,10
10794,10794,,14,2,17,19
10795,10795,,15,7,12,19
10796,10796,,31,2,2,4
10797,10797,,66,0,3,3
10798,10798,,23,10,21,31
10799,10799,,111,6,22,28
10800,10800,,8,2,0,2
10801,10801,,14,3,1,4
10802,10802,,0,4,0,4
10803,10803,,23,1,0,1
10804,10804,,8,2,3,5
10805,10805,,23,1,1,2
10806,10806,,111,1,0,1
10807,10807,,23,4,2,6
10808,10808,,8,0,1,1
10809,10809,,8,4,0,4
10810,10810,,111,6,6,12
10811,10811,,52,1,0,1
10812,10812,,0,1,1,2
10813,10813,,23,1,2,3
10814,10814,,23,0,1,1
10815,10815,,14,1,3,4
10816,10816,,8,1,0,1
10817,10817,,111,0,1,1
10818,10818,,8,1,3,4
10819,10819,,8,3,6,9
10820,10820,,6,0,3,3
10821,10821,,52,0,4,4
10822,10822,,23,18,33,51
10823,10823,,24,0,2,2
10824,10824,,24,0,1,1
10825,10825,,24,3,1,4
10826,10826,,23,4,4,8
10827,10827,,23,0,2,2
10828,10828,,8,3,1,4
10829,10829,,8,0,1,1
10830,10830,,8,2,3,5
10831,10831,,111,1,0,1
10832,10832,,23,2,1,3
10833,10833,,0,0,1,1
10834,10834,,23,5,1,6
10835,10835,,127,1,2,3
10836,10836,,15,3,4,7
10837,10837,,3,1,0,1
10838,10838,,23,2,1,3
10839,10839,,23,0,1,1
10840,10840,,8,2,4,6
10841,10841,,14,5,1,6
10842,10842,,8,2,3,5
10843,10843,,8,1,0,1
10844,10844,,21,1,3,4
10845,10845,,66,11,5,16
10846,10846,,15,1,1,2
10847,10847,,23,1,3,4
10848,10848,,23,1,1,2
10849,10849,,105,0,4,4
10850,10850,,8,1,1,2
10851,10851,,0,5,1,6
10852,10852,,23,1,1,2
10853,10853,,43,4,0,4
10854,10854,,8,2,0,2
10855,10855,,127,1,0,1
10856,10856,,8,0,1,1
10857,10857,,8,3,7,10
10858,10858,,8,0,3,3
10859,10859,,8,3,1,4
10860,10860,,23,0,4,4
10861,10861,,57,0,2,2
10862,10862,,57,2,0,2
10863,10863,,43,0,1,1
10864,10864,,21,3,2,5
10865,10865,,21,2,0,2
10866,10866,,76,2,0,2
10867,10867,,127,6,4,10
10868,10868,,14,1,3,4
10869,10869,,43,1,2,3
10870,10870,,8,1,1,2
10871,10871,,8,2,6,8
10872,10872,,43,1,4,5
10873,10873,,43,11,5,16
10874,10874,,21,3,13,16
10875,10875,,43,1,2,3
10876,10876,,0,5,0,5
10877,10877,,21,4,1,5
10878,10878,,58,0,1,1
10879,10879,,58,1,0,1
10880,10880,,8,2,3,5
10881,10881,,45,1,0,1
10882,10882,,23,4,6,10
10883,10883,,14,3,1,4
10884,10884,,21,8,2,10
10885,10885,,59,0,1,1
10886,10886,,59,1,0,1
10887,10887,,43,8,9,17
10888,10888,,43,7,3,10
10889,10889,,127,0,1,1
10890,10890,,43,2,1,3
10891,10891,,66,4,10,14
10892,10892,,23,2,3,5
10893,10893,,23,1,0,1
10894,10894,,52,1,0,1
10895,10895,,127,4,8,12
10896,10896,,105,14,12,26
10897,10897,,52,0,3,3
10898,10898,,52,1,0,1
10899,10899,,60,0,1,1
10900,10900,,60,1,0,1
10901,10901,,3,0,2,2
10902,10902,,43,1,4,5
10903,10903,,66,2,3,5
10904,10904,,127,0,1,1
10905,10905,,127,0,1,1
10906,10906,,21,0,1,1
10907,10907,,8,1,6,7
10908,10908,,8,2,0,2
10909,10909,,24,6,0,6
10910,10910,,24,2,3,5
10911,10911,,11,5,7,12
10912,10912,,45,1,3,4
10913,10913,,3,1,4,5
10914,10914,,76,0,2,2
10915,10915,,61,0,1,1
10916,10916,,61,1,0,1
10917,10917,,8,9,5,14
10918,10918,,14,4,1,5
10919,10919,,15,1,2,3
10920,10920,,15,1,3,4
10921,10921,,8,0,2,2
10922,10922,,111,3,0,3
10923,10923,,127,1,1,2
10924,10924,,23,143,149,292
10925,10925,,52,0,1,1
10926,10926,,23,3,2,5
10927,10927,,8,0,1,1
10928,10928,,15,0,4,4
10929,10929,,15,1,0,1
10930,10930,,3,1,6,7
10931,10931,,105,1,0,1
10932,10932,,23,9,13,22
10933,10933,,23,0,1,1
10934,10934,,21,1,3,4
10935,10935,,8,1,0,1
10936,10936,,3,7,1,8
10937,10937,,23,1,1,2
10938,10938,,21,0,2,2
10939,10939,,21,2,0,2
10940,10940,,127,2,1,3
10941,10941,,127,0,3,3
10942,10942,,76,1,1,2
10943,10943,,18,1,0,1
10944,10944,,88,0,1,1
10945,10945,,23,0,1,1
10946,10946,,111,0,6,6
10947,10947,,127,0,2,2
10948,10948,,127,1,0,1
10949,10949,,18,4,4,8
10950,10950,,18,4,9,13
10951,10951,,127,3,4,7
10952,10952,,127,2,2,4
10953,10953,,23,3,2,5
10954,10954,,8,0,1,1
10955,10955,,23,0,2,2
10956,10956,,23,1,0,1
10957,10957,,0,2,2,4
10958,10958,,62,0,4,4
10959,10959,,62,2,0,2
10960,10960,,62,0,3,3
10961,10961,,18,1,0,1
10962,10962,,23,1,0,1
10963,10963,,23,2,3,5
10964,10964,,76,11,14,25
10965,10965,,5,2,0,2
10966,10966,,127,1,2,3
10967,10967,,23,3,1,4
10968,10968,,127,2,6,8
10969,10969,,23,1,0,1
10970,10970,,15,0,1,1
10971,10971,,8,2,3,5
10972,10972,,11,0,6,6
10973,10973,,23,2,4,6
10974,10974,,23,1,0,1
10975,10975,,11,6,0,6
10976,10976,,23,0,2,2
10977,10977,,23,1,1,2
10978,10978,,6,7,18,25
10979,10979,,8,2,2,4
10980,10980,,23,0,1,1
10981,10981,,23,6,3,9
10982,10982,,111,1,1,2
10983,10983,,8,6,8,14
10984,10984,,21,13,14,27
10985,10985,,127,1,0,1
10986,10986,,8,4,0,4
10987,10987,,8,1,0,1
10988,10988,,8,1,0,1
10989,10989,,111,1,0,1
10990,10990,,11,1,0,1
10991,10991,,11,15,9,24
10992,10992,,88,20,0,20
10993,10993,,23,4,6,10
10994,10994,,0,2,7,9
10995,10995,,76,0,1,1
10996,10996,,0,3,4,7
10997,10997,,8,8,5,13
10998,10998,,15,1,0,1
10999,10999,,21,1,9,10
11000,11000,,21,0,1,1
11001,11001,,11,0,1,1
11002,11002,,0,6,3,9
11003,11003,,23,4,7,11
11004,11004,,8,20,24,44
11005,11005,,6,3,1,4
11006,11006,,45,0,1,1
11007,11007,,8,9,3,12
11008,11008,,52,2,5,7
11009,11009,,52,0,6,6
11010,11010,,52,1,1,2
11011,11011,,45,3,6,9
11012,11012,,45,1,1,2
11013,11013,,3,4,8,12
11014,11014,,0,11,14,25
11015,11015,,21,5,10,15
11016,11016,,23,5,5,10
11017,11017,,23,5,3,8
11018,11018,,0,1,1,2
11019,11019,,45,1,0,1
11020,11020,,127,0,1,1
11021,11021,,23,0,2,2
11022,11022,,52,2,0,2
11023,11023,,23,1,2,3
11024,11024,,3,2,0,2
11025,11025,,23,2,8,10
11026,11026,,66,4,0,4
11027,11027,,66,6,1,7
11028,11028,,21,4,2,6
11029,11029,,127,1,1,2
11030,11030,,14,0,1,1
11031,11031,,14,1,0,1
11032,11032,,5,8,10,18
11033,11033,,5,8,10,18
11034,11034,,23,2,6,8
11035,11035,,8,0,1,1
11036,11036,,43,5,0,5
11037,11037,,8,0,6,6
11038,11038,,5,1,1,2
11039,11039,,8,5,18,23
11040,11040,,8,5,0,5
11041,11041,,120,2,4,6
11042,11042,,43,9,6,15
11043,11043,,23,7,14,21
11044,11044,,3,1,1,2
11045,11045,,14,4,7,11
11046,11046,,21,6,9,15
11047,11047,,43,1,3,4
11048,11048,,8,6,10,16
11049,11049,,23,3,5,8
11050,11050,,111,0,5,5
11051,11051,,0,5,6,11
11052,11052,,88,11,6,17
11053,11053,,5,0,1,1
11054,11054,,5,6,10,16
11055,11055,,8,1,0,1
11056,11056,,43,1,0,1
11057,11057,,43,19,21,40
11058,11058,,43,3,7,10
11059,11059,,43,3,0,3
11060,11060,,14,1,0,1
11061,11061,,3,1,1,2
11062,11062,,3,0,1,1
11063,11063,,52,2,1,3
11064,11064,,14,0,3,3
11065,11065,,14,4,1,5
11066,11066,,14,3,1,4
11067,11067,,23,1,0,1
11068,11068,,127,1,5,6
11069,11069,,31,1,0,1
11070,11070,,120,1,0,1
11071,11071,,127,3,4,7
11072,11072,,23,0,1,1
11073,11073,,23,3,1,4
11074,11074,,3,0,2,2
11075,11075,,23,9,7,16
11076,11076,,23,1,0,1
11077,11077,,8,0,1,1
11078,11078,,11,3,0,3
11079,11079,,6,0,2,2
11080,11080,,8,0,2,2
11081,11081,,88,0,1,1
11082,11082,,23,8,14,22
11083,11083,,23,1,0,1
11084,11084,,23,0,1,1
11085,11085,,23,0,1,1
11086,11086,,31,6,10,16
11087,11087,,31,3,3,6
11088,11088,,8,0,7,7
11089,11089,,23,1,1,2
11090,11090,,8,2,0,2
11091,11091,,31,2,0,2
11092,11092,,127,4,5,9
11093,11093,,43,0,2,2
11094,11094,,111,0,3,3
11095,11095,,63,0,1,1
11096,11096,,63,1,0,1
11097,11097,,8,0,1,1
11098,11098,,8,20,14,34
11099,11099,,23,1,0,1
11100,11100,,111,3,2,5
11101,11101,,23,4,3,7
11102,11102,,31,0,6,6
11103,11103,,15,13,18,31
11104,11104,,14,0,1,1
11105,11105,,18,2,2,4
11106,11106,,15,2,2,4
11107,11107,,23,0,1,1
11108,11108,,23,2,1,3
11109,11109,,76,1,1,2
11110,11110,,23,7,6,13
11111,11111,,127,2,0,2
11112,11112,,14,3,4,7
11113,11113,,8,2,7,9
11114,11114,,8,2,0,2
11115,11115,,52,2,2,4
11116,11116,,52,2,1,3
11117,11117,,8,0,1,1
11118,11118,,0,1,14,15
11119,11119,,18,3,2,5
11120,11120,,23,1,5,6
11121,11121,,15,0,1,1
11122,11122,,194,0,1,1
11123,11123,,8,0,2,2
11124,11124,,45,1,1,2
11125,11125,,43,0,1,1
11126,11126,,43,1,0,1
11127,11127,,6,1,1,2
11128,11128,,15,5,11,16
11129,11129,,8,0,1,1
11130,11130,,14,2,14,16
11131,11131,,14,1,0,1
11132,11132,,15,6,3,9
11133,11133,,15,12,6,18
11134,11134,,15,8,3,11
11135,11135,,23,0,1,1
11136,11136,,127,1,1,2
11137,11137,,3,10,8,18
11138,11138,,15,1,4,5
11139,11139,,23,2,10,12
11140,11140,,21,1,1,2
11141,11141,,6,57,83,140
11142,11142,,21,4,3,7
11143,11143,,23,1,0,1
11144,11144,,0,2,9,11
11145,11145,,43,1,2,3
11146,11146,,43,1,1,2
11147,11147,,43,2,1,3
11148,11148,,43,5,4,9
11149,11149,,43,1,2,3
11150,11150,,23,11,5,16
11151,11151,,23,7,5,12
11152,11152,,23,1,2,3
11153,11153,,88,13,11,24
11154,11154,,5,2,1,3
11155,11155,,5,7,1,8
11156,11156,,45,2,5,7
11157,11157,,3,1,0,1
11158,11158,,23,0,1,1
11159,11159,,23,5,0,5
11160,11160,,43,5,3,8
11161,11161,,23,46,85,131
11162,11162,,21,1,1,2
11163,11163,,0,0,1,1
11164,11164,,0,1,0,1
11165,11165,,66,1,0,1
11166,11166,,21,2,6,8
11167,11167,,127,6,2,8
11168,11168,,21,7,2,9
11169,11169,,21,2,0,2
11170,11170,,21,4,6,10
11171,11171,,21,2,1,3
11172,11172,,45,0,1,1
11173,11173,,8,1,1,2
11174,11174,,11,4,12,16
11175,11175,,23,1,0,1
11176,11176,,5,2,4,6
11177,11177,,11,0,1,1
11178,11178,,11,1,1,2
11179,11179,,11,0,1,1
11180,11180,,24,1,1,2
11181,11181,,76,3,2,5
11182,11182,,76,3,2,5
11183,11183,,76,1,1,2
11184,11184,,23,6,2,8
11185,11185,,8,0,1,1
11186,11186,,105,7,7,14
11187,11187,,111,0,1,1
11188,11188,,23,1,1,2
11189,11189,,23,12,13,25
11190,11190,,23,1,1,2
11191,11191,,14,6,9,15
11192,11192,,31,0,1,1
11193,11193,,43,1,0,1
11194,11194,,43,0,1,1
11195,11195,,5,0,1,1
11196,11196,,127,2,2,4
11197,11197,,8,0,4,4
11198,11198,,23,1,1,2
11199,11199,,23,1,1,2
11200,11200,,8,2,0,2
11201,11201,,43,1,0,1
11202,11202,,127,4,7,11
11203,11203,,3,1,1,2
11204,11204,,18,0,5,5
11205,11205,,18,3,20,23
11206,11206,,8,0,4,4
11207,11207,,127,0,3,3
11208,11208,,111,3,3,6
11209,11209,,111,1,0,1
11210,11210,,23,0,3,3
11211,11211,,111,0,1,1
11212,11212,,3,1,0,1
11213,11213,,11,1,3,4
11214,11214,,11,0,2,2
11215,11215,,127,3,0,3
11216,11216,,127,0,3,3
11217,11217,,127,0,1,1
11218,11218,,127,2,0,2
11219,11219,,127,0,1,1
11220,11220,,127,0,1,1
11221,11221,,43,6,0,6
11222,11222,,23,2,3,5
11223,11223,,88,2,1,3
11224,11224,,127,2,2,4
11225,11225,,23,0,3,3
11226,11226,,23,41,58,99
11227,11227,,8,1,0,1
11228,11228,,23,0,1,1
11229,11229,,21,1,1,2
11230,11230,,43,5,1,6
11231,11231,,43,1,1,2
11232,11232,,43,1,0,1
11233,11233,,127,12,1,13
11234,11234,,15,9,2,11
11235,11235,,88,1,0,1
11236,11236,,5,4,3,7
11237,11237,,23,6,0,6
11238,11238,,3,0,1,1
11239,11239,,43,0,2,2
11240,11240,,23,0,1,1
11241,11241,,21,33,53,86
11242,11242,,23,3,8,11
11243,11243,,45,1,2,3
11244,11244,,127,2,2,4
11245,11245,,24,1,3,4
11246,11246,,31,7,3,10
11247,11247,,8,5,2,7
11248,11248,,8,0,1,1
11249,11249,,127,5,3,8
11250,11250,,23,2,0,2
11251,11251,,3,1,1,2
11252,11252,,111,0,1,1
11253,11253,,14,14,5,19
11254,11254,,14,0,1,1
11255,11255,,8,2,0,2
11256,11256,,127,1,2,3
11257,11257,,105,1,0,1
11258,11258,,88,20,4,24
11259,11259,,23,0,1,1
11260,11260,,0,30,75,105
11261,11261,,23,5,1,6
11262,11262,,15,1,0,1
11263,11263,,8,1,3,4
11264,11264,,0,2,2,4
11265,11265,,23,5,2,7
11266,11266,,0,3,6,9
11267,11267,,8,1,0,1
11268,11268,,11,1,1,2
11269,11269,,23,3,0,3
11270,11270,,52,2,1,3
11271,11271,,23,0,1,1
11272,11272,,23,5,0,5
11273,11273,,52,2,5,7
11274,11274,,52,3,1,4
11275,11275,,3,2,5,7
11276,11276,,3,4,3,7
11277,11277,,23,8,4,12
11278,11278,,23,0,1,1
11279,11279,,21,0,1,1
11280,11280,,3,0,1,1
11281,11281,,21,0,1,1
11282,11282,,21,3,1,4
11283,11283,,15,1,0,1
11284,11284,,88,3,3,6
11285,11285,,18,0,1,1
11286,11286,,0,2,6,8
11287,11287,,52,2,1,3
11288,11288,,120,3,2,5
11289,11289,,3,17,12,29
11290,11290,,23,1,1,2
11291,11291,,14,8,16,24
11292,11292,,21,3,3,6
11293,11293,,23,10,12,22
11294,11294,,23,1,2,3
11295,11295,,21,0,2,2
11296,11296,,11,1,0,1
11297,11297,,23,2,0,2
11298,11298,,76,6,28,34
11299,11299,,11,0,2,2
11300,11300,,120,6,6,12
11301,11301,,6,2,0,2
11302,11302,,105,1,3,4
11303,11303,,23,6,7,13
11304,11304,,14,4,1,5
11305,11305,,8,0,1,1
11306,11306,,52,0,1,1
11307,11307,,8,3,3,6
11308,11308,,8,1,0,1
11309,11309,,31,0,11,11
11310,11310,,31,3,7,10
11311,11311,,23,0,1,1
11312,11312,,23,8,7,15
11313,11313,,88,1,2,3
11314,11314,,23,0,1,1
11315,11315,,127,2,3,5
11316,11316,,8,2,2,4
11317,11317,,8,0,5,5
11318,11318,,8,2,2,4
11319,11319,,8,6,1,7
11320,11320,,111,4,16,20
11321,11321,,127,2,4,6
11322,11322,,14,7,10,17
11323,11323,,14,1,4,5
11324,11324,,18,1,0,1
11325,11325,,105,1,4,5
11326,11326,,8,1,0,1
11327,11327,,111,0,5,5
11328,11328,,111,22,21,43
11329,11329,,111,7,2,9
11330,11330,,8,4,4,8
11331,11331,,64,1,2,3
11332,11332,,64,1,0,1
11333,11333,,8,4,0,4
11334,11334,,23,0,1,1
11335,11335,,111,1,0,1
11336,11336,,23,1,1,2
11337,11337,,23,1,0,1
11338,11338,,43,0,1,1
11339,11339,,23,6,7,13
11340,11340,,23,2,0,2
11341,11341,,23,1,0,1
11342,11342,,11,2,3,5
11343,11343,,8,14,3,17
11344,11344,,52,1,3,4
11345,11345,,15,5,3,8
11346,11346,,18,5,6,11
11347,11347,,111,0,1,1
11348,11348,,31,0,1,1
11349,11349,,23,10,2,12
11350,11350,,15,0,1,1
11351,11351,,15,8,2,10
11352,11352,,43,11,3,14
11353,11353,,11,0,1,1
11354,11354,,15,1,0,1
11355,11355,,15,0,6,6
11356,11356,,105,2,2,4
11357,11357,,43,1,3,4
11358,11358,,8,2,3,5
11359,11359,,18,0,1,1
11360,11360,,15,0,1,1
11361,11361,,21,4,8,12
11362,11362,,23,2,1,3
11363,11363,,127,0,1,1
11364,11364,,8,7,8,15
11365,11365,,8,1,0,1
11366,11366,,6,2,8,10
11367,11367,,52,3,0,3
11368,11368,,23,7,1,8
11369,11369,,0,10,12,22
11370,11370,,18,0,1,1
11371,11371,,0,1,0,1
11372,11372,,15,3,3,6
11373,11373,,15,1,3,4
11374,11374,,52,1,0,1
11375,11375,,52,0,1,1
11376,11376,,21,0,4,4
11377,11377,,18,1,2,3
11378,11378,,5,4,1,5
11379,11379,,11,9,2,11
11380,11380,,15,6,1,7
11381,11381,,45,0,2,2
11382,11382,,23,1,0,1
11383,11383,,8,2,0,2
11384,11384,,21,1,5,6
11385,11385,,21,1,2,3
11386,11386,,111,10,10,20
11387,11387,,23,3,2,5
11388,11388,,127,0,1,1
11389,11389,,23,6,9,15
11390,11390,,6,2,4,6
11391,11391,,0,0,1,1
11392,11392,,43,3,2,5
11393,11393,,105,1,1,2
11394,11394,,88,6,15,21
11395,11395,,23,2,2,4
11396,11396,,52,1,0,1
11397,11397,,14,0,1,1
11398,11398,,14,0,1,1
11399,11399,,43,27,27,54
11400,11400,,43,1,2,3
11401,11401,,14,3,0,3
11402,11402,,14,3,3,6
11403,11403,,127,6,2,8
11404,11404,,21,0,2,2
11405,11405,,52,1,0,1
11406,11406,,23,6,7,13
11407,11407,,0,1,3,4
11408,11408,,23,4,5,9
11409,11409,,3,1,3,4
11410,11410,,23,1,0,1
11411,11411,,3,3,2,5
11412,11412,,5,0,1,1
11413,11413,,5,2,0,2
11414,11414,,8,1,0,1
11415,11415,,8,0,2,2
11416,11416,,8,6,2,8
11417,11417,,8,1,1,2
11418,11418,,8,1,1,2
11419,11419,,45,1,1,2
11420,11420,,45,4,3,7
11421,11421,,23,2,12,14
11422,11422,,23,2,4,6
11423,11423,,3,2,0,2
11424,11424,,3,0,1,1
11425,11425,,52,2,2,4
11426,11426,,23,1,1,2
11427,11427,,6,3,5,8
11428,11428,,105,0,3,3
11429,11429,,120,1,0,1
11430,11430,,23,1,0,1
11431,11431,,23,1,1,2
11432,11432,,23,1,0,1
11433,11433,,15,0,1,1
11434,11434,,111,1,0,1
11435,11435,,8,10,4,14
11436,11436,,23,7,4,11
11437,11437,,14,1,1,2
11438,11438,,88,6,4,10
11439,11439,,8,2,1,3
11440,11440,,23,2,14,16
11441,11441,,8,5,5,10
11442,11442,,45,12,10,22
11443,11443,,45,5,9,14
11444,11444,,23,8,15,23
11445,11445,,111,3,2,5
11446,11446,,111,0,2,2
11447,11447,,23,2,0,2
11448,11448,,31,7,0,7
11449,11449,,23,1,1,2
11450,11450,,3,0,2,2
11451,11451,,88,0,6,6
11452,11452,,23,1,0,1
11453,11453,,15,1,0,1
11454,11454,,45,0,1,1
11455,11455,,23,0,1,1
11456,11456,,105,0,1,1
11457,11457,,15,0,1,1
11458,11458,,43,0,1,1
11459,11459,,23,1,0,1
11460,11460,,105,1,1,2
11461,11461,,8,4,6,10
11462,11462,,111,0,5,5
11463,11463,,111,2,4,6
11464,11464,,111,1,1,2
11465,11465,,65,0,1,1
11466,11466,,65,1,0,1
11467,11467,,8,0,1,1
11468,11468,,76,2,5,7
11469,11469,,8,0,1,1
11470,11470,,23,1,1,2
11471,11471,,23,3,0,3
11472,11472,,8,0,2,2
11473,11473,,14,4,3,7
11474,11474,,23,0,1,1
11475,11475,,23,2,10,12
11476,11476,,23,3,1,4
11477,11477,,194,0,1,1
11478,11478,,23,1,1,2
11479,11479,,88,1,2,3
11480,11480,,88,9,3,12
11481,11481,,23,0,2,2
11482,11482,,0,0,1,1
11483,11483,,8,3,3,6
11484,11484,,23,1,5,6
11485,11485,,8,16,5,21
11486,11486,,8,3,3,6
11487,11487,,23,0,2,2
11488,11488,,105,4,3,7
11489,11489,,8,0,1,1
11490,11490,,52,2,4,6
11491,11491,,52,4,0,4
11492,11492,,23,1,2,3
11493,11493,,11,0,3,3
11494,11494,,111,2,2,4
11495,11495,,23,1,1,2
11496,11496,,8,2,5,7
11497,11497,,8,1,0,1
11498,11498,,127,1,0,1
11499,11499,,11,1,2,3
11500,11500,,6,4,1,5
11501,11501,,43,9,25,34
11502,11502,,14,4,4,8
11503,11503,,23,1,0,1
11504,11504,,21,0,4,4
11505,11505,,15,5,2,7
11506,11506,,23,4,0,4
11507,11507,,23,0,3,3
11508,11508,,0,6,4,10
11509,11509,,0,2,1,3
11510,11510,,0,3,3,6
11511,11511,,8,0,1,1
11512,11512,,14,3,1,4
11513,11513,,21,0,4,4
11514,11514,,21,0,1,1
11515,11515,,5,8,6,14
11516,11516,,23,3,6,9
11517,11517,,23,2,4,6
11518,11518,,45,1,3,4
11519,11519,,105,2,0,2
11520,11520,,14,0,3,3
11521,11521,,14,8,4,12
11522,11522,,43,6,7,13
11523,11523,,66,1,0,1
11524,11524,,23,1,1,2
11525,11525,,3,2,3,5
11526,11526,,23,1,0,1
11527,11527,,127,5,2,7
11528,11528,,127,4,6,10
11529,11529,,21,4,8,12
11530,11530,,66,1,0,1
11531,11531,,127,1,1,2
11532,11532,,11,1,2,3
11533,11533,,127,1,3,4
11534,11534,,31,0,5,5
11535,11535,,24,2,1,3
11536,11536,,31,0,2,2
11537,11537,,31,3,0,3
11538,11538,,31,0,2,2
11539,11539,,23,1,0,1
11540,11540,,8,3,1,4
11541,11541,,45,1,1,2
11542,11542,,8,2,1,3
11543,11543,,23,1,1,2
11544,11544,,111,0,1,1
11545,11545,,111,4,3,7
11546,11546,,23,33,32,65
11547,11547,,18,1,0,1
11548,11548,,15,2,4,6
11549,11549,,31,1,0,1
11550,11550,,31,1,0,1
11551,11551,,23,1,1,2
11552,11552,,120,2,2,4
11553,11553,,120,0,1,1
11554,11554,,14,6,2,8
11555,11555,,8,0,2,2
11556,11556,,8,1,3,4
11557,11557,,127,11,9,20
11558,11558,,8,1,1,2
11559,11559,,8,2,2,4
11560,11560,,127,1,1,2
11561,11561,,23,3,2,5
11562,11562,,127,2,0,2
11563,11563,,23,3,4,7
11564,11564,,52,1,1,2
11565,11565,,15,7,0,7
11566,11566,,23,1,1,2
11567,11567,,31,4,2,6
11568,11568,,23,2,6,8
11569,11569,,8,0,5,5
11570,11570,,23,2,0,2
11571,11571,,23,1,0,1
11572,11572,,14,1,1,2
11573,11573,,15,1,0,1
11574,11574,,15,1,0,1
11575,11575,,76,0,4,4
11576,11576,,76,0,4,4
11577,11577,,23,2,4,6
11578,11578,,23,5,7,12
11579,11579,,0,0,4,4
11580,11580,,23,0,3,3
11581,11581,,23,4,0,4
11582,11582,,23,1,1,2
11583,11583,,76,1,1,2
11584,11584,,127,0,1,1
11585,11585,,15,2,1,3
11586,11586,,8,2,2,4
11587,11587,,8,0,1,1
11588,11588,,23,1,0,1
11589,11589,,3,0,1,1
11590,11590,,23,1,0,1
11591,11591,,88,13,3,16
11592,11592,,88,1,0,1
11593,11593,,3,1,5,6
11594,11594,,15,0,1,1
11595,11595,,23,17,18,35
11596,11596,,23,0,1,1
11597,11597,,127,2,0,2
11598,11598,,8,3,1,4
11599,11599,,23,0,1,1
11600,11600,,8,0,1,1
11601,11601,,66,4,6,10
11602,11602,,66,5,0,5
11603,11603,,66,0,1,1
11604,11604,,43,2,7,9
11605,11605,,11,0,1,1
11606,11606,,127,0,1,1
11607,11607,,15,5,0,5
11608,11608,,15,3,0,3
11609,11609,,23,3,2,5
11610,11610,,23,0,1,1
11611,11611,,88,3,0,3
11612,11612,,8,1,4,5
11613,11613,,8,4,0,4
11614,11614,,8,2,6,8
11615,11615,,8,4,1,5
11616,11616,,0,1,0,1
11617,11617,,23,2,3,5
11618,11618,,21,1,2,3
11619,11619,,67,0,3,3
11620,11620,,67,2,0,2
11621,11621,,8,1,1,2
11622,11622,,23,2,4,6
11623,11623,,68,0,1,1
11624,11624,,68,1,0,1
11625,11625,,5,12,22,34
11626,11626,,5,2,0,2
11627,11627,,14,2,0,2
11628,11628,,45,3,0,3
11629,11629,,45,1,1,2
11630,11630,,45,5,4,9
11631,11631,,8,2,0,2
11632,11632,,43,1,3,4
11633,11633,,21,2,1,3
11634,11634,,43,1,4,5
11635,11635,,127,3,0,3
11636,11636,,14,1,4,5
11637,11637,,52,2,3,5
11638,11638,,52,8,8,16
11639,11639,,5,2,1,3
11640,11640,,23,1,0,1
11641,11641,,105,2,0,2
11642,11642,,5,2,2,4
11643,11643,,88,2,5,7
11644,11644,,88,3,5,8
11645,11645,,5,0,4,4
11646,11646,,52,1,2,3
11647,11647,,21,3,0,3
11648,11648,,43,4,8,12
11649,11649,,0,2,1,3
11650,11650,,0,1,1,2
11651,11651,,66,2,0,2
11652,11652,,21,1,0,1
11653,11653,,88,1,1,2
11654,11654,,3,0,1,1
11655,11655,,43,0,1,1
11656,11656,,24,0,2,2
11657,11657,,23,4,1,5
11658,11658,,11,8,13,21
11659,11659,,11,1,1,2
11660,11660,,45,1,2,3
11661,11661,,45,0,2,2
11662,11662,,45,1,0,1
11663,11663,,8,1,0,1
11664,11664,,14,13,24,37
11665,11665,,111,1,2,3
11666,11666,,52,3,3,6
11667,11667,,15,3,3,6
11668,11668,,8,1,2,3
11669,11669,,88,1,0,1
11670,11670,,6,7,15,22
11671,11671,,14,1,1,2
11672,11672,,127,0,2,2
11673,11673,,14,0,1,1
11674,11674,,8,3,3,6
11675,11675,,8,2,0,2
11676,11676,,8,0,4,4
11677,11677,,88,0,1,1
11678,11678,,23,5,0,5
11679,11679,,8,1,1,2
11680,11680,,8,2,1,3
11681,11681,,127,0,2,2
11682,11682,,15,0,2,2
11683,11683,,8,0,2,2
11684,11684,,111,1,4,5
11685,11685,,111,1,1,2
11686,11686,,23,1,1,2
11687,11687,,15,1,1,2
11688,11688,,15,2,1,3
11689,11689,,18,4,2,6
11690,11690,,111,0,1,1
11691,11691,,23,2,2,4
11692,11692,,8,1,9,10
11693,11693,,31,0,1,1
11694,11694,,31,1,1,2
11695,11695,,127,0,1,1
11696,11696,,31,6,4,10
11697,11697,,43,6,2,8
11698,11698,,23,1,0,1
11699,11699,,23,2,2,4
11700,11700,,8,24,2,26
11701,11701,,14,0,2,2
11702,11702,,23,3,7,10
11703,11703,,88,4,1,5
11704,11704,,23,0,1,1
11705,11705,,11,8,16,24
11706,11706,,21,4,0,4
11707,11707,,23,10,6,16
11708,11708,,111,0,2,2
11709,11709,,111,1,0,1
11710,11710,,15,1,0,1
11711,11711,,15,4,5,9
11712,11712,,15,0,1,1
11713,11713,,11,5,3,8
11714,11714,,69,0,1,1
11715,11715,,69,1,0,1
11716,11716,,23,8,13,21
11717,11717,,62,1,0,1
11718,11718,,14,0,4,4
11719,11719,,15,11,6,17
11720,11720,,18,3,5,8
11721,11721,,88,6,9,15
11722,11722,,52,0,1,1
11723,11723,,52,3,5,8
11724,11724,,52,1,2,3
11725,11725,,23,1,0,1
11726,11726,,23,2,6,8
11727,11727,,127,1,2,3
11728,11728,,18,2,1,3
11729,11729,,18,1,0,1
11730,11730,,0,1,0,1
11731,11731,,23,1,4,5
11732,11732,,52,5,2,7
11733,11733,,52,2,3,5
11734,11734,,23,0,1,1
11735,11735,,23,9,5,14
11736,11736,,5,0,2,2
11737,11737,,23,0,1,1
11738,11738,,23,1,0,1
11739,11739,,23,0,1,1
11740,11740,,23,0,1,1
11741,11741,,43,0,4,4
11742,11742,,43,0,1,1
11743,11743,,23,2,0,2
11744,11744,,21,3,1,4
11745,11745,,0,4,1,5
11746,11746,,43,1,0,1
11747,11747,,0,1,0,1
11748,11748,,0,1,0,1
11749,11749,,24,3,4,7
11750,11750,,23,2,4,6
11751,11751,,14,1,1,2
11752,11752,,21,0,1,1
11753,11753,,88,4,4,8
11754,11754,,105,0,1,1
11755,11755,,5,4,23,27
11756,11756,,23,7,5,12
11757,11757,,43,1,0,1
11758,11758,,43,0,3,3
11759,11759,,52,2,8,10
11760,11760,,70,0,1,1
11761,11761,,70,1,0,1
11762,11762,,43,2,0,2
11763,11763,,14,2,1,3
11764,11764,,8,0,1,1
11765,11765,,23,3,4,7
11766,11766,,23,1,1,2
11767,11767,,23,3,0,3
11768,11768,,0,0,2,2
11769,11769,,8,2,2,4
11770,11770,,23,0,1,1
11771,11771,,21,1,19,20
11772,11772,,21,1,0,1
11773,11773,,21,3,3,6
11774,11774,,8,3,3,6
11775,11775,,127,2,4,6
11776,11776,,14,0,2,2
11777,11777,,14,1,0,1
11778,11778,,14,2,4,6
11779,11779,,88,6,0,6
11780,11780,,21,3,13,16
11781,11781,,23,2,0,2
11782,11782,,11,1,1,2
11783,11783,,8,4,0,4
11784,11784,,8,0,1,1
11785,11785,,71,0,1,1
11786,11786,,71,1,0,1
11787,11787,,8,0,2,2
11788,11788,,8,2,1,3
11789,11789,,23,1,2,3
11790,11790,,8,5,1,6
11791,11791,,111,1,6,7
11792,11792,,76,2,7,9
11793,11793,,6,8,19,27
11794,11794,,23,4,4,8
11795,11795,,23,1,4,5
11796,11796,,8,3,0,3
11797,11797,,21,2,7,9
11798,11798,,23,2,2,4
11799,11799,,76,0,2,2
11800,11800,,8,1,2,3
11801,11801,,23,3,4,7
11802,11802,,18,0,2,2
11803,11803,,8,1,0,1
11804,11804,,8,4,3,7
11805,11805,,23,1,1,2
11806,11806,,23,3,3,6
11807,11807,,11,1,0,1
11808,11808,,11,2,8,10
11809,11809,,111,4,4,8
11810,11810,,127,1,0,1
11811,11811,,127,3,6,9
11812,11812,,88,2,7,9
11813,11813,,3,1,1,2
11814,11814,,15,0,1,1
11815,11815,,31,3,8,11
11816,11816,,31,0,1,1
11817,11817,,6,20,16,36
11818,11818,,8,3,10,13
11819,11819,,8,0,2,2
11820,11820,,23,7,5,12
11821,11821,,111,2,0,2
11822,11822,,5,1,0,1
11823,11823,,23,1,1,2
11824,11824,,105,0,3,3
11825,11825,,111,4,12,16
11826,11826,,23,1,2,3
11827,11827,,120,7,1,8
11828,11828,,111,2,3,5
11829,11829,,31,1,1,2
11830,11830,,15,2,0,2
11831,11831,,15,0,1,1
11832,11832,,23,0,1,1
11833,11833,,23,1,0,1
11834,11834,,23,0,2,2
11835,11835,,127,0,3,3
11836,11836,,52,1,3,4
11837,11837,,14,2,3,5
11838,11838,,43,3,6,9
11839,11839,,23,2,1,3
11840,11840,,11,6,0,6
11841,11841,,8,1,2,3
11842,11842,,127,0,1,1
11843,11843,,127,3,0,3
11844,11844,,23,3,13,16
11845,11845,,23,6,6,12
11846,11846,,8,0,2,2
11847,11847,,45,1,3,4
11848,11848,,23,0,1,1
11849,11849,,24,11,15,26
11850,11850,,43,0,3,3
11851,11851,,43,0,1,1
11852,11852,,105,4,2,6
11853,11853,,43,5,5,10
11854,11854,,43,4,5,9
11855,11855,,31,3,5,8
11856,11856,,14,5,0,5
11857,11857,,8,2,0,2
11858,11858,,88,0,2,2
11859,11859,,88,3,0,3
11860,11860,,18,5,3,8
11861,11861,,21,4,10,14
11862,11862,,43,0,1,1
11863,11863,,23,0,1,1
11864,11864,,23,0,1,1
11865,11865,,23,0,1,1
11866,11866,,8,0,1,1
11867,11867,,111,0,1,1
11868,11868,,66,1,0,1
11869,11869,,21,1,0,1
11870,11870,,21,0,1,1
11871,11871,,21,0,1,1
11872,11872,,23,1,1,2
11873,11873,,21,1,4,5
11874,11874,,8,1,4,5
11875,11875,,31,0,4,4
11876,11876,,31,0,1,1
11877,11877,,45,0,1,1
11878,11878,,11,1,1,2
11879,11879,,15,0,1,1
11880,11880,,72,0,1,1
11881,11881,,72,1,0,1
11882,11882,,23,2,2,4
11883,11883,,73,1,1,2
11884,11884,,73,1,1,2
11885,11885,,23,1,0,1
11886,11886,,0,2,0,2
11887,11887,,31,0,3,3
11888,11888,,43,4,11,15
11889,11889,,0,3,4,7
11890,11890,,3,0,5,5
11891,11891,,5,0,3,3
11892,11892,,5,4,4,8
11893,11893,,8,1,1,2
11894,11894,,127,3,2,5
11895,11895,,76,2,10,12
11896,11896,,120,2,2,4
11897,11897,,11,1,1,2
11898,11898,,31,2,0,2
11899,11899,,23,0,2,2
11900,11900,,23,6,13,19
11901,11901,,105,2,2,4
11902,11902,,111,5,15,20
11903,11903,,8,0,1,1
11904,11904,,23,0,1,1
11905,11905,,23,1,8,9
11906,11906,,105,0,1,1
11907,11907,,15,4,5,9
11908,11908,,52,3,4,7
11909,11909,,15,0,1,1
11910,11910,,8,1,10,11
11911,11911,,11,0,2,2
11912,11912,,8,2,2,4
11913,11913,,8,1,4,5
11914,11914,,8,6,4,10
11915,11915,,23,9,9,18
11916,11916,,88,5,2,7
11917,11917,,8,0,1,1
11918,11918,,23,1,6,7
11919,11919,,43,1,0,1
11920,11920,,43,0,1,1
11921,11921,,127,1,7,8
11922,11922,,23,0,2,2
11923,11923,,105,1,1,2
11924,11924,,43,3,4,7
11925,11925,,21,1,4,5
11926,11926,,127,1,1,2
11927,11927,,24,0,1,1
11928,11928,,43,13,5,18
11929,11929,,127,1,0,1
11930,11930,,21,1,1,2
11931,11931,,21,2,5,7
11932,11932,,23,0,1,1
11933,11933,,23,4,2,6
11934,11934,,66,3,0,3
11935,11935,,66,9,3,12
11936,11936,,8,2,3,5
11937,11937,,11,1,0,1
11938,11938,,23,0,1,1
11939,11939,,23,0,5,5
11940,11940,,3,2,3,5
11941,11941,,8,1,1,2
11942,11942,,6,0,1,1
11943,11943,,76,1,0,1
11944,11944,,15,0,2,2
11945,11945,,15,3,0,3
11946,11946,,45,7,16,23
11947,11947,,23,1,3,4
11948,11948,,0,1,2,3
11949,11949,,0,0,1,1
11950,11950,,88,1,5,6
11951,11951,,0,2,2,4
11952,11952,,52,0,1,1
11953,11953,,15,1,0,1
11954,11954,,52,0,3,3
11955,11955,,23,1,0,1
11956,11956,,23,3,5,8
11957,11957,,24,1,0,1
11958,11958,,23,1,0,1
11959,11959,,8,1,1,2
11960,11960,,14,1,4,5
11961,11961,,45,1,0,1
11962,11962,,31,0,1,1
11963,11963,,8,2,4,6
11964,11964,,43,0,9,9
11965,11965,,43,0,4,4
11966,11966,,43,5,6,11
11967,11967,,43,2,5,7
11968,11968,,8,1,1,2
11969,11969,,14,2,3,5
11970,11970,,8,0,2,2
11971,11971,,111,1,3,4
11972,11972,,24,1,0,1
11973,11973,,14,1,1,2
11974,11974,,8,1,0,1
11975,11975,,23,1,2,3
11976,11976,,14,2,1,3
11977,11977,,21,1,2,3
11978,11978,,21,1,2,3
11979,11979,,0,2,2,4
11980,11980,,66,3,0,3
11981,11981,,21,1,0,1
11982,11982,,23,1,0,1
11983,11983,,105,2,3,5
11984,11984,,76,4,3,7
11985,11985,,14,1,0,1
11986,11986,,23,0,2,2
11987,11987,,105,2,3,5
11988,11988,,21,8,12,20
11989,11989,,31,0,3,3
11990,11990,,31,0,2,2
11991,11991,,8,1,0,1
11992,11992,,45,4,1,5
11993,11993,,14,7,12,19
11994,11994,,6,1,1,2
11995,11995,,23,7,0,7
11996,11996,,11,2,2,4
11997,11997,,23,9,8,17
11998,11998,,23,0,1,1
11999,11999,,31,1,1,2
12000,12000,,31,2,2,4
12001,12001,,127,0,2,2
12002,12002,,0,0,1,1
12003,12003,,0,0,4,4
12004,12004,,105,0,2,2
12005,12005,,127,1,0,1
12006,12006,,8,2,1,3
12007,12007,,14,1,1,2
12008,12008,,23,0,1,1
12009,12009,,14,2,0,2
12010,12010,,8,1,1,2
12011,12011,,14,1,3,4
12012,12012,,23,1,2,3
12013,12013,,194,1,2,3
12014,12014,,23,13,13,26
12015,12015,,23,0,1,1
12016,12016,,8,2,2,4
12017,12017,,8,0,1,1
12018,12018,,8,2,3,5
12019,12019,,45,1,0,1
12020,12020,,23,3,2,5
12021,12021,,23,1,1,2
12022,12022,,23,1,1,2
12023,12023,,15,0,1,1
12024,12024,,15,0,1,1
12025,12025,,15,3,5,8
12026,12026,,18,3,1,4
12027,12027,,23,1,1,2
12028,12028,,18,1,0,1
12029,12029,,127,0,3,3
12030,12030,,127,3,2,5
12031,12031,,8,1,1,2
12032,12032,,45,8,1,9
12033,12033,,45,7,0,7
12034,12034,,45,0,1,1
12035,12035,,45,8,5,13
12036,12036,,111,0,2,2
12037,12037,,111,1,2,3
12038,12038,,21,0,1,1
12039,12039,,15,1,1,2
12040,12040,,11,1,1,2
12041,12041,,88,5,21,26
12042,12042,,45,4,4,8
12043,12043,,8,4,10,14
12044,12044,,0,7,0,7
12045,12045,,111,13,12,25
12046,12046,,8,0,1,1
12047,12047,,14,2,1,3
12048,12048,,14,1,1,2
12049,12049,,8,8,2,10
12050,12050,,31,1,0,1
12051,12051,,88,5,0,5
12052,12052,,23,26,38,64
12053,12053,,24,2,3,5
12054,12054,,111,1,0,1
12055,12055,,0,0,1,1
12056,12056,,15,2,0,2
12057,12057,,15,1,0,1
12058,12058,,11,2,1,3
12059,12059,,23,2,0,2
12060,12060,,23,1,1,2
12061,12061,,0,4,6,10
12062,12062,,23,2,0,2
12063,12063,,52,5,9,14
12064,12064,,23,1,1,2
12065,12065,,23,3,0,3
12066,12066,,18,3,2,5
12067,12067,,11,1,3,4
12068,12068,,23,5,5,10
12069,12069,,8,0,3,3
12070,12070,,23,2,3,5
12071,12071,,3,1,1,2
12072,12072,,88,10,12,22
12073,12073,,0,22,1,23
12074,12074,,0,11,2,13
12075,12075,,0,1,2,3
12076,12076,,23,2,1,3
12077,12077,,88,2,12,14
12078,12078,,11,3,10,13
12079,12079,,8,0,2,2
12080,12080,,43,0,1,1
12081,12081,,5,1,2,3
12082,12082,,23,0,1,1
12083,12083,,8,2,1,3
12084,12084,,8,1,1,2
12085,12085,,14,3,10,13
12086,12086,,21,3,4,7
12087,12087,,88,1,4,5
12088,12088,,14,4,1,5
12089,12089,,15,5,5,10
12090,12090,,43,1,0,1
12091,12091,,45,3,3,6
12092,12092,,43,0,2,2
12093,12093,,8,3,2,5
12094,12094,,23,11,11,22
12095,12095,,76,0,4,4
12096,12096,,23,1,0,1
12097,12097,,21,0,2,2
12098,12098,,66,3,0,3
12099,12099,,21,221,95,316
12100,12100,,66,2,0,2
12101,12101,,88,3,5,8
12102,12102,,21,0,4,4
12103,12103,,11,4,3,7
12104,12104,,24,1,1,2
12105,12105,,11,1,1,2
12106,12106,,24,3,6,9
12107,12107,,45,6,1,7
12108,12108,,45,1,1,2
12109,12109,,45,1,0,1
12110,12110,,31,4,2,6
12111,12111,,3,0,1,1
12112,12112,,23,1,0,1
12113,12113,,23,4,3,7
12114,12114,,76,0,1,1
12115,12115,,111,5,4,9
12116,12116,,120,1,0,1
12117,12117,,15,3,4,7
12118,12118,,23,1,2,3
12119,12119,,23,2,7,9
12120,12120,,3,7,2,9
12121,12121,,23,0,1,1
12122,12122,,31,0,2,2
12123,12123,,23,52,8,60
12124,12124,,23,16,22,38
12125,12125,,45,1,0,1
12126,12126,,23,4,2,6
12127,12127,,15,4,5,9
12128,12128,,88,5,3,8
12129,12129,,23,0,1,1
12130,12130,,8,1,0,1
12131,12131,,52,6,12,18
12132,12132,,88,0,2,2
12133,12133,,88,2,0,2
12134,12134,,23,1,0,1
12135,12135,,45,5,2,7
12136,12136,,127,1,2,3
12137,12137,,23,2,1,3
12138,12138,,23,1,9,10
12139,12139,,127,1,0,1
12140,12140,,23,8,5,13
12141,12141,,8,9,9,18
12142,12142,,23,0,1,1
12143,12143,,8,1,4,5
12144,12144,,8,3,1,4
12145,12145,,23,7,6,13
12146,12146,,8,1,2,3
12147,12147,,23,11,1,12
12148,12148,,74,1,1,2
12149,12149,,74,1,1,2
12150,12150,,11,2,1,3
12151,12151,,23,0,1,1
12152,12152,,11,1,4,5
12153,12153,,23,0,1,1
12154,12154,,23,10,3,13
12155,12155,,23,40,63,103
12156,12156,,15,2,2,4
12157,12157,,23,3,1,4
12158,12158,,11,12,19,31
12159,12159,,45,1,0,1
12160,12160,,111,1,5,6
12161,12161,,15,6,7,13
12162,12162,,21,3,2,5
12163,12163,,24,1,2,3
12164,12164,,23,1,0,1
12165,12165,,11,1,3,4
12166,12166,,52,0,1,1
12167,12167,,23,1,3,4
12168,12168,,23,2,2,4
12169,12169,,75,1,1,2
12170,12170,,75,1,1,2
12171,12171,,11,0,1,1
12172,12172,,8,0,1,1
12173,12173,,127,2,2,4
12174,12174,,8,0,1,1
12175,12175,,8,1,6,7
12176,12176,,111,1,0,1
12177,12177,,52,3,2,5
12178,12178,,23,3,2,5
12179,12179,,45,0,1,1
12180,12180,,8,5,0,5
12181,12181,,23,1,1,2
12182,12182,,127,1,2,3
12183,12183,,127,1,0,1
12184,12184,,0,4,8,12
12185,12185,,15,1,0,1
12186,12186,,8,0,1,1
12187,12187,,31,2,0,2
12188,12188,,43,0,1,1
12189,12189,,23,1,1,2
12190,12190,,21,2,3,5
12191,12191,,23,3,1,4
12192,12192,,31,1,0,1
12193,12193,,21,2,8,10
12194,12194,,23,2,2,4
12195,12195,,0,0,2,2
12196,12196,,15,1,3,4
12197,12197,,127,0,1,1
12198,12198,,127,3,2,5
12199,12199,,3,1,2,3
12200,12200,,45,1,1,2
12201,12201,,76,1,9,10
12202,12202,,76,3,0,3
12203,12203,,52,5,4,9
12204,12204,,14,2,2,4
12205,12205,,52,0,8,8
12206,12206,,127,0,2,2
12207,12207,,88,2,4,6
12208,12208,,88,5,2,7
12209,12209,,88,11,14,25
12210,12210,,3,18,25,43
12211,12211,,43,1,0,1
12212,12212,,3,5,0,5
12213,12213,,23,13,13,26
12214,12214,,21,1,4,5
12215,12215,,43,0,2,2
12216,12216,,127,3,3,6
12217,12217,,43,1,2,3
12218,12218,,23,1,1,2
12219,12219,,23,0,1,1
12220,12220,,43,4,8,12
12221,12221,,21,2,1,3
12222,12222,,43,0,1,1
12223,12223,,21,2,2,4
12224,12224,,21,4,3,7
12225,12225,,3,1,2,3
12226,12226,,127,1,0,1
12227,12227,,23,6,5,11
12228,12228,,11,0,1,1
12229,12229,,23,1,1,2
12230,12230,,31,1,1,2
12231,12231,,45,6,5,11
12232,12232,,43,0,4,4
12233,12233,,8,1,1,2
12234,12234,,8,1,0,1
12235,12235,,23,1,2,3
12236,12236,,11,0,2,2
12237,12237,,11,0,1,1
12238,12238,,23,3,1,4
12239,12239,,21,0,1,1
12240,12240,,45,2,2,4
12241,12241,,45,1,0,1
12242,12242,,77,0,1,1
12243,12243,,77,1,0,1
12244,12244,,105,4,2,6
12245,12245,,111,2,6,8
12246,12246,,111,9,0,9
12247,12247,,23,2,3,5
12248,12248,,8,3,3,6
12249,12249,,127,0,1,1
12250,12250,,8,1,1,2
12251,12251,,8,0,1,1
12252,12252,,8,1,0,1
12253,12253,,88,4,3,7
12254,12254,,45,0,2,2
12255,12255,,23,1,0,1
12256,12256,,23,1,4,5
12257,12257,,23,0,2,2
12258,12258,,23,1,0,1
12259,12259,,31,10,9,19
12260,12260,,0,2,4,6
12261,12261,,23,1,0,1
12262,12262,,31,34,45,79
12263,12263,,127,5,0,5
12264,12264,,31,3,0,3
12265,12265,,127,1,0,1
12266,12266,,111,1,2,3
12267,12267,,15,5,14,19
12268,12268,,23,2,3,5
12269,12269,,23,0,2,2
12270,12270,,45,0,6,6
12271,12271,,76,1,1,2
12272,12272,,127,0,1,1
12273,12273,,0,0,2,2
12274,12274,,23,1,2,3
12275,12275,,23,1,0,1
12276,12276,,45,0,1,1
12277,12277,,8,1,1,2
12278,12278,,23,1,0,1
12279,12279,,8,1,0,1
12280,12280,,23,0,1,1
12281,12281,,52,2,1,3
12282,12282,,5,3,2,5
12283,12283,,11,1,5,6
12284,12284,,8,1,2,3
12285,12285,,111,0,5,5
12286,12286,,111,1,0,1
12287,12287,,66,1,2,3
12288,12288,,8,0,1,1
12289,12289,,127,0,1,1
12290,12290,,127,1,0,1
12291,12291,,15,2,1,3
12292,12292,,11,2,5,7
12293,12293,,43,1,0,1
12294,12294,,18,2,4,6
12295,12295,,23,0,2,2
12296,12296,,88,1,1,2
12297,12297,,15,2,2,4
12298,12298,,8,0,3,3
12299,12299,,66,6,7,13
12300,12300,,52,0,3,3
12301,12301,,11,0,2,2
12302,12302,,21,6,3,9
12303,12303,,88,2,0,2
12304,12304,,88,1,1,2
12305,12305,,23,2,3,5
12306,12306,,23,1,2,3
12307,12307,,31,4,0,4
12308,12308,,31,3,0,3
12309,12309,,23,1,0,1
12310,12310,,23,1,0,1
12311,12311,,23,1,2,3
12312,12312,,23,7,7,14
12313,12313,,0,1,3,4
12314,12314,,23,0,1,1
12315,12315,,23,5,6,11
12316,12316,,23,6,6,12
12317,12317,,31,1,2,3
12318,12318,,78,0,1,1
12319,12319,,78,1,0,1
12320,12320,,43,2,1,3
12321,12321,,43,6,3,9
12322,12322,,43,3,4,7
12323,12323,,43,0,3,3
12324,12324,,23,0,2,2
12325,12325,,8,1,3,4
12326,12326,,8,2,0,2
12327,12327,,120,1,0,1
12328,12328,,79,2,3,5
12329,12329,,79,2,2,4
12330,12330,,105,1,1,2
12331,12331,,5,2,2,4
12332,12332,,3,2,0,2
12333,12333,,23,0,3,3
12334,12334,,8,0,2,2
12335,12335,,23,1,1,2
12336,12336,,76,4,12,16
12337,12337,,80,0,1,1
12338,12338,,80,1,0,1
12339,12339,,3,21,15,36
12340,12340,,3,1,1,2
12341,12341,,3,0,1,1
12342,12342,,3,2,0,2
12343,12343,,21,1,0,1
12344,12344,,6,3,2,5
12345,12345,,11,0,2,2
12346,12346,,3,0,1,1
12347,12347,,8,1,1,2
12348,12348,,24,0,3,3
12349,12349,,24,4,2,6
12350,12350,,31,2,0,2
12351,12351,,11,2,0,2
12352,12352,,8,0,2,2
12353,12353,,8,1,0,1
12354,12354,,3,0,1,1
12355,12355,,14,6,6,12
12356,12356,,23,3,5,8
12357,12357,,3,1,0,1
12358,12358,,3,4,1,5
12359,12359,,23,4,3,7
12360,12360,,21,2,0,2
12361,12361,,111,0,1,1
12362,12362,,52,2,0,2
12363,12363,,23,0,1,1
12364,12364,,76,1,6,7
12365,12365,,120,1,0,1
12366,12366,,45,0,2,2
12367,12367,,8,1,5,6
12368,12368,,8,0,3,3
12369,12369,,88,1,0,1
12370,12370,,11,1,0,1
12371,12371,,18,0,4,4
12372,12372,,18,3,1,4
12373,12373,,111,4,3,7
12374,12374,,23,1,0,1
12375,12375,,23,0,1,1
12376,12376,,23,3,5,8
12377,12377,,52,2,3,5
12378,12378,,14,1,0,1
12379,12379,,23,0,1,1
12380,12380,,23,0,3,3
12381,12381,,14,0,2,2
12382,12382,,31,2,8,10
12383,12383,,8,0,2,2
12384,12384,,8,0,3,3
12385,12385,,8,1,2,3
12386,12386,,8,2,1,3
12387,12387,,23,3,2,5
12388,12388,,18,2,4,6
12389,12389,,23,0,2,2
12390,12390,,23,3,1,4
12391,12391,,8,5,3,8
12392,12392,,127,1,1,2
12393,12393,,43,7,3,10
12394,12394,,21,0,3,3
12395,12395,,8,1,0,1
12396,12396,,8,1,1,2
12397,12397,,24,1,0,1
12398,12398,,14,1,1,2
12399,12399,,127,2,0,2
12400,12400,,8,0,1,1
12401,12401,,8,1,0,1
12402,12402,,8,2,3,5
12403,12403,,23,0,2,2
12404,12404,,45,4,7,11
12405,12405,,0,2,0,2
12406,12406,,23,1,1,2
12407,12407,,0,1,2,3
12408,12408,,127,5,0,5
12409,12409,,8,1,0,1
12410,12410,,45,3,2,5
12411,12411,,45,1,0,1
12412,12412,,8,1,0,1
12413,12413,,15,9,2,11
12414,12414,,15,6,0,6
12415,12415,,23,1,1,2
12416,12416,,14,0,2,2
12417,12417,,23,14,30,44
12418,12418,,21,1,1,2
12419,12419,,21,1,2,3
12420,12420,,88,1,0,1
12421,12421,,3,2,2,4
12422,12422,,11,1,0,1
12423,12423,,8,0,1,1
12424,12424,,8,1,3,4
12425,12425,,8,5,1,6
12426,12426,,8,1,2,3
12427,12427,,14,1,0,1
12428,12428,,14,1,0,1
12429,12429,,43,5,6,11
12430,12430,,8,2,5,7
12431,12431,,127,2,2,4
12432,12432,,127,1,0,1
12433,12433,,0,0,1,1
12434,12434,,127,2,3,5
12435,12435,,88,1,2,3
12436,12436,,21,0,1,1
12437,12437,,105,0,1,1
12438,12438,,23,3,3,6
12439,12439,,127,0,1,1
12440,12440,,3,0,1,1
12441,12441,,105,1,0,1
12442,12442,,11,1,0,1
12443,12443,,43,2,4,6
12444,12444,,21,2,4,6
12445,12445,,23,5,0,5
12446,12446,,23,0,1,1
12447,12447,,76,2,6,8
12448,12448,,76,0,3,3
12449,12449,,43,2,2,4
12450,12450,,0,1,3,4
12451,12451,,21,2,2,4
12452,12452,,66,3,0,3
12453,12453,,8,3,7,10
12454,12454,,3,3,4,7
12455,12455,,3,1,1,2
12456,12456,,8,1,1,2
12457,12457,,31,0,2,2
12458,12458,,45,2,0,2
12459,12459,,8,2,6,8
12460,12460,,11,5,2,7
12461,12461,,8,1,0,1
12462,12462,,81,0,1,1
12463,12463,,81,1,0,1
12464,12464,,23,2,0,2
12465,12465,,31,3,3,6
12466,12466,,31,3,0,3
12467,12467,,21,12,4,16
12468,12468,,21,1,2,3
12469,12469,,23,0,1,1
12470,12470,,23,6,15,21
12471,12471,,5,1,0,1
12472,12472,,23,3,10,13
12473,12473,,127,1,2,3
12474,12474,,127,4,1,5
12475,12475,,8,1,1,2
12476,12476,,127,0,4,4
12477,12477,,127,1,4,5
12478,12478,,23,1,1,2
12479,12479,,23,0,1,1
12480,12480,,8,11,22,33
12481,12481,,23,6,0,6
12482,12482,,23,2,1,3
12483,12483,,105,1,1,2
12484,12484,,105,4,5,9
12485,12485,,105,1,1,2
12486,12486,,6,1,0,1
12487,12487,,127,1,4,5
12488,12488,,15,5,2,7
12489,12489,,8,0,1,1
12490,12490,,76,1,2,3
12491,12491,,105,6,1,7
12492,12492,,8,1,4,5
12493,12493,,8,1,0,1
12494,12494,,23,3,0,3
12495,12495,,43,1,0,1
12496,12496,,8,8,11,19
12497,12497,,43,0,1,1
12498,12498,,31,1,1,2
12499,12499,,0,1,1,2
12500,12500,,111,0,1,1
12501,12501,,15,2,2,4
12502,12502,,3,3,2,5
12503,12503,,23,5,1,6
12504,12504,,23,1,1,2
12505,12505,,15,0,1,1
12506,12506,,21,1,2,3
12507,12507,,88,2,1,3
12508,12508,,23,0,1,1
12509,12509,,0,4,3,7
12510,12510,,8,4,3,7
12511,12511,,18,1,1,2
12512,12512,,14,3,4,7
12513,12513,,8,1,0,1
12514,12514,,23,0,4,4
12515,12515,,23,2,0,2
12516,12516,,52,5,0,5
12517,12517,,45,0,1,1
12518,12518,,21,0,1,1
12519,12519,,0,0,2,2
12520,12520,,127,2,5,7
12521,12521,,23,1,0,1
12522,12522,,5,1,2,3
12523,12523,,43,4,3,7
12524,12524,,43,1,6,7
12525,12525,,43,1,0,1
12526,12526,,43,1,2,3
12527,12527,,43,1,2,3
12528,12528,,43,1,1,2
12529,12529,,23,6,13,19
12530,12530,,21,2,0,2
12531,12531,,14,0,1,1
12532,12532,,14,0,4,4
12533,12533,,43,1,5,6
12534,12534,,43,5,1,6
12535,12535,,23,1,0,1
12536,12536,,8,1,1,2
12537,12537,,23,0,1,1
12538,12538,,21,1,0,1
12539,12539,,21,13,8,21
12540,12540,,127,3,0,3
12541,12541,,8,0,2,2
12542,12542,,31,2,1,3
12543,12543,,120,8,8,16
12544,12544,,31,4,0,4
12545,12545,,8,0,1,1
12546,12546,,8,2,2,4
12547,12547,,8,1,1,2
12548,12548,,88,1,1,2
12549,12549,,3,4,0,4
12550,12550,,43,0,4,4
12551,12551,,3,0,1,1
12552,12552,,127,1,3,4
12553,12553,,3,0,1,1
12554,12554,,66,0,1,1
12555,12555,,23,4,5,9
12556,12556,,76,0,1,1
12557,12557,,3,4,4,8
12558,12558,,23,1,6,7
12559,12559,,23,1,0,1
12560,12560,,23,1,0,1
12561,12561,,14,1,5,6
12562,12562,,88,6,3,9
12563,12563,,6,0,1,1
12564,12564,,0,1,0,1
12565,12565,,23,1,1,2
12566,12566,,23,8,7,15
12567,12567,,43,1,6,7
12568,12568,,3,2,7,9
12569,12569,,43,0,3,3
12570,12570,,43,7,7,14
12571,12571,,43,1,0,1
12572,12572,,11,1,1,2
12573,12573,,88,4,1,5
12574,12574,,88,1,0,1
12575,12575,,24,0,2,2
12576,12576,,43,1,0,1
12577,12577,,52,1,0,1
12578,12578,,76,1,0,1
12579,12579,,23,2,0,2
12580,12580,,24,1,0,1
12581,12581,,23,2,0,2
12582,12582,,31,1,8,9
12583,12583,,127,1,0,1
12584,12584,,127,3,8,11
12585,12585,,127,9,4,13
12586,12586,,111,6,3,9
12587,12587,,111,1,5,6
12588,12588,,8,4,4,8
12589,12589,,127,0,4,4
12590,12590,,127,1,1,2
12591,12591,,11,1,2,3
12592,12592,,5,2,0,2
12593,12593,,3,0,2,2
12594,12594,,8,2,11,13
12595,12595,,111,3,2,5
12596,12596,,3,3,8,11
12597,12597,,8,2,3,5
12598,12598,,23,3,3,6
12599,12599,,23,3,2,5
12600,12600,,111,1,6,7
12601,12601,,111,1,0,1
12602,12602,,23,1,1,2
12603,12603,,0,1,0,1
12604,12604,,8,0,1,1
12605,12605,,21,1,2,3
12606,12606,,21,5,3,8
12607,12607,,0,1,2,3
12608,12608,,23,5,2,7
12609,12609,,8,0,3,3
12610,12610,,3,1,3,4
12611,12611,,52,0,1,1
12612,12612,,15,1,0,1
12613,12613,,14,1,5,6
12614,12614,,14,3,3,6
12615,12615,,23,0,5,5
12616,12616,,15,1,0,1
12617,12617,,0,1,0,1
12618,12618,,3,3,1,4
12619,12619,,0,0,1,1
12620,12620,,43,1,2,3
12621,12621,,23,1,1,2
12622,12622,,127,1,3,4
12623,12623,,23,1,1,2
12624,12624,,43,0,2,2
12625,12625,,88,0,1,1
12626,12626,,23,1,3,4
12627,12627,,23,2,0,2
12628,12628,,43,1,0,1
12629,12629,,43,1,1,2
12630,12630,,21,4,7,11
12631,12631,,21,3,2,5
12632,12632,,21,8,8,16
12633,12633,,21,5,7,12
12634,12634,,3,0,1,1
12635,12635,,3,0,1,1
12636,12636,,8,0,3,3
12637,12637,,8,1,1,2
12638,12638,,23,0,3,3
12639,12639,,8,0,3,3
12640,12640,,31,1,1,2
12641,12641,,31,2,1,3
12642,12642,,31,0,2,2
12643,12643,,31,0,1,1
12644,12644,,43,1,3,4
12645,12645,,45,6,6,12
12646,12646,,45,4,1,5
12647,12647,,23,0,1,1
12648,12648,,52,2,0,2
12649,12649,,21,10,15,25
12650,12650,,111,0,2,2
12651,12651,,111,3,3,6
12652,12652,,14,6,5,11
12653,12653,,23,9,5,14
12654,12654,,23,22,7,29
12655,12655,,105,3,1,4
12656,12656,,43,2,1,3
12657,12657,,43,1,4,5
12658,12658,,127,0,1,1
12659,12659,,82,1,1,2
12660,12660,,82,1,1,2
12661,12661,,105,2,3,5
12662,12662,,31,1,1,2
12663,12663,,31,4,0,4
12664,12664,,23,3,5,8
12665,12665,,8,0,1,1
12666,12666,,31,5,12,17
12667,12667,,8,3,3,6
12668,12668,,23,13,0,13
12669,12669,,8,0,1,1
12670,12670,,14,3,2,5
12671,12671,,0,4,6,10
12672,12672,,43,0,4,4
12673,12673,,43,1,0,1
12674,12674,,0,2,0,2
12675,12675,,31,0,3,3
12676,12676,,111,3,6,9
12677,12677,,31,1,1,2
12678,12678,,43,28,11,39
12679,12679,,11,3,4,7
12680,12680,,23,0,1,1
12681,12681,,14,0,1,1
12682,12682,,14,1,1,2
12683,12683,,14,1,2,3
12684,12684,,43,1,1,2
12685,12685,,23,0,1,1
12686,12686,,88,1,2,3
12687,12687,,3,1,0,1
12688,12688,,3,0,1,1
12689,12689,,15,1,0,1
12690,12690,,23,2,0,2
12691,12691,,23,1,0,1
12692,12692,,18,3,1,4
12693,12693,,8,1,2,3
12694,12694,,23,0,1,1
12695,12695,,8,0,2,2
12696,12696,,23,4,4,8
12697,12697,,23,2,1,3
12698,12698,,15,0,3,3
12699,12699,,15,1,2,3
12700,12700,,23,6,6,12
12701,12701,,3,2,1,3
12702,12702,,111,1,3,4
12703,12703,,8,0,1,1
12704,12704,,83,1,1,2
12705,12705,,83,1,1,2
12706,12706,,11,1,2,3
12707,12707,,15,0,2,2
12708,12708,,23,1,0,1
12709,12709,,23,0,2,2
12710,12710,,52,3,5,8
12711,12711,,6,14,16,30
12712,12712,,23,0,2,2
12713,12713,,88,0,2,2
12714,12714,,88,1,0,1
12715,12715,,15,2,0,2
12716,12716,,15,0,1,1
12717,12717,,15,2,0,2
12718,12718,,23,0,8,8
12719,12719,,23,1,4,5
12720,12720,,23,0,1,1
12721,12721,,23,1,3,4
12722,12722,,23,1,0,1
12723,12723,,23,4,7,11
12724,12724,,3,2,0,2
12725,12725,,15,2,0,2
12726,12726,,0,0,1,1
12727,12727,,23,1,1,2
12728,12728,,23,45,41,86
12729,12729,,23,38,25,63
12730,12730,,11,14,3,17
12731,12731,,105,1,0,1
12732,12732,,43,2,1,3
12733,12733,,43,3,3,6
12734,12734,,43,3,10,13
12735,12735,,0,0,1,1
12736,12736,,14,1,0,1
12737,12737,,21,1,2,3
12738,12738,,23,1,0,1
12739,12739,,43,2,0,2
12740,12740,,52,0,1,1
12741,12741,,52,2,1,3
12742,12742,,127,3,4,7
12743,12743,,127,1,0,1
12744,12744,,23,6,5,11
12745,12745,,23,0,2,2
12746,12746,,23,7,6,13
12747,12747,,18,0,3,3
12748,12748,,3,9,11,20
12749,12749,,21,12,2,14
12750,12750,,23,2,2,4
12751,12751,,0,2,2,4
12752,12752,,120,1,2,3
12753,12753,,14,9,17,26
12754,12754,,111,3,9,12
12755,12755,,43,0,1,1
12756,12756,,23,0,1,1
12757,12757,,23,3,3,6
12758,12758,,3,3,0,3
12759,12759,,23,1,0,1
12760,12760,,105,1,1,2
12761,12761,,15,1,1,2
12762,12762,,31,3,5,8
12763,12763,,31,1,1,2
12764,12764,,31,2,0,2
12765,12765,,8,1,1,2
12766,12766,,88,1,1,2
12767,12767,,127,2,3,5
12768,12768,,6,2,3,5
12769,12769,,6,1,0,1
12770,12770,,8,1,1,2
12771,12771,,31,1,1,2
12772,12772,,31,2,3,5
12773,12773,,8,2,1,3
12774,12774,,8,0,1,1
12775,12775,,23,0,1,1
12776,12776,,31,1,1,2
12777,12777,,8,6,13,19
12778,12778,,23,1,0,1
12779,12779,,5,3,5,8
12780,12780,,8,1,0,1
12781,12781,,23,1,2,3
12782,12782,,15,1,3,4
12783,12783,,8,1,0,1
12784,12784,,23,2,1,3
12785,12785,,23,1,0,1
12786,12786,,23,9,1,10
12787,12787,,0,1,0,1
12788,12788,,23,3,1,4
12789,12789,,8,0,5,5
12790,12790,,8,1,1,2
12791,12791,,111,2,3,5
12792,12792,,84,0,1,1
12793,12793,,84,1,0,1
12794,12794,,31,1,9,10
12795,12795,,23,1,1,2
12796,12796,,88,0,1,1
12797,12797,,45,1,3,4
12798,12798,,45,3,1,4
12799,12799,,23,13,5,18
12800,12800,,23,7,4,11
12801,12801,,8,1,1,2
12802,12802,,21,1,0,1
12803,12803,,76,1,2,3
12804,12804,,23,1,1,2
12805,12805,,15,2,1,3
12806,12806,,23,3,1,4
12807,12807,,14,3,2,5
12808,12808,,15,0,3,3
12809,12809,,8,2,3,5
12810,12810,,11,3,0,3
12811,12811,,11,6,2,8
12812,12812,,23,0,1,1
12813,12813,,23,3,1,4
12814,12814,,45,0,1,1
12815,12815,,15,0,2,2
12816,12816,,8,1,1,2
12817,12817,,23,2,0,2
12818,12818,,43,1,2,3
12819,12819,,43,0,1,1
12820,12820,,23,4,6,10
12821,12821,,127,2,6,8
12822,12822,,5,0,1,1
12823,12823,,15,2,2,4
12824,12824,,11,1,1,2
12825,12825,,21,0,2,2
12826,12826,,85,0,4,4
12827,12827,,85,2,1,3
12828,12828,,23,1,2,3
12829,12829,,23,0,2,2
12830,12830,,3,5,3,8
12831,12831,,23,1,0,1
12832,12832,,8,1,4,5
12833,12833,,8,6,8,14
12834,12834,,15,2,1,3
12835,12835,,5,2,3,5
12836,12836,,43,0,2,2
12837,12837,,23,1,1,2
12838,12838,,21,0,1,1
12839,12839,,8,2,0,2
12840,12840,,43,0,1,1
12841,12841,,43,2,1,3
12842,12842,,21,2,0,2
12843,12843,,23,1,1,2
12844,12844,,23,3,5,8
12845,12845,,21,11,0,11
12846,12846,,31,2,7,9
12847,12847,,15,2,2,4
12848,12848,,23,0,2,2
12849,12849,,43,1,4,5
12850,12850,,45,1,0,1
12851,12851,,43,0,1,1
12852,12852,,31,10,2,12
12853,12853,,11,1,2,3
12854,12854,,11,3,1,4
12855,12855,,52,1,5,6
12856,12856,,52,2,4,6
12857,12857,,14,1,4,5
12858,12858,,31,2,1,3
12859,12859,,8,5,6,11
12860,12860,,76,1,0,1
12861,12861,,0,3,4,7
12862,12862,,127,0,1,1
12863,12863,,127,6,10,16
12864,12864,,23,2,3,5
12865,12865,,31,0,1,1
12866,12866,,0,4,1,5
12867,12867,,23,1,1,2
12868,12868,,23,1,1,2
12869,12869,,5,0,1,1
12870,12870,,24,4,6,10
12871,12871,,43,1,1,2
12872,12872,,11,1,1,2
12873,12873,,24,0,4,4
12874,12874,,24,1,2,3
12875,12875,,11,1,2,3
12876,12876,,11,1,0,1
12877,12877,,120,5,5,10
12878,12878,,111,4,9,13
12879,12879,,76,7,7,14
12880,12880,,3,0,1,1
12881,12881,,23,0,1,1
12882,12882,,23,2,0,2
12883,12883,,127,0,1,1
12884,12884,,43,0,2,2
12885,12885,,21,1,1,2
12886,12886,,120,1,4,5
12887,12887,,105,1,1,2
12888,12888,,23,1,1,2
12889,12889,,23,1,0,1
12890,12890,,8,1,0,1
12891,12891,,14,1,3,4
12892,12892,,14,0,1,1
12893,12893,,23,0,1,1
12894,12894,,8,2,3,5
12895,12895,,8,0,2,2
12896,12896,,23,7,7,14
12897,12897,,23,4,4,8
12898,12898,,43,0,1,1
12899,12899,,31,0,2,2
12900,12900,,23,1,1,2
12901,12901,,8,1,1,2
12902,12902,,8,1,1,2
12903,12903,,8,0,1,1
12904,12904,,15,2,1,3
12905,12905,,3,2,0,2
12906,12906,,45,1,1,2
12907,12907,,23,1,1,2
12908,12908,,23,1,0,1
12909,12909,,111,0,1,1
12910,12910,,66,1,0,1
12911,12911,,23,1,1,2
12912,12912,,15,1,1,2
12913,12913,,8,1,2,3
12914,12914,,8,2,2,4
12915,12915,,23,1,2,3
12916,12916,,15,1,3,4
12917,12917,,15,2,0,2
12918,12918,,23,0,1,1
12919,12919,,23,5,5,10
12920,12920,,15,0,1,1
12921,12921,,111,0,1,1
12922,12922,,86,1,1,2
12923,12923,,86,1,1,2
12924,12924,,23,0,1,1
12925,12925,,0,0,4,4
12926,12926,,23,2,2,4
12927,12927,,23,1,0,1
12928,12928,,3,5,2,7
12929,12929,,43,0,1,1
12930,12930,,43,0,1,1
12931,12931,,127,6,6,12
12932,12932,,21,0,1,1
12933,12933,,23,0,1,1
12934,12934,,14,1,1,2
12935,12935,,23,1,1,2
12936,12936,,23,1,2,3
12937,12937,,15,1,1,2
12938,12938,,15,1,0,1
12939,12939,,6,2,2,4
12940,12940,,23,3,0,3
12941,12941,,52,0,2,2
12942,12942,,52,1,0,1
12943,12943,,76,40,13,53
12944,12944,,66,0,1,1
12945,12945,,23,2,5,7
12946,12946,,18,0,1,1
12947,12947,,15,1,5,6
12948,12948,,11,1,3,4
12949,12949,,21,9,3,12
12950,12950,,23,1,10,11
12951,12951,,3,3,3,6
12952,12952,,8,0,2,2
12953,12953,,8,1,0,1
12954,12954,,31,2,5,7
12955,12955,,31,3,0,3
12956,12956,,23,0,1,1
12957,12957,,21,3,1,4
12958,12958,,14,0,2,2
12959,12959,,21,2,3,5
12960,12960,,88,0,1,1
12961,12961,,23,1,0,1
12962,12962,,105,2,0,2
12963,12963,,21,0,1,1
12964,12964,,21,102,32,134
12965,12965,,127,0,1,1
12966,12966,,43,1,2,3
12967,12967,,105,2,2,4
12968,12968,,43,0,1,1
12969,12969,,52,4,0,4
12970,12970,,23,1,0,1
12971,12971,,3,0,1,1
12972,12972,,8,3,0,3
12973,12973,,8,0,3,3
12974,12974,,21,1,0,1
12975,12975,,6,1,1,2
12976,12976,,6,2,1,3
12977,12977,,87,0,1,1
12978,12978,,87,1,0,1
12979,12979,,21,1,0,1
12980,12980,,3,1,0,1
12981,12981,,5,5,1,6
12982,12982,,23,0,1,1
12983,12983,,31,1,0,1
12984,12984,,8,3,1,4
12985,12985,,0,0,2,2
12986,12986,,8,2,2,4
12987,12987,,24,2,5,7
12988,12988,,8,1,0,1
12989,12989,,76,4,4,8
12990,12990,,76,1,3,4
12991,12991,,76,2,1,3
12992,12992,,52,13,6,19
12993,12993,,21,0,1,1
12994,12994,,23,0,1,1
12995,12995,,23,0,2,2
12996,12996,,31,0,1,1
12997,12997,,31,3,1,4
12998,12998,,8,1,0,1
12999,12999,,14,2,1,3
13000,13000,,23,0,1,1
13001,13001,,31,0,5,5
13002,13002,,15,6,3,9
13003,13003,,15,1,1,2
13004,13004,,8,2,1,3
13005,13005,,45,1,4,5
13006,13006,,127,2,2,4
13007,13007,,43,5,0,5
13008,13008,,11,0,1,1
13009,13009,,127,7,2,9
13010,13010,,8,3,11,14
13011,13011,,8,1,4,5
13012,13012,,194,1,1,2
13013,13013,,194,2,0,2
13014,13014,,194,1,3,4
13015,13015,,194,2,0,2
13016,13016,,105,2,1,3
13017,13017,,8,2,4,6
13018,13018,,23,4,2,6
13019,13019,,111,2,2,4
13020,13020,,23,2,2,4
13021,13021,,5,6,0,6
13022,13022,,23,1,0,1
13023,13023,,88,70,66,136
13024,13024,,23,4,2,6
13025,13025,,8,1,3,4
13026,13026,,15,2,1,3
13027,13027,,15,5,6,11
13028,13028,,45,1,1,2
13029,13029,,127,0,1,1
13030,13030,,23,10,11,21
13031,13031,,88,8,0,8
13032,13032,,127,1,10,11
13033,13033,,23,0,1,1
13034,13034,,23,1,1,2
13035,13035,,23,0,1,1
13036,13036,,15,5,0,5
13037,13037,,15,1,0,1
13038,13038,,21,2,1,3
13039,13039,,15,1,0,1
13040,13040,,31,1,3,4
13041,13041,,127,1,0,1
13042,13042,,5,1,1,2
13043,13043,,23,1,3,4
13044,13044,,111,4,1,5
13045,13045,,23,0,1,1
13046,13046,,8,8,2,10
13047,13047,,23,2,3,5
13048,13048,,23,1,0,1
13049,13049,,23,0,1,1
13050,13050,,23,0,2,2
13051,13051,,23,8,10,18
13052,13052,,15,3,1,4
13053,13053,,23,0,1,1
13054,13054,,52,0,1,1
13055,13055,,111,0,2,2
13056,13056,,23,0,1,1
13057,13057,,111,23,41,64
13058,13058,,0,3,0,3
13059,13059,,45,2,6,8
13060,13060,,23,1,1,2
13061,13061,,3,1,1,2
13062,13062,,23,1,1,2
13063,13063,,21,3,4,7
13064,13064,,8,4,7,11
13065,13065,,0,0,1,1
13066,13066,,45,0,1,1
13067,13067,,8,0,8,8
13068,13068,,8,7,2,9
13069,13069,,23,1,1,2
13070,13070,,14,3,0,3
13071,13071,,14,1,3,4
13072,13072,,21,0,1,1
13073,13073,,105,4,3,7
13074,13074,,43,4,3,7
13075,13075,,43,0,1,1
13076,13076,,15,3,3,6
13077,13077,,5,7,0,7
13078,13078,,23,1,0,1
13079,13079,,127,0,2,2
13080,13080,,15,0,2,2
13081,13081,,8,2,3,5
13082,13082,,8,2,1,3
13083,13083,,88,0,1,1
13084,13084,,5,1,0,1
13085,13085,,43,2,1,3
13086,13086,,43,2,3,5
13087,13087,,21,0,1,1
13088,13088,,21,3,0,3
13089,13089,,14,3,8,11
13090,13090,,105,0,2,2
13091,13091,,3,0,4,4
13092,13092,,45,1,0,1
13093,13093,,11,4,0,4
13094,13094,,11,24,6,30
13095,13095,,8,2,0,2
13096,13096,,8,1,0,1
13097,13097,,8,22,12,34
13098,13098,,23,0,1,1
13099,13099,,31,0,2,2
13100,13100,,23,0,1,1
13101,13101,,23,1,1,2
13102,13102,,43,0,1,1
13103,13103,,8,3,1,4
13104,13104,,15,1,0,1
13105,13105,,8,1,0,1
13106,13106,,31,1,2,3
13107,13107,,23,0,1,1
13108,13108,,14,1,0,1
13109,13109,,3,0,4,4
13110,13110,,52,1,1,2
13111,13111,,23,1,0,1
13112,13112,,23,1,1,2
13113,13113,,23,1,1,2
13114,13114,,45,1,1,2
13115,13115,,45,2,1,3
13116,13116,,11,0,3,3
13117,13117,,89,0,1,1
13118,13118,,89,1,0,1
13119,13119,,43,3,0,3
13120,13120,,21,3,2,5
13121,13121,,24,2,1,3
13122,13122,,111,2,0,2
13123,13123,,111,1,0,1
13124,13124,,8,1,2,3
13125,13125,,23,2,3,5
13126,13126,,111,6,5,11
13127,13127,,111,0,3,3
13128,13128,,15,2,2,4
13129,13129,,90,0,1,1
13130,13130,,90,1,0,1
13131,13131,,11,2,3,5
13132,13132,,105,0,2,2
13133,13133,,23,0,1,1
13134,13134,,45,1,1,2
13135,13135,,3,2,0,2
13136,13136,,3,1,1,2
13137,13137,,8,0,2,2
13138,13138,,11,1,0,1
13139,13139,,23,1,0,1
13140,13140,,43,0,1,1
13141,13141,,8,0,1,1
13142,13142,,111,2,0,2
13143,13143,,105,0,2,2
13144,13144,,23,1,1,2
13145,13145,,91,1,1,2
13146,13146,,91,1,1,2
13147,13147,,23,8,9,17
13148,13148,,127,1,2,3
13149,13149,,127,2,2,4
13150,13150,,23,0,1,1
13151,13151,,23,0,1,1
13152,13152,,0,1,1,2
13153,13153,,92,0,1,1
13154,13154,,92,1,1,2
13155,13155,,8,1,0,1
13156,13156,,8,2,0,2
13157,13157,,5,1,0,1
13158,13158,,15,2,1,3
13159,13159,,3,3,0,3
13160,13160,,8,1,0,1
13161,13161,,3,1,1,2
13162,13162,,127,1,0,1
13163,13163,,23,2,1,3
13164,13164,,43,1,1,2
13165,13165,,111,0,2,2
13166,13166,,24,2,5,7
13167,13167,,0,3,2,5
13168,13168,,21,1,0,1
13169,13169,,23,2,2,4
13170,13170,,43,0,1,1
13171,13171,,43,2,17,19
13172,13172,,43,1,0,1
13173,13173,,8,1,5,6
13174,13174,,23,1,1,2
13175,13175,,3,2,0,2
13176,13176,,66,5,1,6
13177,13177,,66,0,1,1
13178,13178,,66,3,2,5
13179,13179,,5,0,4,4
13180,13180,,21,1,0,1
13181,13181,,21,3,5,8
13182,13182,,11,1,0,1
13183,13183,,8,0,1,1
13184,13184,,11,1,2,3
13185,13185,,8,2,0,2
13186,13186,,8,1,4,5
13187,13187,,8,2,1,3
13188,13188,,45,0,2,2
13189,13189,,8,1,1,2
13190,13190,,23,0,1,1
13191,13191,,127,1,4,5
13192,13192,,23,1,0,1
13193,13193,,31,2,3,5
13194,13194,,21,0,6,6
13195,13195,,11,2,0,2
13196,13196,,76,1,1,2
13197,13197,,76,3,2,5
13198,13198,,14,0,1,1
13199,13199,,66,0,2,2
13200,13200,,45,1,0,1
13201,13201,,23,9,6,15
13202,13202,,23,3,3,6
13203,13203,,23,1,1,2
13204,13204,,127,4,5,9
13205,13205,,76,0,3,3
13206,13206,,18,8,2,10
13207,13207,,8,1,1,2
13208,13208,,52,1,3,4
13209,13209,,23,17,7,24
13210,13210,,0,1,4,5
13211,13211,,31,1,0,1
13212,13212,,23,4,10,14
13213,13213,,24,2,1,3
13214,13214,,14,14,7,21
13215,13215,,31,1,0,1
13216,13216,,43,17,21,38
13217,13217,,3,1,1,2
13218,13218,,127,0,1,1
13219,13219,,111,0,2,2
13220,13220,,66,6,0,6
13221,13221,,88,2,0,2
13222,13222,,5,2,1,3
13223,13223,,23,6,4,10
13224,13224,,43,1,0,1
13225,13225,,127,1,1,2
13226,13226,,66,1,1,2
13227,13227,,66,0,2,2
13228,13228,,3,5,5,10
13229,13229,,8,1,0,1
13230,13230,,24,1,2,3
13231,13231,,105,1,1,2
13232,13232,,0,1,4,5
13233,13233,,11,10,13,23
13234,13234,,23,2,0,2
13235,13235,,23,0,1,1
13236,13236,,8,4,0,4
13237,13237,,43,1,0,1
13238,13238,,52,0,1,1
13239,13239,,0,1,1,2
13240,13240,,8,1,3,4
13241,13241,,43,0,2,2
13242,13242,,52,0,2,2
13243,13243,,93,0,1,1
13244,13244,,93,1,0,1
13245,13245,,23,2,3,5
13246,13246,,3,0,2,2
13247,13247,,23,1,0,1
13248,13248,,52,0,1,1
13249,13249,,21,3,0,3
13250,13250,,43,1,1,2
13251,13251,,43,1,2,3
13252,13252,,24,1,0,1
13253,13253,,43,1,0,1
13254,13254,,43,2,2,4
13255,13255,,43,1,1,2
13256,13256,,14,12,9,21
13257,13257,,23,1,0,1
13258,13258,,23,0,1,1
13259,13259,,105,2,2,4
13260,13260,,14,13,8,21
13261,13261,,8,4,7,11
13262,13262,,0,0,1,1
13263,13263,,127,0,1,1
13264,13264,,8,7,1,8
13265,13265,,8,4,4,8
13266,13266,,18,2,2,4
13267,13267,,52,1,0,1
13268,13268,,3,1,5,6
13269,13269,,23,1,3,4
13270,13270,,23,0,1,1
13271,13271,,15,1,2,3
13272,13272,,23,0,3,3
13273,13273,,0,1,2,3
13274,13274,,11,1,2,3
13275,13275,,31,1,0,1
13276,13276,,8,0,1,1
13277,13277,,8,3,1,4
13278,13278,,8,1,0,1
13279,13279,,23,1,0,1
13280,13280,,66,1,0,1
13281,13281,,8,0,1,1
13282,13282,,23,1,1,2
13283,13283,,23,1,0,1
13284,13284,,0,1,1,2
13285,13285,,18,1,2,3
13286,13286,,23,2,2,4
13287,13287,,111,1,3,4
13288,13288,,127,3,2,5
13289,13289,,127,6,0,6
13290,13290,,8,1,0,1
13291,13291,,31,1,0,1
13292,13292,,8,2,1,3
13293,13293,,0,2,3,5
13294,13294,,0,0,3,3
13295,13295,,31,1,8,9
13296,13296,,11,0,2,2
13297,13297,,3,3,7,10
13298,13298,,3,1,0,1
13299,13299,,3,1,0,1
13300,13300,,15,0,1,1
13301,13301,,18,2,1,3
13302,13302,,52,0,1,1
13303,13303,,52,4,1,5
13304,13304,,3,0,1,1
13305,13305,,3,1,1,2
13306,13306,,43,0,1,1
13307,13307,,111,3,1,4
13308,13308,,23,0,1,1
13309,13309,,43,2,1,3
13310,13310,,111,1,3,4
13311,13311,,11,1,0,1
13312,13312,,31,9,9,18
13313,13313,,11,0,1,1
13314,13314,,11,2,2,4
13315,13315,,8,2,4,6
13316,13316,,23,2,2,4
13317,13317,,52,11,25,36
13318,13318,,45,0,2,2
13319,13319,,21,2,0,2
13320,13320,,21,3,0,3
13321,13321,,8,0,2,2
13322,13322,,24,3,1,4
13323,13323,,127,8,6,14
13324,13324,,8,2,0,2
13325,13325,,3,1,0,1
13326,13326,,23,0,3,3
13327,13327,,94,0,1,1
13328,13328,,94,1,0,1
13329,13329,,127,11,11,22
13330,13330,,127,3,3,6
13331,13331,,0,1,1,2
13332,13332,,11,3,3,6
13333,13333,,11,3,0,3
13334,13334,,21,0,1,1
13335,13335,,11,0,1,1
13336,13336,,43,2,5,7
13337,13337,,11,1,1,2
13338,13338,,8,2,1,3
13339,13339,,127,3,1,4
13340,13340,,15,7,5,12
13341,13341,,21,3,6,9
13342,13342,,14,7,9,16
13343,13343,,43,4,7,11
13344,13344,,8,1,2,3
13345,13345,,127,4,6,10
13346,13346,,43,7,0,7
13347,13347,,23,1,2,3
13348,13348,,43,2,0,2
13349,13349,,14,1,1,2
13350,13350,,23,0,1,1
13351,13351,,66,0,1,1
13352,13352,,23,1,0,1
13353,13353,,3,1,1,2
13354,13354,,95,1,1,2
13355,13355,,95,1,1,2
13356,13356,,3,3,2,5
13357,13357,,3,5,4,9
13358,13358,,24,1,2,3
13359,13359,,45,7,5,12
13360,13360,,8,0,1,1
13361,13361,,96,0,2,2
13362,13362,,96,1,0,1
13363,13363,,24,2,0,2
13364,13364,,8,2,1,3
13365,13365,,31,2,4,6
13366,13366,,11,4,1,5
13367,13367,,8,0,2,2
13368,13368,,8,2,3,5
13369,13369,,97,0,1,1
13370,13370,,97,1,0,1
13371,13371,,23,1,0,1
13372,13372,,45,0,2,2
13373,13373,,120,0,2,2
13374,13374,,76,2,1,3
13375,13375,,127,5,7,12
13376,13376,,111,0,1,1
13377,13377,,76,1,5,6
13378,13378,,14,1,0,1
13379,13379,,14,1,0,1
13380,13380,,127,1,3,4
13381,13381,,15,1,2,3
13382,13382,,23,2,3,5
13383,13383,,105,1,0,1
13384,13384,,23,1,2,3
13385,13385,,14,0,1,1
13386,13386,,14,2,0,2
13387,13387,,23,2,3,5
13388,13388,,31,0,1,1
13389,13389,,31,2,0,2
13390,13390,,3,3,4,7
13391,13391,,23,1,11,12
13392,13392,,105,3,3,6
13393,13393,,88,0,1,1
13394,13394,,127,4,5,9
13395,13395,,31,2,0,2
13396,13396,,18,1,1,2
13397,13397,,14,0,1,1
13398,13398,,31,1,3,4
13399,13399,,8,0,1,1
13400,13400,,120,1,0,1
13401,13401,,23,2,2,4
13402,13402,,0,3,0,3
13403,13403,,23,1,3,4
13404,13404,,120,1,1,2
13405,13405,,76,0,5,5
13406,13406,,76,0,2,2
13407,13407,,23,3,1,4
13408,13408,,127,4,0,4
13409,13409,,6,0,2,2
13410,13410,,3,3,2,5
13411,13411,,23,1,4,5
13412,13412,,3,1,0,1
13413,13413,,31,4,2,6
13414,13414,,31,0,1,1
13415,13415,,111,5,3,8
13416,13416,,24,1,0,1
13417,13417,,23,3,2,5
13418,13418,,23,1,0,1
13419,13419,,52,0,1,1
13420,13420,,8,1,0,1
13421,13421,,18,1,1,2
13422,13422,,45,1,1,2
13423,13423,,127,1,2,3
13424,13424,,88,1,2,3
13425,13425,,23,1,0,1
13426,13426,,8,1,0,1
13427,13427,,98,0,1,1
13428,13428,,98,1,0,1
13429,13429,,8,1,2,3
13430,13430,,88,0,2,2
13431,13431,,23,0,4,4
13432,13432,,15,2,1,3
13433,13433,,3,1,0,1
13434,13434,,111,1,1,2
13435,13435,,111,0,1,1
13436,13436,,111,2,0,2
13437,13437,,31,0,5,5
13438,13438,,23,2,2,4
13439,13439,,31,0,2,2
13440,13440,,31,5,0,5
13441,13441,,31,0,7,7
13442,13442,,8,1,1,2
13443,13443,,11,1,2,3
13444,13444,,11,0,1,1
13445,13445,,23,0,1,1
13446,13446,,23,11,13,24
13447,13447,,23,1,0,1
13448,13448,,0,0,1,1
13449,13449,,127,1,0,1
13450,13450,,3,1,1,2
13451,13451,,14,0,2,2
13452,13452,,8,0,1,1
13453,13453,,21,1,2,3
13454,13454,,88,9,4,13
13455,13455,,0,0,1,1
13456,13456,,0,1,2,3
13457,13457,,0,0,1,1
13458,13458,,0,4,0,4
13459,13459,,43,2,3,5
13460,13460,,21,5,5,10
13461,13461,,0,10,15,25
13462,13462,,21,3,0,3
13463,13463,,5,0,2,2
13464,13464,,88,0,1,1
13465,13465,,88,0,2,2
13466,13466,,5,1,1,2
13467,13467,,8,3,1,4
13468,13468,,14,1,0,1
13469,13469,,0,0,1,1
13470,13470,,23,2,8,10
13471,13471,,3,1,0,1
13472,13472,,15,4,1,5
13473,13473,,127,4,4,8
13474,13474,,21,0,3,3
13475,13475,,23,1,1,2
13476,13476,,3,1,1,2
13477,13477,,0,2,7,9
13478,13478,,21,1,1,2
13479,13479,,21,1,0,1
13480,13480,,3,1,1,2
13481,13481,,24,2,0,2
13482,13482,,105,0,3,3
13483,13483,,8,1,2,3
13484,13484,,8,16,22,38
13485,13485,,43,1,1,2
13486,13486,,127,2,3,5
13487,13487,,127,1,1,2
13488,13488,,23,0,1,1
13489,13489,,14,0,4,4
13490,13490,,8,2,1,3
13491,13491,,8,0,2,2
13492,13492,,31,0,2,2
13493,13493,,18,2,0,2
13494,13494,,23,1,1,2
13495,13495,,8,1,0,1
13496,13496,,23,1,1,2
13497,13497,,8,2,0,2
13498,13498,,18,3,0,3
13499,13499,,6,2,0,2
13500,13500,,99,0,2,2
13501,13501,,99,3,0,3
13502,13502,,99,1,2,3
13503,13503,,99,1,1,2
13504,13504,,105,0,1,1
13505,13505,,0,0,1,1
13506,13506,,31,0,1,1
13507,13507,,23,0,3,3
13508,13508,,6,1,0,1
13509,13509,,14,0,1,1
13510,13510,,14,1,0,1
13511,13511,,3,1,1,2
13512,13512,,15,1,0,1
13513,13513,,8,1,6,7
13514,13514,,23,0,1,1
13515,13515,,23,0,1,1
13516,13516,,23,1,0,1
13517,13517,,100,1,1,2
13518,13518,,100,1,1,2
13519,13519,,8,1,0,1
13520,13520,,0,2,0,2
13521,13521,,23,1,1,2
13522,13522,,23,1,0,1
13523,13523,,0,3,3,6
13524,13524,,8,3,3,6
13525,13525,,23,3,1,4
13526,13526,,43,1,7,8
13527,13527,,43,2,1,3
13528,13528,,76,3,0,3
13529,13529,,88,2,2,4
13530,13530,,15,1,7,8
13531,13531,,3,0,2,2
13532,13532,,23,3,4,7
13533,13533,,127,0,1,1
13534,13534,,127,3,0,3
13535,13535,,43,3,5,8
13536,13536,,43,0,3,3
13537,13537,,88,2,0,2
13538,13538,,3,2,3,5
13539,13539,,14,2,3,5
13540,13540,,101,0,1,1
13541,13541,,101,1,0,1
13542,13542,,14,6,7,13
13543,13543,,3,2,3,5
13544,13544,,3,7,8,15
13545,13545,,23,4,3,7
13546,13546,,23,5,13,18
13547,13547,,23,2,2,4
13548,13548,,43,1,0,1
13549,13549,,43,0,1,1
13550,13550,,23,2,1,3
13551,13551,,3,1,1,2
13552,13552,,14,0,1,1
13553,13553,,14,3,5,8
13554,13554,,15,1,2,3
13555,13555,,43,5,0,5
13556,13556,,23,0,2,2
13557,13557,,3,43,58,101
13558,13558,,8,3,2,5
13559,13559,,127,17,14,31
13560,13560,,21,2,0,2
13561,13561,,3,1,4,5
13562,13562,,3,4,4,8
13563,13563,,21,1,4,5
13564,13564,,45,0,1,1
13565,13565,,45,3,5,8
13566,13566,,24,4,2,6
13567,13567,,8,0,1,1
13568,13568,,24,4,1,5
13569,13569,,43,3,1,4
13570,13570,,43,1,1,2
13571,13571,,5,13,17,30
13572,13572,,14,0,2,2
13573,13573,,23,2,2,4
13574,13574,,6,0,2,2
13575,13575,,31,3,1,4
13576,13576,,23,1,4,5
13577,13577,,14,1,2,3
13578,13578,,23,1,6,7
13579,13579,,8,1,0,1
13580,13580,,8,3,8,11
13581,13581,,8,1,0,1
13582,13582,,23,3,6,9
13583,13583,,76,3,3,6
13584,13584,,23,1,1,2
13585,13585,,8,1,0,1
13586,13586,,43,0,2,2
13587,13587,,8,2,0,2
13588,13588,,127,2,1,3
13589,13589,,15,2,3,5
13590,13590,,8,0,1,1
13591,13591,,14,0,3,3
13592,13592,,11,2,4,6
13593,13593,,11,2,2,4
13594,13594,,23,1,1,2
13595,13595,,31,0,1,1
13596,13596,,45,0,2,2
13597,13597,,11,0,3,3
13598,13598,,23,2,0,2
13599,13599,,8,0,2,2
13600,13600,,31,1,0,1
13601,13601,,127,2,0,2
13602,13602,,8,8,1,9
13603,13603,,23,12,11,23
13604,13604,,23,5,3,8
13605,13605,,15,1,1,2
13606,13606,,23,1,0,1
13607,13607,,127,0,2,2
13608,13608,,52,0,1,1
13609,13609,,105,0,3,3
13610,13610,,23,2,1,3
13611,13611,,3,1,1,2
13612,13612,,8,1,1,2
13613,13613,,111,1,0,1
13614,13614,,111,0,3,3
13615,13615,,111,2,0,2
13616,13616,,3,2,2,4
13617,13617,,21,1,0,1
13618,13618,,23,0,2,2
13619,13619,,45,3,2,5
13620,13620,,18,2,2,4
13621,13621,,18,1,1,2
13622,13622,,11,1,0,1
13623,13623,,6,1,4,5
13624,13624,,8,0,1,1
13625,13625,,24,0,6,6
13626,13626,,88,2,4,6
13627,13627,,21,2,2,4
13628,13628,,21,1,1,2
13629,13629,,88,1,2,3
13630,13630,,5,0,1,1
13631,13631,,15,0,4,4
13632,13632,,11,1,2,3
13633,13633,,11,5,5,10
13634,13634,,0,1,1,2
13635,13635,,11,0,1,1
13636,13636,,23,0,1,1
13637,13637,,43,1,0,1
13638,13638,,21,5,4,9
13639,13639,,127,1,2,3
13640,13640,,23,1,0,1
13641,13641,,52,2,0,2
13642,13642,,88,0,2,2
13643,13643,,23,157,231,388
13644,13644,,43,0,1,1
13645,13645,,23,0,1,1
13646,13646,,43,0,4,4
13647,13647,,43,2,0,2
13648,13648,,11,0,2,2
13649,13649,,127,0,2,2
13650,13650,,21,11,8,19
13651,13651,,21,13,9,22
13652,13652,,43,3,1,4
13653,13653,,3,0,1,1
13654,13654,,3,0,3,3
13655,13655,,21,3,3,6
13656,13656,,31,0,1,1
13657,13657,,45,1,0,1
13658,13658,,3,1,4,5
13659,13659,,76,0,1,1
13660,13660,,76,1,0,1
13661,13661,,111,1,1,2
13662,13662,,111,1,0,1
13663,13663,,15,0,1,1
13664,13664,,23,3,1,4
13665,13665,,6,5,11,16
13666,13666,,23,1,1,2
13667,13667,,23,2,4,6
13668,13668,,23,1,0,1
13669,13669,,23,11,0,11
13670,13670,,11,1,6,7
13671,13671,,5,0,4,4
13672,13672,,43,0,1,1
13673,13673,,23,0,3,3
13674,13674,,105,1,0,1
13675,13675,,8,1,0,1
13676,13676,,15,1,0,1
13677,13677,,0,2,2,4
13678,13678,,15,1,2,3
13679,13679,,14,0,1,1
13680,13680,,14,2,3,5
13681,13681,,43,4,2,6
13682,13682,,23,9,10,19
13683,13683,,8,4,2,6
13684,13684,,8,1,0,1
13685,13685,,8,1,0,1
13686,13686,,111,0,1,1
13687,13687,,105,0,2,2
13688,13688,,15,2,3,5
13689,13689,,88,0,2,2
13690,13690,,127,2,0,2
13691,13691,,8,0,1,1
13692,13692,,8,1,4,5
13693,13693,,23,1,0,1
13694,13694,,88,3,0,3
13695,13695,,23,2,0,2
13696,13696,,102,0,1,1
13697,13697,,102,1,0,1
13698,13698,,23,0,2,2
13699,13699,,111,0,1,1
13700,13700,,23,0,1,1
13701,13701,,23,0,1,1
13702,13702,,6,1,0,1
13703,13703,,18,3,3,6
13704,13704,,0,1,1,2
13705,13705,,111,1,1,2
13706,13706,,111,4,6,10
13707,13707,,0,1,1,2
13708,13708,,8,0,2,2
13709,13709,,45,1,2,3
13710,13710,,52,1,0,1
13711,13711,,76,0,1,1
13712,13712,,23,0,1,1
13713,13713,,127,2,0,2
13714,13714,,45,0,2,2
13715,13715,,45,0,1,1
13716,13716,,45,2,0,2
13717,13717,,127,2,2,4
13718,13718,,23,2,1,3
13719,13719,,3,1,1,2
13720,13720,,31,0,1,1
13721,13721,,111,4,2,6
13722,13722,,105,0,3,3
13723,13723,,88,0,1,1
13724,13724,,23,1,0,1
13725,13725,,18,0,2,2
13726,13726,,31,0,1,1
13727,13727,,3,0,2,2
13728,13728,,21,6,5,11
13729,13729,,43,1,4,5
13730,13730,,8,1,2,3
13731,13731,,8,4,2,6
13732,13732,,0,2,1,3
13733,13733,,66,1,0,1
13734,13734,,43,0,1,1
13735,13735,,88,2,2,4
13736,13736,,8,2,1,3
13737,13737,,43,1,1,2
13738,13738,,21,0,1,1
13739,13739,,23,0,1,1
13740,13740,,23,2,4,6
13741,13741,,0,0,1,1
13742,13742,,21,1,0,1
13743,13743,,66,0,2,2
13744,13744,,66,1,1,2
13745,13745,,3,0,2,2
13746,13746,,3,3,2,5
13747,13747,,24,1,2,3
13748,13748,,11,3,1,4
13749,13749,,11,4,3,7
13750,13750,,23,0,2,2
13751,13751,,14,1,1,2
13752,13752,,11,1,2,3
13753,13753,,15,1,0,1
13754,13754,,127,2,4,6
13755,13755,,11,11,3,14
13756,13756,,11,1,1,2
13757,13757,,18,0,2,2
13758,13758,,23,1,0,1
13759,13759,,52,4,0,4
13760,13760,,11,1,4,5
13761,13761,,11,1,2,3
13762,13762,,0,2,1,3
13763,13763,,6,6,4,10
13764,13764,,105,2,0,2
13765,13765,,43,10,7,17
13766,13766,,76,1,0,1
13767,13767,,21,2,1,3
13768,13768,,45,1,2,3
13769,13769,,8,0,1,1
13770,13770,,31,0,1,1
13771,13771,,111,0,1,1
13772,13772,,111,1,1,2
13773,13773,,45,0,1,1
13774,13774,,105,6,1,7
13775,13775,,76,2,2,4
13776,13776,,23,1,2,3
13777,13777,,43,0,4,4
13778,13778,,8,1,1,2
13779,13779,,5,2,2,4
13780,13780,,8,0,1,1
13781,13781,,0,3,2,5
13782,13782,,15,3,3,6
13783,13783,,15,2,0,2
13784,13784,,15,1,0,1
13785,13785,,105,0,1,1
13786,13786,,23,1,2,3
13787,13787,,23,1,1,2
13788,13788,,11,0,1,1
13789,13789,,120,0,5,5
13790,13790,,23,1,1,2
13791,13791,,8,0,1,1
13792,13792,,127,1,1,2
13793,13793,,8,2,0,2
13794,13794,,23,0,1,1
13795,13795,,11,5,0,5
13796,13796,,52,0,2,2
13797,13797,,52,0,2,2
13798,13798,,127,9,14,23
13799,13799,,15,1,3,4
13800,13800,,23,2,2,4
13801,13801,,52,1,1,2
13802,13802,,127,0,1,1
13803,13803,,43,0,1,1
13804,13804,,0,0,1,1
13805,13805,,88,1,1,2
13806,13806,,3,5,6,11
13807,13807,,23,6,1,7
13808,13808,,21,0,2,2
13809,13809,,23,0,1,1
13810,13810,,23,0,2,2
13811,13811,,43,0,1,1
13812,13812,,3,1,0,1
13813,13813,,3,1,2,3
13814,13814,,5,3,2,5
13815,13815,,21,1,1,2
13816,13816,,8,1,9,10
13817,13817,,23,1,0,1
13818,13818,,0,9,3,12
13819,13819,,3,2,5,7
13820,13820,,3,5,0,5
13821,13821,,3,4,2,6
13822,13822,,120,2,2,4
13823,13823,,127,0,1,1
13824,13824,,3,1,0,1
13825,13825,,21,1,1,2
13826,13826,,43,1,0,1
13827,13827,,45,0,2,2
13828,13828,,8,4,5,9
13829,13829,,23,0,1,1
13830,13830,,11,0,2,2
13831,13831,,11,2,0,2
13832,13832,,52,1,0,1
13833,13833,,6,1,0,1
13834,13834,,103,0,1,1
13835,13835,,103,1,0,1
13836,13836,,111,2,1,3
13837,13837,,88,1,0,1
13838,13838,,105,1,3,4
13839,13839,,0,0,2,2
13840,13840,,15,1,1,2
13841,13841,,11,0,1,1
13842,13842,,23,0,1,1
13843,13843,,11,0,1,1
13844,13844,,43,1,0,1
13845,13845,,8,1,0,1
13846,13846,,8,0,1,1
13847,13847,,127,0,2,2
13848,13848,,127,4,4,8
13849,13849,,23,1,1,2
13850,13850,,8,3,0,3
13851,13851,,8,0,1,1
13852,13852,,3,5,8,13
13853,13853,,23,1,1,2
13854,13854,,31,0,2,2
13855,13855,,31,1,0,1
13856,13856,,23,1,5,6
13857,13857,,23,1,1,2
13858,13858,,31,5,8,13
13859,13859,,14,4,7,11
13860,13860,,14,2,0,2
13861,13861,,8,0,5,5
13862,13862,,5,10,17,27
13863,13863,,23,2,4,6
13864,13864,,11,2,1,3
13865,13865,,0,4,1,5
13866,13866,,15,2,3,5
13867,13867,,127,1,5,6
13868,13868,,6,0,1,1
13869,13869,,6,2,0,2
13870,13870,,23,0,1,1
13871,13871,,45,1,0,1
13872,13872,,23,0,1,1
13873,13873,,15,2,1,3
13874,13874,,8,1,2,3
13875,13875,,111,0,1,1
13876,13876,,21,2,0,2
13877,13877,,88,1,2,3
13878,13878,,23,1,0,1
13879,13879,,0,0,2,2
13880,13880,,23,0,1,1
13881,13881,,0,0,1,1
13882,13882,,23,2,1,3
13883,13883,,21,3,3,6
13884,13884,,3,0,1,1
13885,13885,,21,9,4,13
13886,13886,,24,4,2,6
13887,13887,,111,3,3,6
13888,13888,,11,1,0,1
13889,13889,,11,2,0,2
13890,13890,,31,0,1,1
13891,13891,,11,2,1,3
13892,13892,,11,1,2,3
13893,13893,,43,0,1,1
13894,13894,,23,1,2,3
13895,13895,,43,1,1,2
13896,13896,,43,2,1,3
13897,13897,,52,2,0,2
13898,13898,,52,3,4,7
13899,13899,,23,1,0,1
13900,13900,,31,1,0,1
13901,13901,,31,1,1,2
13902,13902,,14,1,6,7
13903,13903,,127,11,15,26
13904,13904,,43,0,1,1
13905,13905,,76,1,1,2
13906,13906,,104,0,1,1
13907,13907,,104,1,0,1
13908,13908,,43,2,0,2
13909,13909,,43,0,1,1
13910,13910,,3,1,0,1
13911,13911,,111,2,1,3
13912,13912,,111,4,2,6
13913,13913,,111,1,0,1
13914,13914,,111,2,0,2
13915,13915,,23,4,1,5
13916,13916,,76,1,1,2
13917,13917,,3,0,1,1
13918,13918,,23,1,2,3
13919,13919,,23,1,3,4
13920,13920,,43,3,3,6
13921,13921,,8,1,1,2
13922,13922,,15,1,0,1
13923,13923,,23,0,2,2
13924,13924,,0,0,1,1
13925,13925,,0,1,0,1
13926,13926,,23,3,4,7
13927,13927,,31,0,1,1
13928,13928,,3,3,2,5
13929,13929,,18,2,0,2
13930,13930,,111,1,0,1
13931,13931,,14,2,3,5
13932,13932,,194,1,0,1
13933,13933,,127,1,0,1
13934,13934,,127,0,1,1
13935,13935,,11,1,1,2
13936,13936,,23,1,0,1
13937,13937,,105,2,8,10
13938,13938,,18,0,2,2
13939,13939,,111,4,0,4
13940,13940,,23,2,2,4
13941,13941,,18,1,2,3
13942,13942,,52,4,3,7
13943,13943,,3,2,10,12
13944,13944,,105,1,0,1
13945,13945,,23,0,3,3
13946,13946,,11,1,1,2
13947,13947,,11,2,2,4
13948,13948,,127,0,3,3
13949,13949,,15,0,1,1
13950,13950,,15,0,1,1
13951,13951,,8,3,0,3
13952,13952,,21,0,4,4
13953,13953,,23,1,1,2
13954,13954,,15,0,1,1
13955,13955,,8,1,0,1
13956,13956,,23,0,1,1
13957,13957,,127,1,1,2
13958,13958,,111,1,0,1
13959,13959,,15,0,1,1
13960,13960,,15,2,5,7
13961,13961,,14,0,1,1
13962,13962,,0,1,0,1
13963,13963,,111,1,1,2
13964,13964,,21,1,0,1
13965,13965,,18,0,1,1
13966,13966,,23,1,1,2
13967,13967,,24,3,0,3
13968,13968,,0,3,1,4
13969,13969,,45,0,1,1
13970,13970,,127,1,1,2
13971,13971,,127,2,2,4
13972,13972,,8,1,0,1
13973,13973,,127,10,2,12
13974,13974,,106,1,1,2
13975,13975,,106,1,1,2
13976,13976,,14,6,3,9
13977,13977,,5,2,3,5
13978,13978,,88,5,2,7
13979,13979,,8,1,0,1
13980,13980,,3,0,2,2
13981,13981,,0,1,0,1
13982,13982,,21,2,1,3
13983,13983,,3,1,10,11
13984,13984,,3,2,0,2
13985,13985,,21,6,0,6
13986,13986,,18,1,3,4
13987,13987,,111,8,2,10
13988,13988,,11,2,0,2
13989,13989,,127,0,1,1
13990,13990,,0,7,3,10
13991,13991,,8,1,1,2
13992,13992,,11,0,1,1
13993,13993,,15,2,0,2
13994,13994,,3,8,16,24
13995,13995,,127,4,5,9
13996,13996,,21,1,2,3
13997,13997,,21,1,0,1
13998,13998,,8,0,1,1
13999,13999,,31,1,3,4
14000,14000,,23,2,3,5
14001,14001,,52,0,1,1
14002,14002,,52,0,1,1
14003,14003,,52,3,0,3
14004,14004,,14,1,1,2
14005,14005,,52,3,0,3
14006,14006,,8,217,300,517
14007,14007,,14,0,5,5
14008,14008,,43,2,9,11
14009,14009,,127,0,2,2
14010,14010,,127,1,0,1
14011,14011,,23,1,6,7
14012,14012,,43,3,0,3
14013,14013,,14,3,1,4
14014,14014,,111,1,0,1
14015,14015,,6,1,4,5
14016,14016,,8,10,16,26
14017,14017,,8,3,2,5
14018,14018,,111,3,3,6
14019,14019,,23,3,3,6
14020,14020,,5,2,2,4
14021,14021,,5,2,2,4
14022,14022,,6,7,8,15
14023,14023,,127,1,3,4
14024,14024,,23,1,0,1
14025,14025,,111,0,1,1
14026,14026,,111,1,3,4
14027,14027,,23,0,1,1
14028,14028,,14,3,2,5
14029,14029,,23,0,2,2
14030,14030,,8,6,7,13
14031,14031,,14,1,3,4
14032,14032,,23,3,10,13
14033,14033,,3,1,1,2
14034,14034,,8,0,2,2
14035,14035,,15,2,3,5
14036,14036,,8,0,1,1
14037,14037,,11,1,2,3
14038,14038,,14,1,3,4
14039,14039,,14,0,1,1
14040,14040,,14,2,2,4
14041,14041,,8,1,2,3
14042,14042,,8,4,7,11
14043,14043,,3,2,0,2
14044,14044,,23,1,0,1
14045,14045,,0,1,2,3
14046,14046,,18,1,0,1
14047,14047,,23,1,1,2
14048,14048,,8,1,0,1
14049,14049,,3,2,0,2
14050,14050,,127,0,3,3
14051,14051,,127,3,0,3
14052,14052,,52,2,2,4
14053,14053,,105,0,1,1
14054,14054,,111,1,0,1
14055,14055,,111,0,1,1
14056,14056,,8,0,1,1
14057,14057,,43,0,1,1
14058,14058,,0,0,4,4
14059,14059,,88,2,3,5
14060,14060,,15,1,1,2
14061,14061,,31,3,2,5
14062,14062,,31,1,2,3
14063,14063,,88,0,1,1
14064,14064,,43,0,1,1
14065,14065,,52,9,0,9
14066,14066,,127,3,2,5
14067,14067,,111,1,1,2
14068,14068,,8,0,1,1
14069,14069,,88,0,2,2
14070,14070,,8,2,2,4
14071,14071,,15,0,2,2
14072,14072,,31,0,1,1
14073,14073,,23,2,2,4
14074,14074,,23,1,1,2
14075,14075,,23,2,0,2
14076,14076,,111,1,0,1
14077,14077,,8,2,0,2
14078,14078,,8,1,3,4
14079,14079,,21,1,1,2
14080,14080,,76,2,1,3
14081,14081,,23,1,1,2
14082,14082,,8,7,3,10
14083,14083,,43,2,3,5
14084,14084,,18,5,6,11
14085,14085,,21,0,1,1
14086,14086,,15,4,2,6
14087,14087,,15,1,2,3
14088,14088,,23,0,1,1
14089,14089,,8,0,2,2
14090,14090,,21,0,1,1
14091,14091,,21,1,1,2
14092,14092,,21,2,1,3
14093,14093,,24,2,0,2
14094,14094,,31,0,1,1
14095,14095,,45,0,1,1
14096,14096,,45,0,1,1
14097,14097,,24,2,3,5
14098,14098,,8,0,1,1
14099,14099,,23,2,0,2
14100,14100,,14,1,0,1
14101,14101,,14,3,1,4
14102,14102,,3,1,0,1
14103,14103,,14,0,2,2
14104,14104,,43,2,1,3
14105,14105,,105,0,1,1
14106,14106,,43,1,2,3
14107,14107,,0,2,2,4
14108,14108,,23,0,1,1
14109,14109,,107,0,1,1
14110,14110,,107,1,0,1
14111,14111,,52,0,1,1
14112,14112,,52,0,5,5
14113,14113,,8,3,1,4
14114,14114,,24,1,1,2
14115,14115,,23,3,2,5
14116,14116,,8,0,1,1
14117,14117,,8,0,2,2
14118,14118,,52,2,2,4
14119,14119,,0,0,1,1
14120,14120,,127,0,1,1
14121,14121,,8,2,2,4
14122,14122,,21,0,3,3
14123,14123,,23,0,1,1
14124,14124,,23,1,0,1
14125,14125,,45,1,0,1
14126,14126,,111,1,0,1
14127,14127,,23,2,2,4
14128,14128,,14,1,3,4
14129,14129,,24,0,3,3
14130,14130,,24,1,1,2
14131,14131,,120,2,3,5
14132,14132,,3,4,2,6
14133,14133,,23,2,0,2
14134,14134,,45,1,0,1
14135,14135,,111,0,1,1
14136,14136,,127,0,3,3
14137,14137,,15,1,2,3
14138,14138,,23,4,0,4
14139,14139,,23,0,1,1
14140,14140,,15,4,7,11
14141,14141,,15,8,2,10
14142,14142,,105,7,4,11
14143,14143,,15,2,6,8
14144,14144,,15,4,7,11
14145,14145,,8,0,1,1
14146,14146,,8,0,1,1
14147,14147,,15,3,0,3
14148,14148,,11,2,2,4
14149,14149,,23,1,0,1
14150,14150,,8,2,5,7
14151,14151,,23,0,1,1
14152,14152,,14,1,2,3
14153,14153,,14,4,1,5
14154,14154,,0,1,3,4
14155,14155,,5,3,3,6
14156,14156,,0,1,0,1
14157,14157,,23,9,0,9
14158,14158,,23,1,1,2
14159,14159,,23,1,1,2
14160,14160,,23,1,1,2
14161,14161,,23,3,0,3
14162,14162,,21,0,2,2
14163,14163,,21,2,0,2
14164,14164,,23,1,2,3
14165,14165,,3,0,1,1
14166,14166,,127,0,1,1
14167,14167,,127,1,1,2
14168,14168,,18,0,1,1
14169,14169,,15,1,1,2
14170,14170,,23,0,1,1
14171,14171,,127,1,4,5
14172,14172,,23,1,0,1
14173,14173,,21,0,3,3
14174,14174,,8,0,1,1
14175,14175,,8,0,1,1
14176,14176,,0,15,1,16
14177,14177,,15,0,1,1
14178,14178,,23,0,1,1
14179,14179,,15,6,12,18
14180,14180,,3,0,1,1
14181,14181,,105,4,7,11
14182,14182,,23,0,1,1
14183,14183,,111,2,0,2
14184,14184,,23,2,1,3
14185,14185,,23,0,1,1
14186,14186,,23,1,0,1
14187,14187,,8,2,2,4
14188,14188,,21,0,1,1
14189,14189,,66,2,1,3
14190,14190,,66,10,2,12
14191,14191,,43,1,5,6
14192,14192,,14,6,20,26
14193,14193,,45,3,1,4
14194,14194,,23,0,1,1
14195,14195,,24,0,2,2
14196,14196,,45,0,4,4
14197,14197,,11,1,1,2
14198,14198,,23,1,1,2
14199,14199,,31,4,19,23
14200,14200,,120,6,2,8
14201,14201,,8,1,0,1
14202,14202,,8,6,2,8
14203,14203,,127,2,2,4
14204,14204,,43,2,0,2
14205,14205,,108,0,1,1
14206,14206,,108,1,0,1
14207,14207,,14,19,2,21
14208,14208,,43,0,4,4
14209,14209,,127,0,1,1
14210,14210,,23,1,1,2
14211,14211,,43,1,0,1
14212,14212,,43,0,1,1
14213,14213,,8,1,3,4
14214,14214,,8,1,1,2
14215,14215,,15,1,0,1
14216,14216,,6,2,2,4
14217,14217,,31,2,2,4
14218,14218,,23,1,3,4
14219,14219,,31,0,1,1
14220,14220,,8,1,1,2
14221,14221,,8,2,3,5
14222,14222,,45,0,1,1
14223,14223,,23,0,1,1
14224,14224,,23,2,4,6
14225,14225,,23,0,1,1
14226,14226,,21,2,4,6
14227,14227,,8,4,2,6
14228,14228,,45,0,1,1
14229,14229,,31,1,0,1
14230,14230,,43,1,2,3
14231,14231,,66,1,0,1
14232,14232,,11,1,2,3
14233,14233,,23,0,2,2
14234,14234,,23,2,3,5
14235,14235,,127,2,1,3
14236,14236,,3,1,2,3
14237,14237,,11,1,1,2
14238,14238,,15,1,0,1
14239,14239,,8,1,0,1
14240,14240,,0,1,0,1
14241,14241,,3,8,1,9
14242,14242,,23,3,5,8
14243,14243,,5,2,0,2
14244,14244,,3,3,2,5
14245,14245,,8,0,1,1
14246,14246,,52,0,1,1
14247,14247,,14,0,1,1
14248,14248,,76,5,4,9
14249,14249,,0,0,4,4
14250,14250,,23,1,1,2
14251,14251,,43,4,3,7
14252,14252,,3,1,0,1
14253,14253,,3,1,1,2
14254,14254,,127,1,1,2
14255,14255,,43,2,1,3
14256,14256,,23,1,1,2
14257,14257,,23,2,3,5
14258,14258,,66,1,1,2
14259,14259,,23,1,1,2
14260,14260,,8,1,1,2
14261,14261,,23,0,1,1
14262,14262,,8,3,0,3
14263,14263,,15,1,0,1
14264,14264,,14,1,3,4
14265,14265,,8,0,1,1
14266,14266,,15,2,0,2
14267,14267,,45,1,0,1
14268,14268,,8,1,3,4
14269,14269,,127,0,3,3
14270,14270,,8,4,13,17
14271,14271,,14,0,2,2
14272,14272,,8,4,3,7
14273,14273,,105,6,2,8
14274,14274,,8,1,0,1
14275,14275,,21,0,1,1
14276,14276,,127,2,0,2
14277,14277,,11,1,3,4
14278,14278,,111,10,10,20
14279,14279,,14,1,0,1
14280,14280,,43,6,1,7
14281,14281,,127,0,1,1
14282,14282,,15,0,1,1
14283,14283,,76,1,6,7
14284,14284,,23,1,0,1
14285,14285,,23,0,1,1
14286,14286,,23,4,6,10
14287,14287,,8,2,3,5
14288,14288,,8,0,2,2
14289,14289,,76,3,8,11
14290,14290,,14,16,12,28
14291,14291,,14,2,1,3
14292,14292,,43,0,2,2
14293,14293,,15,1,2,3
14294,14294,,120,0,1,1
14295,14295,,8,1,0,1
14296,14296,,3,2,0,2
14297,14297,,8,1,0,1
14298,14298,,23,1,3,4
14299,14299,,8,6,12,18
14300,14300,,127,4,2,6
14301,14301,,11,1,5,6
14302,14302,,127,0,5,5
14303,14303,,76,1,0,1
14304,14304,,3,1,0,1
14305,14305,,21,1,3,4
14306,14306,,23,0,1,1
14307,14307,,0,2,8,10
14308,14308,,8,2,6,8
14309,14309,,23,3,0,3
14310,14310,,21,0,2,2
14311,14311,,3,2,2,4
14312,14312,,21,1,2,3
14313,14313,,43,1,1,2
14314,14314,,8,0,1,1
14315,14315,,23,0,1,1
14316,14316,,43,2,0,2
14317,14317,,127,1,1,2
14318,14318,,23,0,2,2
14319,14319,,15,1,3,4
14320,14320,,15,1,0,1
14321,14321,,23,4,4,8
14322,14322,,23,1,4,5
14323,14323,,23,3,4,7
14324,14324,,23,0,1,1
14325,14325,,127,5,2,7
14326,14326,,8,0,1,1
14327,14327,,43,3,4,7
14328,14328,,15,0,1,1
14329,14329,,23,3,2,5
14330,14330,,8,1,0,1
14331,14331,,6,2,0,2
14332,14332,,14,3,0,3
14333,14333,,8,0,1,1
14334,14334,,23,5,0,5
14335,14335,,8,1,2,3
14336,14336,,0,0,1,1
14337,14337,,15,0,3,3
14338,14338,,0,0,1,1
14339,14339,,21,1,0,1
14340,14340,,43,2,1,3
14341,14341,,23,4,5,9
14342,14342,,105,1,4,5
14343,14343,,105,6,1,7
14344,14344,,88,0,1,1
14345,14345,,15,2,3,5
14346,14346,,3,8,17,25
14347,14347,,45,0,2,2
14348,14348,,88,0,2,2
14349,14349,,111,1,1,2
14350,14350,,15,0,2,2
14351,14351,,15,0,1,1
14352,14352,,14,3,3,6
14353,14353,,11,0,1,1
14354,14354,,11,2,0,2
14355,14355,,31,1,0,1
14356,14356,,8,1,0,1
14357,14357,,8,0,1,1
14358,14358,,15,1,3,4
14359,14359,,8,6,15,21
14360,14360,,0,4,5,9
14361,14361,,8,3,0,3
14362,14362,,76,2,1,3
14363,14363,,14,1,1,2
14364,14364,,14,1,0,1
14365,14365,,76,0,2,2
14366,14366,,76,2,0,2
14367,14367,,5,1,5,6
14368,14368,,5,0,1,1
14369,14369,,6,0,1,1
14370,14370,,23,4,2,6
14371,14371,,23,10,35,45
14372,14372,,127,2,3,5
14373,14373,,8,0,1,1
14374,14374,,3,0,1,1
14375,14375,,3,0,1,1
14376,14376,,3,4,5,9
14377,14377,,45,2,2,4
14378,14378,,21,3,1,4
14379,14379,,127,2,1,3
14380,14380,,23,3,0,3
14381,14381,,21,1,0,1
14382,14382,,21,1,0,1
14383,14383,,21,1,0,1
14384,14384,,11,0,1,1
14385,14385,,45,2,1,3
14386,14386,,45,0,3,3
14387,14387,,43,0,1,1
14388,14388,,43,3,2,5
14389,14389,,43,1,9,10
14390,14390,,0,1,1,2
14391,14391,,3,1,1,2
14392,14392,,14,0,1,1
14393,14393,,76,6,4,10
14394,14394,,23,2,1,3
14395,14395,,52,1,8,9
14396,14396,,109,0,1,1
14397,14397,,109,1,0,1
14398,14398,,52,2,3,5
14399,14399,,127,2,0,2
14400,14400,,21,1,0,1
14401,14401,,23,0,1,1
14402,14402,,52,0,3,3
14403,14403,,23,6,20,26
14404,14404,,45,0,2,2
14405,14405,,21,3,0,3
14406,14406,,14,7,6,13
14407,14407,,3,0,8,8
14408,14408,,3,2,0,2
14409,14409,,14,0,1,1
14410,14410,,43,1,0,1
14411,14411,,14,2,1,3
14412,14412,,31,5,7,12
14413,14413,,23,1,0,1
14414,14414,,76,2,1,3
14415,14415,,15,1,5,6
14416,14416,,23,1,0,1
14417,14417,,43,0,1,1
14418,14418,,21,1,1,2
14419,14419,,15,0,1,1
14420,14420,,18,0,1,1
14421,14421,,127,0,1,1
14422,14422,,23,0,2,2
14423,14423,,105,1,1,2
14424,14424,,45,0,1,1
14425,14425,,11,1,1,2
14426,14426,,11,0,1,1
14427,14427,,11,2,3,5
14428,14428,,8,1,0,1
14429,14429,,8,1,0,1
14430,14430,,43,0,1,1
14431,14431,,8,2,2,4
14432,14432,,14,2,2,4
14433,14433,,14,0,1,1
14434,14434,,43,0,1,1
14435,14435,,3,2,2,4
14436,14436,,23,1,4,5
14437,14437,,21,1,1,2
14438,14438,,8,0,1,1
14439,14439,,8,12,4,16
14440,14440,,0,1,1,2
14441,14441,,8,1,1,2
14442,14442,,8,14,1,15
14443,14443,,14,3,1,4
14444,14444,,21,1,0,1
14445,14445,,8,2,4,6
14446,14446,,11,0,1,1
14447,14447,,23,1,1,2
14448,14448,,6,2,0,2
14449,14449,,11,4,0,4
14450,14450,,8,2,0,2
14451,14451,,23,0,1,1
14452,14452,,18,1,1,2
14453,14453,,18,1,1,2
14454,14454,,127,2,0,2
14455,14455,,111,0,2,2
14456,14456,,111,0,5,5
14457,14457,,111,2,0,2
14458,14458,,111,1,1,2
14459,14459,,105,1,1,2
14460,14460,,88,2,1,3
14461,14461,,88,0,2,2
14462,14462,,6,3,2,5
14463,14463,,127,0,1,1
14464,14464,,23,0,1,1
14465,14465,,23,2,2,4
14466,14466,,5,0,1,1
14467,14467,,11,1,2,3
14468,14468,,8,6,4,10
14469,14469,,8,3,3,6
14470,14470,,5,2,2,4
14471,14471,,3,1,1,2
14472,14472,,21,0,6,6
14473,14473,,66,4,0,4
14474,14474,,21,1,2,3
14475,14475,,3,0,1,1
14476,14476,,3,6,7,13
14477,14477,,21,1,0,1
14478,14478,,21,1,0,1
14479,14479,,21,5,3,8
14480,14480,,21,7,7,14
14481,14481,,31,3,1,4
14482,14482,,110,0,1,1
14483,14483,,110,1,0,1
14484,14484,,11,1,0,1
14485,14485,,43,1,0,1
14486,14486,,23,6,21,27
14487,14487,,127,0,1,1
14488,14488,,120,0,1,1
14489,14489,,14,3,1,4
14490,14490,,43,0,2,2
14491,14491,,8,1,5,6
14492,14492,,0,1,0,1
14493,14493,,23,1,0,1
14494,14494,,23,1,0,1
14495,14495,,127,3,3,6
14496,14496,,127,2,2,4
14497,14497,,0,4,6,10
14498,14498,,15,1,0,1
14499,14499,,23,1,0,1
14500,14500,,8,4,0,4
14501,14501,,8,0,1,1
14502,14502,,18,10,6,16
14503,14503,,8,4,0,4
14504,14504,,8,5,1,6
14505,14505,,43,4,1,5
14506,14506,,8,4,0,4
14507,14507,,5,4,2,6
14508,14508,,5,4,2,6
14509,14509,,127,0,1,1
14510,14510,,31,1,1,2
14511,14511,,127,3,0,3
14512,14512,,8,0,3,3
14513,14513,,8,3,1,4
14514,14514,,15,1,1,2
14515,14515,,111,3,5,8
14516,14516,,8,2,3,5
14517,14517,,31,2,2,4
14518,14518,,31,4,6,10
14519,14519,,31,1,3,4
14520,14520,,3,7,6,13
14521,14521,,8,1,0,1
14522,14522,,11,1,0,1
14523,14523,,23,0,1,1
14524,14524,,0,1,1,2
14525,14525,,111,5,9,14
14526,14526,,14,2,0,2
14527,14527,,45,2,3,5
14528,14528,,45,4,3,7
14529,14529,,127,1,0,1
14530,14530,,23,0,1,1
14531,14531,,45,5,2,7
14532,14532,,6,12,4,16
14533,14533,,8,0,7,7
14534,14534,,8,1,0,1
14535,14535,,8,0,1,1
14536,14536,,127,1,0,1
14537,14537,,8,0,1,1
14538,14538,,23,1,0,1
14539,14539,,23,0,2,2
14540,14540,,45,0,1,1
14541,14541,,23,1,0,1
14542,14542,,6,6,3,9
14543,14543,,15,1,1,2
14544,14544,,43,1,1,2
14545,14545,,120,4,3,7
14546,14546,,23,1,2,3
14547,14547,,21,3,5,8
14548,14548,,23,0,1,1
14549,14549,,45,3,2,5
14550,14550,,23,1,1,2
14551,14551,,23,3,1,4
14552,14552,,23,0,1,1
14553,14553,,8,3,3,6
14554,14554,,88,3,2,5
14555,14555,,112,0,1,1
14556,14556,,112,1,0,1
14557,14557,,23,1,0,1
14558,14558,,111,1,0,1
14559,14559,,23,0,1,1
14560,14560,,127,1,2,3
14561,14561,,111,0,1,1
14562,14562,,76,2,7,9
14563,14563,,11,1,0,1
14564,14564,,127,0,1,1
14565,14565,,11,1,1,2
14566,14566,,21,2,0,2
14567,14567,,21,1,0,1
14568,14568,,21,4,5,9
14569,14569,,11,1,1,2
14570,14570,,24,2,0,2
14571,14571,,11,1,0,1
14572,14572,,45,5,5,10
14573,14573,,23,0,1,1
14574,14574,,8,7,28,35
14575,14575,,113,1,1,2
14576,14576,,113,1,1,2
14577,14577,,45,1,1,2
14578,14578,,0,2,1,3
14579,14579,,31,3,2,5
14580,14580,,114,1,2,3
14581,14581,,114,1,1,2
14582,14582,,11,4,5,9
14583,14583,,0,1,0,1
14584,14584,,52,0,1,1
14585,14585,,43,4,2,6
14586,14586,,45,2,2,4
14587,14587,,43,1,0,1
14588,14588,,43,4,6,10
14589,14589,,45,0,1,1
14590,14590,,111,0,1,1
14591,14591,,8,5,0,5
14592,14592,,8,1,0,1
14593,14593,,8,1,0,1
14594,14594,,14,1,1,2
14595,14595,,31,0,1,1
14596,14596,,120,1,3,4
14597,14597,,120,1,1,2
14598,14598,,23,0,1,1
14599,14599,,18,2,3,5
14600,14600,,23,0,1,1
14601,14601,,120,2,0,2
14602,14602,,31,0,3,3
14603,14603,,23,1,0,1
14604,14604,,8,0,1,1
14605,14605,,14,1,0,1
14606,14606,,23,0,2,2
14607,14607,,3,0,1,1
14608,14608,,0,0,2,2
14609,14609,,23,7,12,19
14610,14610,,8,2,1,3
14611,14611,,23,2,3,5
14612,14612,,23,1,1,2
14613,14613,,76,1,3,4
14614,14614,,127,0,1,1
14615,14615,,24,8,2,10
14616,14616,,15,1,0,1
14617,14617,,88,1,0,1
14618,14618,,111,3,0,3
14619,14619,,18,1,0,1
14620,14620,,127,1,1,2
14621,14621,,8,1,0,1
14622,14622,,8,1,4,5
14623,14623,,43,1,0,1
14624,14624,,14,2,0,2
14625,14625,,111,0,4,4
14626,14626,,24,1,1,2
14627,14627,,8,2,5,7
14628,14628,,127,0,2,2
14629,14629,,105,0,1,1
14630,14630,,23,0,2,2
14631,14631,,8,0,1,1
14632,14632,,18,1,0,1
14633,14633,,8,0,1,1
14634,14634,,127,3,2,5
14635,14635,,127,0,6,6
14636,14636,,8,0,1,1
14637,14637,,15,0,2,2
14638,14638,,45,1,4,5
14639,14639,,18,1,0,1
14640,14640,,111,2,2,4
14641,14641,,18,0,4,4
14642,14642,,18,1,0,1
14643,14643,,14,2,1,3
14644,14644,,14,1,1,2
14645,14645,,8,3,0,3
14646,14646,,21,0,2,2
14647,14647,,21,2,2,4
14648,14648,,11,2,0,2
14649,14649,,11,0,1,1
14650,14650,,43,0,1,1
14651,14651,,88,5,2,7
14652,14652,,21,0,3,3
14653,14653,,21,1,0,1
14654,14654,,21,6,5,11
14655,14655,,21,2,1,3
14656,14656,,114,1,0,1
14657,14657,,115,0,1,1
14658,14658,,115,1,0,1
14659,14659,,8,2,2,4
14660,14660,,43,1,0,1
14661,14661,,43,4,1,5
14662,14662,,43,0,3,3
14663,14663,,127,2,3,5
14664,14664,,127,0,1,1
14665,14665,,52,0,1,1
14666,14666,,52,1,2,3
14667,14667,,120,2,8,10
14668,14668,,23,2,2,4
14669,14669,,52,1,0,1
14670,14670,,24,1,0,1
14671,14671,,8,7,10,17
14672,14672,,8,1,1,2
14673,14673,,23,1,0,1
14674,14674,,127,0,3,3
14675,14675,,111,0,4,4
14676,14676,,111,0,2,2
14677,14677,,23,11,11,22
14678,14678,,52,1,1,2
14679,14679,,52,3,3,6
14680,14680,,0,1,1,2
14681,14681,,18,1,2,3
14682,14682,,116,0,1,1
14683,14683,,116,1,0,1
14684,14684,,8,0,3,3
14685,14685,,8,3,1,4
14686,14686,,76,1,2,3
14687,14687,,8,1,1,2
14688,14688,,11,1,3,4
14689,14689,,111,3,0,3
14690,14690,,111,0,1,1
14691,14691,,8,6,4,10
14692,14692,,23,1,0,1
14693,14693,,11,1,5,6
14694,14694,,14,0,1,1
14695,14695,,8,1,0,1
14696,14696,,23,2,4,6
14697,14697,,31,0,2,2
14698,14698,,111,0,1,1
14699,14699,,6,0,1,1
14700,14700,,23,7,7,14
14701,14701,,127,1,1,2
14702,14702,,23,0,3,3
14703,14703,,23,2,2,4
14704,14704,,15,1,0,1
14705,14705,,15,1,0,1
14706,14706,,23,0,1,1
14707,14707,,8,1,0,1
14708,14708,,45,1,0,1
14709,14709,,45,1,0,1
14710,14710,,21,2,2,4
14711,14711,,8,5,1,6
14712,14712,,11,5,2,7
14713,14713,,111,4,0,4
14714,14714,,0,2,1,3
14715,14715,,15,1,0,1
14716,14716,,23,5,5,10
14717,14717,,111,0,1,1
14718,14718,,43,2,0,2
14719,14719,,23,1,2,3
14720,14720,,14,7,2,9
14721,14721,,21,2,5,7
14722,14722,,14,2,3,5
14723,14723,,127,1,3,4
14724,14724,,45,2,3,5
14725,14725,,43,1,1,2
14726,14726,,14,1,0,1
14727,14727,,117,0,1,1
14728,14728,,117,1,0,1
14729,14729,,52,14,9,23
14730,14730,,23,1,1,2
14731,14731,,23,1,1,2
14732,14732,,8,0,1,1
14733,14733,,23,1,3,4
14734,14734,,8,1,4,5
14735,14735,,118,0,1,1
14736,14736,,118,1,0,1
14737,14737,,21,5,2,7
14738,14738,,3,2,1,3
14739,14739,,8,1,0,1
14740,14740,,31,1,1,2
14741,14741,,43,1,0,1
14742,14742,,3,0,1,1
14743,14743,,43,2,5,7
14744,14744,,0,0,4,4
14745,14745,,14,1,5,6
14746,14746,,14,1,0,1
14747,14747,,23,1,2,3
14748,14748,,23,0,1,1
14749,14749,,43,2,0,2
14750,14750,,11,2,4,6
14751,14751,,66,1,0,1
14752,14752,,0,1,1,2
14753,14753,,111,1,1,2
14754,14754,,11,0,2,2
14755,14755,,88,4,9,13
14756,14756,,23,0,2,2
14757,14757,,23,1,0,1
14758,14758,,15,3,0,3
14759,14759,,127,1,2,3
14760,14760,,8,0,1,1
14761,14761,,127,1,6,7
14762,14762,,23,0,1,1
14763,14763,,21,4,3,7
14764,14764,,21,1,1,2
14765,14765,,45,3,2,5
14766,14766,,45,1,0,1
14767,14767,,105,2,1,3
14768,14768,,3,1,0,1
14769,14769,,15,2,0,2
14770,14770,,11,0,2,2
14771,14771,,11,0,1,1
14772,14772,,31,2,2,4
14773,14773,,8,2,0,2
14774,14774,,14,9,7,16
14775,14775,,23,0,1,1
14776,14776,,127,4,4,8
14777,14777,,8,2,4,6
14778,14778,,8,1,1,2
14779,14779,,23,1,2,3
14780,14780,,23,1,0,1
14781,14781,,21,1,1,2
14782,14782,,15,0,1,1
14783,14783,,15,14,10,24
14784,14784,,14,6,5,11
14785,14785,,43,0,2,2
14786,14786,,14,1,0,1
14787,14787,,14,0,1,1
14788,14788,,43,1,0,1
14789,14789,,88,2,0,2
14790,14790,,88,2,2,4
14791,14791,,0,1,1,2
14792,14792,,8,1,0,1
14793,14793,,88,0,1,1
14794,14794,,15,1,0,1
14795,14795,,119,0,1,1
14796,14796,,119,1,0,1
14797,14797,,23,1,1,2
14798,14798,,111,2,1,3
14799,14799,,0,2,2,4
14800,14800,,23,0,1,1
14801,14801,,127,0,1,1
14802,14802,,52,0,2,2
14803,14803,,21,0,2,2
14804,14804,,21,1,0,1
14805,14805,,8,1,0,1
14806,14806,,111,8,11,19
14807,14807,,0,0,1,1
14808,14808,,120,8,5,13
14809,14809,,43,3,2,5
14810,14810,,43,1,0,1
14811,14811,,43,1,1,2
14812,14812,,43,5,5,10
14813,14813,,14,5,4,9
14814,14814,,14,7,3,10
14815,14815,,31,2,1,3
14816,14816,,31,0,1,1
14817,14817,,8,0,13,13
14818,14818,,23,0,1,1
14819,14819,,31,1,0,1
14820,14820,,111,1,2,3
14821,14821,,31,0,3,3
14822,14822,,14,2,0,2
14823,14823,,0,4,0,4
14824,14824,,111,0,2,2
14825,14825,,23,2,0,2
14826,14826,,0,0,1,1
14827,14827,,23,0,1,1
14828,14828,,105,1,1,2
14829,14829,,3,0,2,2
14830,14830,,76,0,5,5
14831,14831,,111,1,0,1
14832,14832,,11,1,2,3
14833,14833,,23,0,2,2
14834,14834,,127,8,13,21
14835,14835,,127,2,1,3
14836,14836,,11,1,0,1
14837,14837,,23,0,2,2
14838,14838,,111,0,1,1
14839,14839,,0,0,2,2
14840,14840,,8,1,3,4
14841,14841,,14,0,1,1
14842,14842,,14,4,3,7
14843,14843,,23,0,1,1
14844,14844,,127,4,9,13
14845,14845,,11,0,1,1
14846,14846,,8,0,1,1
14847,14847,,23,1,0,1
14848,14848,,11,1,1,2
14849,14849,,23,5,4,9
14850,14850,,15,1,1,2
14851,14851,,14,3,1,4
14852,14852,,76,1,2,3
14853,14853,,11,1,1,2
14854,14854,,0,2,2,4
14855,14855,,21,4,0,4
14856,14856,,8,0,1,1
14857,14857,,3,1,0,1
14858,14858,,23,2,1,3
14859,14859,,23,5,4,9
14860,14860,,23,11,17,28
14861,14861,,76,2,0,2
14862,14862,,8,1,4,5
14863,14863,,23,1,1,2
14864,14864,,0,1,0,1
14865,14865,,3,0,1,1
14866,14866,,3,0,1,1
14867,14867,,3,0,1,1
14868,14868,,23,1,0,1
14869,14869,,21,3,6,9
14870,14870,,127,3,3,6
14871,14871,,24,0,1,1
14872,14872,,43,0,1,1
14873,14873,,8,0,2,2
14874,14874,,43,0,1,1
14875,14875,,127,3,5,8
14876,14876,,23,0,1,1
14877,14877,,3,2,1,3
14878,14878,,52,0,1,1
14879,14879,,52,5,0,5
14880,14880,,23,1,1,2
14881,14881,,43,1,2,3
14882,14882,,43,0,2,2
14883,14883,,52,44,17,61
14884,14884,,23,3,2,5
14885,14885,,11,2,0,2
14886,14886,,24,1,0,1
14887,14887,,52,2,3,5
14888,14888,,8,1,0,1
14889,14889,,8,1,1,2
14890,14890,,8,0,1,1
14891,14891,,23,0,1,1
14892,14892,,8,1,1,2
14893,14893,,18,5,11,16
14894,14894,,18,2,3,5
14895,14895,,111,0,1,1
14896,14896,,8,0,3,3
14897,14897,,14,1,0,1
14898,14898,,23,0,1,1
14899,14899,,31,0,1,1
14900,14900,,127,0,1,1
14901,14901,,8,3,4,7
14902,14902,,31,0,1,1
14903,14903,,15,2,1,3
14904,14904,,121,0,1,1
14905,14905,,121,1,0,1
14906,14906,,8,0,1,1
14907,14907,,8,2,1,3
14908,14908,,23,1,1,2
14909,14909,,23,0,1,1
14910,14910,,127,3,3,6
14911,14911,,76,0,1,1
14912,14912,,76,0,6,6
14913,14913,,8,0,2,2
14914,14914,,8,5,3,8
14915,14915,,8,0,1,1
14916,14916,,8,1,1,2
14917,14917,,8,2,3,5
14918,14918,,122,0,1,1
14919,14919,,122,1,0,1
14920,14920,,23,1,0,1
14921,14921,,0,0,2,2
14922,14922,,8,0,1,1
14923,14923,,43,7,6,13
14924,14924,,23,4,2,6
14925,14925,,127,1,0,1
14926,14926,,3,0,1,1
14927,14927,,3,0,1,1
14928,14928,,88,1,1,2
14929,14929,,3,2,0,2
14930,14930,,0,1,2,3
14931,14931,,0,1,0,1
14932,14932,,127,0,1,1
14933,14933,,43,0,2,2
14934,14934,,5,5,5,10
14935,14935,,18,1,2,3
14936,14936,,3,0,1,1
14937,14937,,52,0,1,1
14938,14938,,5,0,2,2
14939,14939,,23,0,1,1
14940,14940,,23,0,1,1
14941,14941,,21,1,1,2
14942,14942,,21,1,0,1
14943,14943,,23,2,2,4
14944,14944,,21,0,5,5
14945,14945,,21,1,0,1
14946,14946,,21,0,1,1
14947,14947,,3,2,0,2
14948,14948,,11,1,2,3
14949,14949,,11,4,5,9
14950,14950,,8,3,1,4
14951,14951,,45,14,17,31
14952,14952,,23,0,1,1
14953,14953,,8,1,2,3
14954,14954,,8,0,1,1
14955,14955,,11,1,0,1
14956,14956,,8,1,2,3
14957,14957,,43,6,14,20
14958,14958,,120,0,1,1
14959,14959,,0,1,0,1
14960,14960,,127,1,1,2
14961,14961,,52,3,9,12
14962,14962,,5,1,0,1
14963,14963,,5,2,7,9
14964,14964,,23,1,0,1
14965,14965,,5,0,1,1
14966,14966,,43,0,1,1
14967,14967,,18,2,0,2
14968,14968,,43,2,3,5
14969,14969,,23,0,1,1
14970,14970,,111,0,4,4
14971,14971,,23,0,2,2
14972,14972,,3,1,0,1
14973,14973,,88,1,1,2
14974,14974,,127,1,2,3
14975,14975,,76,3,0,3
14976,14976,,43,0,1,1
14977,14977,,23,3,1,4
14978,14978,,23,0,1,1
14979,14979,,6,2,2,4
14980,14980,,11,0,2,2
14981,14981,,3,1,0,1
14982,14982,,3,1,0,1
14983,14983,,15,2,1,3
14984,14984,,8,1,0,1
14985,14985,,8,1,0,1
14986,14986,,0,0,2,2
14987,14987,,6,2,7,9
14988,14988,,31,0,1,1
14989,14989,,88,0,2,2
14990,14990,,31,1,0,1
14991,14991,,15,5,2,7
14992,14992,,14,0,1,1
14993,14993,,6,2,0,2
14994,14994,,123,0,1,1
14995,14995,,123,1,0,1
14996,14996,,23,0,2,2
14997,14997,,23,1,1,2
14998,14998,,8,0,2,2
14999,14999,,8,7,7,14
15000,15000,,23,0,1,1
15001,15001,,23,1,1,2
15002,15002,,0,1,2,3
15003,15003,,0,0,1,1
15004,15004,,31,1,1,2
15005,15005,,11,2,3,5
15006,15006,,3,1,3,4
15007,15007,,43,2,1,3
15008,15008,,127,3,3,6
15009,15009,,124,1,1,2
15010,15010,,124,1,1,2
15011,15011,,3,1,3,4
15012,15012,,111,1,0,1
15013,15013,,14,6,5,11
15014,15014,,8,0,2,2
15015,15015,,23,0,1,1
15016,15016,,14,0,3,3
15017,15017,,23,0,1,1
15018,15018,,0,5,5,10
15019,15019,,23,4,4,8
15020,15020,,23,4,3,7
15021,15021,,8,1,1,2
15022,15022,,3,10,14,24
15023,15023,,18,5,1,6
15024,15024,,88,0,3,3
15025,15025,,3,0,1,1
15026,15026,,21,0,1,1
15027,15027,,23,1,1,2
15028,15028,,23,1,7,8
15029,15029,,23,3,2,5
15030,15030,,76,1,1,2
15031,15031,,23,1,0,1
15032,15032,,0,1,0,1
15033,15033,,21,2,0,2
15034,15034,,8,2,3,5
15035,15035,,23,2,0,2
15036,15036,,23,0,2,2
15037,15037,,3,1,2,3
15038,15038,,3,0,1,1
15039,15039,,11,2,0,2
15040,15040,,127,0,2,2
15041,15041,,11,1,1,2
15042,15042,,0,1,1,2
15043,15043,,0,1,1,2
15044,15044,,8,1,0,1
15045,15045,,8,0,2,2
15046,15046,,0,2,3,5
15047,15047,,11,0,1,1
15048,15048,,3,0,1,1
15049,15049,,43,0,1,1
15050,15050,,21,0,1,1
15051,15051,,127,0,1,1
15052,15052,,127,1,1,2
15053,15053,,45,1,0,1
15054,15054,,125,0,1,1
15055,15055,,125,1,0,1
15056,15056,,8,0,1,1
15057,15057,,8,2,1,3
15058,15058,,11,2,3,5
15059,15059,,11,3,4,7
15060,15060,,45,0,1,1
15061,15061,,52,2,4,6
15062,15062,,52,4,2,6
15063,15063,,111,2,0,2
15064,15064,,88,1,0,1
15065,15065,,3,0,2,2
15066,15066,,0,10,0,10
15067,15067,,0,0,2,2
15068,15068,,14,0,1,1
15069,15069,,43,0,1,1
15070,15070,,52,3,1,4
15071,15071,,127,0,1,1
15072,15072,,43,3,18,21
15073,15073,,8,0,1,1
15074,15074,,105,2,0,2
15075,15075,,45,1,2,3
15076,15076,,23,0,1,1
15077,15077,,23,0,1,1
15078,15078,,88,1,0,1
15079,15079,,8,4,3,7
15080,15080,,8,1,1,2
15081,15081,,0,3,0,3
15082,15082,,127,1,0,1
15083,15083,,18,0,3,3
15084,15084,,127,4,0,4
15085,15085,,127,3,1,4
15086,15086,,23,1,0,1
15087,15087,,52,1,0,1
15088,15088,,8,1,1,2
15089,15089,,8,1,0,1
15090,15090,,111,0,1,1
15091,15091,,0,0,1,1
15092,15092,,23,1,3,4
15093,15093,,23,0,1,1
15094,15094,,23,2,0,2
15095,15095,,23,1,0,1
15096,15096,,88,3,1,4
15097,15097,,8,0,1,1
15098,15098,,15,2,2,4
15099,15099,,31,1,2,3
15100,15100,,76,3,1,4
15101,15101,,15,0,2,2
15102,15102,,76,0,2,2
15103,15103,,15,1,1,2
15104,15104,,15,1,1,2
15105,15105,,23,0,2,2
15106,15106,,23,4,1,5
15107,15107,,23,0,2,2
15108,15108,,23,2,3,5
15109,15109,,23,2,2,4
15110,15110,,88,2,1,3
15111,15111,,23,0,2,2
15112,15112,,23,1,0,1
15113,15113,,15,0,1,1
15114,15114,,0,1,0,1
15115,15115,,0,2,0,2
15116,15116,,126,0,1,1
15117,15117,,126,1,0,1
15118,15118,,0,0,2,2
15119,15119,,8,2,1,3
15120,15120,,23,3,3,6
15121,15121,,5,2,2,4
15122,15122,,31,1,0,1
15123,15123,,23,1,0,1
15124,15124,,8,2,0,2
15125,15125,,23,1,0,1
15126,15126,,23,2,3,5
15127,15127,,23,3,5,8
15128,15128,,23,1,10,11
15129,15129,,8,1,0,1
15130,15130,,8,1,1,2
15131,15131,,8,1,1,2
15132,15132,,15,1,1,2
15133,15133,,15,2,1,3
15134,15134,,15,0,2,2
15135,15135,,66,1,0,1
15136,15136,,8,1,2,3
15137,15137,,66,1,0,1
15138,15138,,3,0,3,3
15139,15139,,127,1,1,2
15140,15140,,127,1,0,1
15141,15141,,11,0,1,1
15142,15142,,43,0,2,2
15143,15143,,43,1,2,3
15144,15144,,31,2,1,3
15145,15145,,23,1,0,1
15146,15146,,43,0,2,2
15147,15147,,21,1,0,1
15148,15148,,66,2,0,2
15149,15149,,23,23,11,34
15150,15150,,52,0,1,1
15151,15151,,111,0,7,7
15152,15152,,15,1,2,3
15153,15153,,3,2,2,4
15154,15154,,66,0,2,2
15155,15155,,66,1,0,1
15156,15156,,23,0,1,1
15157,15157,,23,0,1,1
15158,15158,,76,2,0,2
15159,15159,,0,1,0,1
15160,15160,,23,1,1,2
15161,15161,,8,0,1,1
15162,15162,,111,0,1,1
15163,15163,,6,0,1,1
15164,15164,,15,2,2,4
15165,15165,,14,1,0,1
15166,15166,,45,2,5,7
15167,15167,,31,2,2,4
15168,15168,,66,0,2,2
15169,15169,,31,0,6,6
15170,15170,,31,1,0,1
15171,15171,,76,2,6,8
15172,15172,,14,1,1,2
15173,15173,,23,0,1,1
15174,15174,,43,1,1,2
15175,15175,,18,1,2,3
15176,15176,,127,2,0,2
15177,15177,,127,0,4,4
15178,15178,,8,0,1,1
15179,15179,,23,0,4,4
15180,15180,,8,1,4,5
15181,15181,,8,1,0,1
15182,15182,,194,3,1,4
15183,15183,,127,6,1,7
15184,15184,,127,3,0,3
15185,15185,,23,1,0,1
15186,15186,,15,2,1,3
15187,15187,,23,1,2,3
15188,15188,,23,0,1,1
15189,15189,,11,2,2,4
15190,15190,,11,1,1,2
15191,15191,,0,2,0,2
15192,15192,,23,1,1,2
15193,15193,,15,0,1,1
15194,15194,,8,0,1,1
15195,15195,,8,3,1,4
15196,15196,,31,0,2,2
15197,15197,,8,1,3,4
15198,15198,,105,1,0,1
15199,15199,,23,1,3,4
15200,15200,,111,0,7,7
15201,15201,,8,2,0,2
15202,15202,,8,3,1,4
15203,15203,,8,0,2,2
15204,15204,,23,1,0,1
15205,15205,,128,0,1,1
15206,15206,,128,1,0,1
15207,15207,,15,1,0,1
15208,15208,,21,0,1,1
15209,15209,,21,1,1,2
15210,15210,,21,2,3,5
15211,15211,,21,4,0,4
15212,15212,,23,1,0,1
15213,15213,,8,0,2,2
15214,15214,,8,1,0,1
15215,15215,,43,0,1,1
15216,15216,,43,1,1,2
15217,15217,,8,0,1,1
15218,15218,,14,1,1,2
15219,15219,,43,0,1,1
15220,15220,,43,0,1,1
15221,15221,,14,5,5,10
15222,15222,,129,1,1,2
15223,15223,,129,1,1,2
15224,15224,,127,0,1,1
15225,15225,,3,0,4,4
15226,15226,,23,1,2,3
15227,15227,,0,0,1,1
15228,15228,,0,0,1,1
15229,15229,,11,1,0,1
15230,15230,,3,0,1,1
15231,15231,,23,0,1,1
15232,15232,,3,0,1,1
15233,15233,,23,0,2,2
15234,15234,,88,1,19,20
15235,15235,,8,1,1,2
15236,15236,,23,1,0,1
15237,15237,,8,6,0,6
15238,15238,,15,0,1,1
15239,15239,,8,0,3,3
15240,15240,,23,2,4,6
15241,15241,,14,3,0,3
15242,15242,,105,15,11,26
15243,15243,,111,0,1,1
15244,15244,,23,0,1,1
15245,15245,,23,1,1,2
15246,15246,,23,0,1,1
15247,15247,,127,0,1,1
15248,15248,,88,2,0,2
15249,15249,,43,0,1,1
15250,15250,,105,1,0,1
15251,15251,,130,0,2,2
15252,15252,,130,2,0,2
15253,15253,,66,2,0,2
15254,15254,,0,0,1,1
15255,15255,,8,1,0,1
15256,15256,,23,0,1,1
15257,15257,,0,2,2,4
15258,15258,,0,2,2,4
15259,15259,,43,4,13,17
15260,15260,,45,0,1,1
15261,15261,,43,1,4,5
15262,15262,,43,2,0,2
15263,15263,,43,0,1,1
15264,15264,,43,0,1,1
15265,15265,,0,1,0,1
15266,15266,,11,1,3,4
15267,15267,,3,2,0,2
15268,15268,,120,5,2,7
15269,15269,,127,6,1,7
15270,15270,,8,2,0,2
15271,15271,,120,0,1,1
15272,15272,,105,0,1,1
15273,15273,,43,0,1,1
15274,15274,,120,2,1,3
15275,15275,,15,0,3,3
15276,15276,,11,1,0,1
15277,15277,,8,2,0,2
15278,15278,,0,3,3,6
15279,15279,,0,0,1,1
15280,15280,,23,1,1,2
15281,15281,,43,1,0,1
15282,15282,,3,0,1,1
15283,15283,,21,4,0,4
15284,15284,,21,0,1,1
15285,15285,,21,1,2,3
15286,15286,,21,1,0,1
15287,15287,,24,1,0,1
15288,15288,,127,1,0,1
15289,15289,,5,2,0,2
15290,15290,,5,2,0,2
15291,15291,,11,0,1,1
15292,15292,,0,0,1,1
15293,15293,,127,0,1,1
15294,15294,,0,0,2,2
15295,15295,,8,0,1,1
15296,15296,,127,0,1,1
15297,15297,,6,8,11,19
15298,15298,,8,1,1,2
15299,15299,,127,3,1,4
15300,15300,,43,0,1,1
15301,15301,,23,4,0,4
15302,15302,,8,1,0,1
15303,15303,,0,3,1,4
15304,15304,,23,1,0,1
15305,15305,,23,1,0,1
15306,15306,,52,3,5,8
15307,15307,,111,7,3,10
15308,15308,,45,3,3,6
15309,15309,,15,1,2,3
15310,15310,,6,3,26,29
15311,15311,,6,0,2,2
15312,15312,,15,1,0,1
15313,15313,,23,0,1,1
15314,15314,,8,1,1,2
15315,15315,,31,0,1,1
15316,15316,,18,2,2,4
15317,15317,,23,1,5,6
15318,15318,,8,2,2,4
15319,15319,,15,0,1,1
15320,15320,,15,0,1,1
15321,15321,,23,29,24,53
15322,15322,,23,1,0,1
15323,15323,,23,1,1,2
15324,15324,,14,0,1,1
15325,15325,,23,7,8,15
15326,15326,,23,0,1,1
15327,15327,,6,6,6,12
15328,15328,,8,1,3,4
15329,15329,,0,0,1,1
15330,15330,,88,1,1,2
15331,15331,,15,0,3,3
15332,15332,,23,2,2,4
15333,15333,,5,4,2,6
15334,15334,,88,0,2,2
15335,15335,,66,0,1,1
15336,15336,,66,1,0,1
15337,15337,,66,1,4,5
15338,15338,,5,0,1,1
15339,15339,,15,2,6,8
15340,15340,,8,0,1,1
15341,15341,,23,2,0,2
15342,15342,,3,2,0,2
15343,15343,,23,1,0,1
15344,15344,,31,2,0,2
15345,15345,,23,3,0,3
15346,15346,,23,1,3,4
15347,15347,,31,2,0,2
15348,15348,,11,0,1,1
15349,15349,,8,0,1,1
15350,15350,,111,1,0,1
15351,15351,,23,1,0,1
15352,15352,,0,0,2,2
15353,15353,,5,1,1,2
15354,15354,,127,5,8,13
15355,15355,,23,4,2,6
15356,15356,,131,0,1,1
15357,15357,,131,1,0,1
15358,15358,,23,2,2,4
15359,15359,,43,0,1,1
15360,15360,,43,0,1,1
15361,15361,,105,1,1,2
15362,15362,,23,4,3,7
15363,15363,,21,2,1,3
15364,15364,,105,1,0,1
15365,15365,,127,0,2,2
15366,15366,,43,0,3,3
15367,15367,,8,1,0,1
15368,15368,,111,3,0,3
15369,15369,,76,0,1,1
15370,15370,,111,1,0,1
15371,15371,,111,3,1,4
15372,15372,,23,1,0,1
15373,15373,,8,2,0,2
15374,15374,,8,1,0,1
15375,15375,,43,1,3,4
15376,15376,,43,0,1,1
15377,15377,,0,0,1,1
15378,15378,,6,0,3,3
15379,15379,,127,1,0,1
15380,15380,,23,2,1,3
15381,15381,,23,2,2,4
15382,15382,,8,2,2,4
15383,15383,,0,1,6,7
15384,15384,,45,0,3,3
15385,15385,,11,0,1,1
15386,15386,,11,2,1,3
15387,15387,,11,2,1,3
15388,15388,,14,1,0,1
15389,15389,,23,0,1,1
15390,15390,,127,0,7,7
15391,15391,,127,3,0,3
15392,15392,,8,0,1,1
15393,15393,,120,1,0,1
15394,15394,,105,2,0,2
15395,15395,,8,1,2,3
15396,15396,,0,0,1,1
15397,15397,,23,1,1,2
15398,15398,,8,1,0,1
15399,15399,,0,0,1,1
15400,15400,,105,3,3,6
15401,15401,,105,1,0,1
15402,15402,,105,1,1,2
15403,15403,,15,3,3,6
15404,15404,,18,2,3,5
15405,15405,,23,0,3,3
15406,15406,,23,1,1,2
15407,15407,,21,1,2,3
15408,15408,,21,2,1,3
15409,15409,,15,2,0,2
15410,15410,,15,0,1,1
15411,15411,,21,2,0,2
15412,15412,,23,0,1,1
15413,15413,,8,2,1,3
15414,15414,,21,1,2,3
15415,15415,,23,0,1,1
15416,15416,,127,0,2,2
15417,15417,,127,1,0,1
15418,15418,,6,0,1,1
15419,15419,,18,2,0,2
15420,15420,,8,0,4,4
15421,15421,,45,3,0,3
15422,15422,,0,1,1,2
15423,15423,,23,1,2,3
15424,15424,,5,13,10,23
15425,15425,,8,0,1,1
15426,15426,,21,1,1,2
15427,15427,,88,4,2,6
15428,15428,,88,0,1,1
15429,15429,,52,4,5,9
15430,15430,,8,2,1,3
15431,15431,,132,0,1,1
15432,15432,,132,1,0,1
15433,15433,,14,1,0,1
15434,15434,,127,3,6,9
15435,15435,,23,2,0,2
15436,15436,,23,2,1,3
15437,15437,,14,3,0,3
15438,15438,,23,3,1,4
15439,15439,,23,0,1,1
15440,15440,,14,4,1,5
15441,15441,,76,5,3,8
15442,15442,,23,0,1,1
15443,15443,,24,15,7,22
15444,15444,,66,3,3,6
15445,15445,,66,2,0,2
15446,15446,,3,1,1,2
15447,15447,,21,1,0,1
15448,15448,,24,0,2,2
15449,15449,,111,3,0,3
15450,15450,,24,0,1,1
15451,15451,,31,2,0,2
15452,15452,,11,1,1,2
15453,15453,,11,1,1,2
15454,15454,,23,1,0,1
15455,15455,,11,2,2,4
15456,15456,,3,0,1,1
15457,15457,,64,1,1,2
15458,15458,,133,1,1,2
15459,15459,,133,1,1,2
15460,15460,,23,0,5,5
15461,15461,,43,2,0,2
15462,15462,,43,0,3,3
15463,15463,,43,0,7,7
15464,15464,,43,5,8,13
15465,15465,,23,0,1,1
15466,15466,,14,0,2,2
15467,15467,,14,1,0,1
15468,15468,,52,2,1,3
15469,15469,,127,0,1,1
15470,15470,,127,1,0,1
15471,15471,,23,3,1,4
15472,15472,,15,1,1,2
15473,15473,,14,8,10,18
15474,15474,,23,1,0,1
15475,15475,,8,1,0,1
15476,15476,,43,1,0,1
15477,15477,,52,0,2,2
15478,15478,,8,3,0,3
15479,15479,,8,2,1,3
15480,15480,,23,4,4,8
15481,15481,,23,0,1,1
15482,15482,,6,1,0,1
15483,15483,,23,1,0,1
15484,15484,,23,4,0,4
15485,15485,,88,0,2,2
15486,15486,,11,1,0,1
15487,15487,,23,5,4,9
15488,15488,,23,2,2,4
15489,15489,,111,0,3,3
15490,15490,,14,1,0,1
15491,15491,,8,0,1,1
15492,15492,,8,1,2,3
15493,15493,,8,4,5,9
15494,15494,,8,2,1,3
15495,15495,,11,0,1,1
15496,15496,,23,1,2,3
15497,15497,,23,0,1,1
15498,15498,,6,3,3,6
15499,15499,,43,1,0,1
15500,15500,,23,2,1,3
15501,15501,,31,1,2,3
15502,15502,,23,3,3,6
15503,15503,,11,1,0,1
15504,15504,,23,0,1,1
15505,15505,,23,1,0,1
15506,15506,,8,0,3,3
15507,15507,,15,1,0,1
15508,15508,,23,1,0,1
15509,15509,,23,0,1,1
15510,15510,,6,3,1,4
15511,15511,,23,5,4,9
15512,15512,,6,1,0,1
15513,15513,,6,2,0,2
15514,15514,,14,0,2,2
15515,15515,,24,4,4,8
15516,15516,,23,0,1,1
15517,15517,,0,0,4,4
15518,15518,,23,0,1,1
15519,15519,,5,2,1,3
15520,15520,,23,0,1,1
15521,15521,,11,0,1,1
15522,15522,,105,1,1,2
15523,15523,,8,2,2,4
15524,15524,,23,0,1,1
15525,15525,,76,1,0,1
15526,15526,,23,1,0,1
15527,15527,,43,1,3,4
15528,15528,,43,1,0,1
15529,15529,,127,1,2,3
15530,15530,,127,0,1,1
15531,15531,,15,1,1,2
15532,15532,,127,4,2,6
15533,15533,,111,0,2,2
15534,15534,,8,0,1,1
15535,15535,,23,0,1,1
15536,15536,,8,0,1,1
15537,15537,,0,0,1,1
15538,15538,,11,0,4,4
15539,15539,,8,2,1,3
15540,15540,,23,2,3,5
15541,15541,,15,1,0,1
15542,15542,,134,1,1,2
15543,15543,,134,1,1,2
15544,15544,,127,2,0,2
15545,15545,,88,2,4,6
15546,15546,,18,1,3,4
15547,15547,,43,1,2,3
15548,15548,,6,0,2,2
15549,15549,,0,1,11,12
15550,15550,,23,1,1,2
15551,15551,,23,1,0,1
15552,15552,,0,1,1,2
15553,15553,,15,4,3,7
15554,15554,,18,9,12,21
15555,15555,,23,0,1,1
15556,15556,,8,2,0,2
15557,15557,,23,1,1,2
15558,15558,,88,0,3,3
15559,15559,,14,3,4,7
15560,15560,,23,1,2,3
15561,15561,,23,2,4,6
15562,15562,,23,0,3,3
15563,15563,,43,0,3,3
15564,15564,,8,0,5,5
15565,15565,,15,2,0,2
15566,15566,,23,2,0,2
15567,15567,,15,0,1,1
15568,15568,,21,0,1,1
15569,15569,,0,0,1,1
15570,15570,,8,3,3,6
15571,15571,,8,1,0,1
15572,15572,,8,1,0,1
15573,15573,,21,3,1,4
15574,15574,,21,1,0,1
15575,15575,,23,2,2,4
15576,15576,,111,1,0,1
15577,15577,,43,1,1,2
15578,15578,,23,9,8,17
15579,15579,,24,1,0,1
15580,15580,,66,2,0,2
15581,15581,,6,0,1,1
15582,15582,,3,1,1,2
15583,15583,,14,0,1,1
15584,15584,,23,2,4,6
15585,15585,,43,4,0,4
15586,15586,,43,2,1,3
15587,15587,,23,0,1,1
15588,15588,,23,0,1,1
15589,15589,,14,0,1,1
15590,15590,,14,1,1,2
15591,15591,,23,1,0,1
15592,15592,,24,1,0,1
15593,15593,,21,115,171,286
15594,15594,,3,0,4,4
15595,15595,,6,3,2,5
15596,15596,,120,15,8,23
15597,15597,,43,1,0,1
15598,15598,,21,2,1,3
15599,15599,,23,4,5,9
15600,15600,,43,0,2,2
15601,15601,,21,24,54,78
15602,15602,,66,2,0,2
15603,15603,,11,0,1,1
15604,15604,,0,1,1,2
15605,15605,,45,5,0,5
15606,15606,,8,0,1,1
15607,15607,,31,1,0,1
15608,15608,,5,3,2,5
15609,15609,,23,0,1,1
15610,15610,,43,0,1,1
15611,15611,,43,3,5,8
15612,15612,,3,3,3,6
15613,15613,,5,3,0,3
15614,15614,,24,1,0,1
15615,15615,,21,0,1,1
15616,15616,,76,1,5,6
15617,15617,,105,3,2,5
15618,15618,,8,0,1,1
15619,15619,,15,6,2,8
15620,15620,,8,1,0,1
15621,15621,,21,0,1,1
15622,15622,,21,1,1,2
15623,15623,,8,0,5,5
15624,15624,,105,0,1,1
15625,15625,,127,1,3,4
15626,15626,,14,0,1,1
15627,15627,,21,2,6,8
15628,15628,,8,0,5,5
15629,15629,,8,1,1,2
15630,15630,,52,0,1,1
15631,15631,,3,0,1,1
15632,15632,,15,2,0,2
15633,15633,,21,22,24,46
15634,15634,,0,0,1,1
15635,15635,,111,1,2,3
15636,15636,,8,0,1,1
15637,15637,,23,1,0,1
15638,15638,,23,0,1,1
15639,15639,,127,2,0,2
15640,15640,,21,2,2,4
15641,15641,,43,1,0,1
15642,15642,,8,0,1,1
15643,15643,,8,0,1,1
15644,15644,,52,0,1,1
15645,15645,,8,1,0,1
15646,15646,,23,0,1,1
15647,15647,,43,0,1,1
15648,15648,,45,0,1,1
15649,15649,,45,1,1,2
15650,15650,,23,0,3,3
15651,15651,,23,1,1,2
15652,15652,,18,1,0,1
15653,15653,,8,0,1,1
15654,15654,,105,2,0,2
15655,15655,,43,1,5,6
15656,15656,,127,0,1,1
15657,15657,,21,1,5,6
15658,15658,,8,0,2,2
15659,15659,,8,2,3,5
15660,15660,,23,2,0,2
15661,15661,,23,1,0,1
15662,15662,,8,1,1,2
15663,15663,,31,2,1,3
15664,15664,,0,2,0,2
15665,15665,,23,2,5,7
15666,15666,,24,3,1,4
15667,15667,,5,2,4,6
15668,15668,,66,1,0,1
15669,15669,,21,0,1,1
15670,15670,,0,0,1,1
15671,15671,,21,19,15,34
15672,15672,,127,0,1,1
15673,15673,,127,3,3,6
15674,15674,,21,1,0,1
15675,15675,,3,3,2,5
15676,15676,,5,4,14,18
15677,15677,,21,1,0,1
15678,15678,,8,4,1,5
15679,15679,,3,1,0,1
15680,15680,,14,0,1,1
15681,15681,,43,0,1,1
15682,15682,,11,6,3,9
15683,15683,,105,1,2,3
15684,15684,,21,0,1,1
15685,15685,,23,1,3,4
15686,15686,,21,25,63,88
15687,15687,,66,0,2,2
15688,15688,,21,13,2,15
15689,15689,,23,1,0,1
15690,15690,,0,0,1,1
15691,15691,,8,1,0,1
15692,15692,,8,1,2,3
15693,15693,,24,5,1,6
15694,15694,,11,1,2,3
15695,15695,,135,0,1,1
15696,15696,,135,1,0,1
15697,15697,,120,0,2,2
15698,15698,,120,5,0,5
15699,15699,,21,8,11,19
15700,15700,,23,8,1,9
15701,15701,,43,1,2,3
15702,15702,,11,3,14,17
15703,15703,,23,11,9,20
15704,15704,,111,1,0,1
15705,15705,,0,1,1,2
15706,15706,,11,1,3,4
15707,15707,,23,7,5,12
15708,15708,,14,8,1,9
15709,15709,,0,2,5,7
15710,15710,,23,1,0,1
15711,15711,,23,5,5,10
15712,15712,,11,3,3,6
15713,15713,,11,1,6,7
15714,15714,,0,1,0,1
15715,15715,,14,0,3,3
15716,15716,,14,1,1,2
15717,15717,,8,1,0,1
15718,15718,,105,0,1,1
15719,15719,,21,0,2,2
15720,15720,,21,1,0,1
15721,15721,,3,1,1,2
15722,15722,,11,6,3,9
15723,15723,,11,1,9,10
15724,15724,,3,0,1,1
15725,15725,,23,2,2,4
15726,15726,,14,1,1,2
15727,15727,,23,2,0,2
15728,15728,,0,2,0,2
15729,15729,,11,0,3,3
15730,15730,,21,1,1,2
15731,15731,,3,1,1,2
15732,15732,,6,3,0,3
15733,15733,,43,2,1,3
15734,15734,,23,4,5,9
15735,15735,,43,2,1,3
15736,15736,,21,6,4,10
15737,15737,,21,0,1,1
15738,15738,,3,0,1,1
15739,15739,,8,1,1,2
15740,15740,,11,1,0,1
15741,15741,,14,2,0,2
15742,15742,,52,7,10,17
15743,15743,,11,2,0,2
15744,15744,,52,1,3,4
15745,15745,,0,7,0,7
15746,15746,,8,2,4,6
15747,15747,,111,1,1,2
15748,15748,,6,2,4,6
15749,15749,,8,1,0,1
15750,15750,,14,1,2,3
15751,15751,,0,1,0,1
15752,15752,,15,1,0,1
15753,15753,,88,2,1,3
15754,15754,,11,0,2,2
15755,15755,,11,3,3,6
15756,15756,,23,1,0,1
15757,15757,,23,0,1,1
15758,15758,,23,1,8,9
15759,15759,,23,0,1,1
15760,15760,,0,1,1,2
15761,15761,,6,2,5,7
15762,15762,,105,1,3,4
15763,15763,,136,0,1,1
15764,15764,,136,1,0,1
15765,15765,,0,1,0,1
15766,15766,,52,4,2,6
15767,15767,,8,0,1,1
15768,15768,,43,0,1,1
15769,15769,,43,0,1,1
15770,15770,,14,1,1,2
15771,15771,,21,23,14,37
15772,15772,,3,1,1,2
15773,15773,,23,1,1,2
15774,15774,,5,5,5,10
15775,15775,,14,2,1,3
15776,15776,,23,0,3,3
15777,15777,,105,1,0,1
15778,15778,,21,6,5,11
15779,15779,,3,0,1,1
15780,15780,,137,0,1,1
15781,15781,,137,1,0,1
15782,15782,,23,0,1,1
15783,15783,,21,1,2,3
15784,15784,,24,0,2,2
15785,15785,,8,2,3,5
15786,15786,,8,1,1,2
15787,15787,,3,3,3,6
15788,15788,,14,1,0,1
15789,15789,,111,2,2,4
15790,15790,,14,1,0,1
15791,15791,,21,0,4,4
15792,15792,,21,2,0,2
15793,15793,,21,0,1,1
15794,15794,,0,2,0,2
15795,15795,,31,3,1,4
15796,15796,,43,0,2,2
15797,15797,,21,0,1,1
15798,15798,,23,1,1,2
15799,15799,,43,0,1,1
15800,15800,,31,0,10,10
15801,15801,,14,1,3,4
15802,15802,,23,1,2,3
15803,15803,,31,3,6,9
15804,15804,,6,1,0,1
15805,15805,,8,3,5,8
15806,15806,,43,0,2,2
15807,15807,,23,1,5,6
15808,15808,,15,1,6,7
15809,15809,,15,0,1,1
15810,15810,,14,0,1,1
15811,15811,,18,6,0,6
15812,15812,,21,3,10,13
15813,15813,,31,0,1,1
15814,15814,,76,3,1,4
15815,15815,,23,1,1,2
15816,15816,,105,0,2,2
15817,15817,,8,0,1,1
15818,15818,,8,0,2,2
15819,15819,,8,0,1,1
15820,15820,,15,2,1,3
15821,15821,,23,2,1,3
15822,15822,,31,0,1,1
15823,15823,,15,0,4,4
15824,15824,,15,3,2,5
15825,15825,,18,1,0,1
15826,15826,,21,2,5,7
15827,15827,,23,0,1,1
15828,15828,,31,1,4,5
15829,15829,,23,2,2,4
15830,15830,,62,1,0,1
15831,15831,,8,0,5,5
15832,15832,,8,1,0,1
15833,15833,,3,3,2,5
15834,15834,,24,2,1,3
15835,15835,,0,1,0,1
15836,15836,,66,0,2,2
15837,15837,,6,1,0,1
15838,15838,,23,0,1,1
15839,15839,,23,1,1,2
15840,15840,,23,5,1,6
15841,15841,,14,5,4,9
15842,15842,,21,1,1,2
15843,15843,,18,1,1,2
15844,15844,,23,1,0,1
15845,15845,,8,0,2,2
15846,15846,,18,5,2,7
15847,15847,,52,0,2,2
15848,15848,,6,13,4,17
15849,15849,,8,1,2,3
15850,15850,,5,1,2,3
15851,15851,,15,2,0,2
15852,15852,,23,1,11,12
15853,15853,,15,1,0,1
15854,15854,,23,0,2,2
15855,15855,,8,1,3,4
15856,15856,,14,9,12,21
15857,15857,,21,3,4,7
15858,15858,,23,0,1,1
15859,15859,,23,0,1,1
15860,15860,,0,0,1,1
15861,15861,,21,0,4,4
15862,15862,,21,0,1,1
15863,15863,,23,1,1,2
15864,15864,,8,1,1,2
15865,15865,,3,4,11,15
15866,15866,,111,1,1,2
15867,15867,,23,1,0,1
15868,15868,,31,0,1,1
15869,15869,,23,6,23,29
15870,15870,,43,1,0,1
15871,15871,,23,0,1,1
15872,15872,,23,2,0,2
15873,15873,,11,0,1,1
15874,15874,,23,0,1,1
15875,15875,,23,1,1,2
15876,15876,,8,0,2,2
15877,15877,,45,5,0,5
15878,15878,,23,0,1,1
15879,15879,,31,0,1,1
15880,15880,,127,1,1,2
15881,15881,,31,1,1,2
15882,15882,,8,1,0,1
15883,15883,,105,0,1,1
15884,15884,,11,3,0,3
15885,15885,,14,2,0,2
15886,15886,,88,1,0,1
15887,15887,,18,1,1,2
15888,15888,,6,1,0,1
15889,15889,,111,0,1,1
15890,15890,,111,3,0,3
15891,15891,,0,1,3,4
15892,15892,,0,1,0,1
15893,15893,,3,0,2,2
15894,15894,,105,1,0,1
15895,15895,,127,0,1,1
15896,15896,,0,4,6,10
15897,15897,,8,1,0,1
15898,15898,,111,1,0,1
15899,15899,,11,1,15,16
15900,15900,,105,0,3,3
15901,15901,,23,1,1,2
15902,15902,,8,0,1,1
15903,15903,,23,0,3,3
15904,15904,,23,0,2,2
15905,15905,,127,1,0,1
15906,15906,,5,0,1,1
15907,15907,,11,0,1,1
15908,15908,,23,2,0,2
15909,15909,,120,1,0,1
15910,15910,,31,3,2,5
15911,15911,,52,1,0,1
15912,15912,,23,2,1,3
15913,15913,,23,1,1,2
15914,15914,,11,3,7,10
15915,15915,,0,4,3,7
15916,15916,,23,1,1,2
15917,15917,,3,2,0,2
15918,15918,,23,1,1,2
15919,15919,,23,0,2,2
15920,15920,,5,5,0,5
15921,15921,,18,1,2,3
15922,15922,,43,3,9,12
15923,15923,,43,0,1,1
15924,15924,,43,0,2,2
15925,15925,,43,0,1,1
15926,15926,,23,1,1,2
15927,15927,,23,1,1,2
15928,15928,,21,3,2,5
15929,15929,,23,0,1,1
15930,15930,,88,1,0,1
15931,15931,,5,1,2,3
15932,15932,,43,0,1,1
15933,15933,,43,1,2,3
15934,15934,,8,1,0,1
15935,15935,,5,1,0,1
15936,15936,,127,0,1,1
15937,15937,,43,0,1,1
15938,15938,,3,2,2,4
15939,15939,,21,3,3,6
15940,15940,,23,1,1,2
15941,15941,,23,1,0,1
15942,15942,,24,3,2,5
15943,15943,,138,1,1,2
15944,15944,,138,1,1,2
15945,15945,,23,0,1,1
15946,15946,,3,3,2,5
15947,15947,,21,0,1,1
15948,15948,,111,1,2,3
15949,15949,,76,0,1,1
15950,15950,,31,1,0,1
15951,15951,,18,1,0,1
15952,15952,,23,0,1,1
15953,15953,,127,1,3,4
15954,15954,,31,1,1,2
15955,15955,,14,0,1,1
15956,15956,,52,1,1,2
15957,15957,,5,1,1,2
15958,15958,,6,0,3,3
15959,15959,,31,0,4,4
15960,15960,,11,0,1,1
15961,15961,,127,1,0,1
15962,15962,,23,1,0,1
15963,15963,,23,3,3,6
15964,15964,,23,1,1,2
15965,15965,,31,2,6,8
15966,15966,,31,3,4,7
15967,15967,,127,0,2,2
15968,15968,,15,0,3,3
15969,15969,,6,0,1,1
15970,15970,,88,2,0,2
15971,15971,,88,0,1,1
15972,15972,,23,0,1,1
15973,15973,,15,2,0,2
15974,15974,,5,0,1,1
15975,15975,,14,1,0,1
15976,15976,,8,2,5,7
15977,15977,,111,11,6,17
15978,15978,,88,2,1,3
15979,15979,,23,1,0,1
15980,15980,,0,1,3,4
15981,15981,,0,0,1,1
15982,15982,,14,0,1,1
15983,15983,,14,4,5,9
15984,15984,,18,1,3,4
15985,15985,,8,3,4,7
15986,15986,,76,0,1,1
15987,15987,,127,1,1,2
15988,15988,,15,0,1,1
15989,15989,,23,1,1,2
15990,15990,,43,0,1,1
15991,15991,,88,1,2,3
15992,15992,,8,0,1,1
15993,15993,,6,0,1,1
15994,15994,,21,1,6,7
15995,15995,,52,7,0,7
15996,15996,,43,0,2,2
15997,15997,,23,1,1,2
15998,15998,,8,1,1,2
15999,15999,,3,0,1,1
16000,16000,,15,3,1,4
16001,16001,,23,1,3,4
16002,16002,,23,0,1,1
16003,16003,,23,1,0,1
16004,16004,,139,0,1,1
16005,16005,,139,1,0,1
16006,16006,,88,1,0,1
16007,16007,,43,2,0,2
16008,16008,,43,1,0,1
16009,16009,,127,1,0,1
16010,16010,,88,1,0,1
16011,16011,,127,1,0,1
16012,16012,,15,2,3,5
16013,16013,,14,8,2,10
16014,16014,,11,1,0,1
16015,16015,,43,1,5,6
16016,16016,,88,5,2,7
16017,16017,,21,0,2,2
16018,16018,,3,1,0,1
16019,16019,,45,0,2,2
16020,16020,,111,1,0,1
16021,16021,,11,0,3,3
16022,16022,,11,0,3,3
16023,16023,,8,1,0,1
16024,16024,,23,0,2,2
16025,16025,,43,0,1,1
16026,16026,,23,0,14,14
16027,16027,,23,1,1,2
16028,16028,,8,4,2,6
16029,16029,,6,6,4,10
16030,16030,,15,3,1,4
16031,16031,,23,2,0,2
16032,16032,,23,1,0,1
16033,16033,,24,0,1,1
16034,16034,,14,1,0,1
16035,16035,,31,0,1,1
16036,16036,,23,3,3,6
16037,16037,,15,2,2,4
16038,16038,,31,0,1,1
16039,16039,,111,1,0,1
16040,16040,,127,4,3,7
16041,16041,,23,1,0,1
16042,16042,,76,1,0,1
16043,16043,,23,1,1,2
16044,16044,,6,1,4,5
16045,16045,,127,1,1,2
16046,16046,,8,0,2,2
16047,16047,,3,2,0,2
16048,16048,,8,0,3,3
16049,16049,,111,0,1,1
16050,16050,,140,0,1,1
16051,16051,,140,1,0,1
16052,16052,,8,0,1,1
16053,16053,,88,3,0,3
16054,16054,,43,0,1,1
16055,16055,,15,1,1,2
16056,16056,,24,2,0,2
16057,16057,,3,1,0,1
16058,16058,,45,5,0,5
16059,16059,,6,1,1,2
16060,16060,,15,1,0,1
16061,16061,,23,0,1,1
16062,16062,,23,0,1,1
16063,16063,,3,1,0,1
16064,16064,,11,1,0,1
16065,16065,,23,0,2,2
16066,16066,,24,2,2,4
16067,16067,,23,1,0,1
16068,16068,,23,1,0,1
16069,16069,,3,2,2,4
16070,16070,,127,1,2,3
16071,16071,,5,1,4,5
16072,16072,,23,1,3,4
16073,16073,,43,1,1,2
16074,16074,,23,1,1,2
16075,16075,,23,1,0,1
16076,16076,,21,0,8,8
16077,16077,,23,1,6,7
16078,16078,,52,0,1,1
16079,16079,,21,2,2,4
16080,16080,,14,8,6,14
16081,16081,,14,2,2,4
16082,16082,,23,0,1,1
16083,16083,,0,0,1,1
16084,16084,,0,2,2,4
16085,16085,,66,0,1,1
16086,16086,,8,1,1,2
16087,16087,,21,2,6,8
16088,16088,,21,1,6,7
16089,16089,,45,0,2,2
16090,16090,,11,1,1,2
16091,16091,,127,0,3,3
16092,16092,,76,1,0,1
16093,16093,,23,1,2,3
16094,16094,,43,3,1,4
16095,16095,,52,1,0,1
16096,16096,,52,0,3,3
16097,16097,,15,2,0,2
16098,16098,,23,1,0,1
16099,16099,,6,2,1,3
16100,16100,,31,0,2,2
16101,16101,,88,1,2,3
16102,16102,,23,0,1,1
16103,16103,,23,1,0,1
16104,16104,,18,1,1,2
16105,16105,,127,3,4,7
16106,16106,,105,9,2,11
16107,16107,,23,3,1,4
16108,16108,,43,2,0,2
16109,16109,,45,0,1,1
16110,16110,,45,3,0,3
16111,16111,,45,1,1,2
16112,16112,,88,1,0,1
16113,16113,,6,1,0,1
16114,16114,,88,2,4,6
16115,16115,,88,1,0,1
16116,16116,,23,1,0,1
16117,16117,,23,0,1,1
16118,16118,,14,0,2,2
16119,16119,,21,1,0,1
16120,16120,,14,1,2,3
16121,16121,,0,3,4,7
16122,16122,,14,2,0,2
16123,16123,,127,1,1,2
16124,16124,,43,2,0,2
16125,16125,,43,0,1,1
16126,16126,,43,0,4,4
16127,16127,,23,1,0,1
16128,16128,,11,0,2,2
16129,16129,,43,4,1,5
16130,16130,,21,5,14,19
16131,16131,,66,0,2,2
16132,16132,,11,2,1,3
16133,16133,,45,0,1,1
16134,16134,,21,1,0,1
16135,16135,,21,0,1,1
16136,16136,,21,1,0,1
16137,16137,,11,2,4,6
16138,16138,,141,1,1,2
16139,16139,,141,1,1,2
16140,16140,,24,0,2,2
16141,16141,,24,0,1,1
16142,16142,,120,0,1,1
16143,16143,,24,1,1,2
16144,16144,,127,2,2,4
16145,16145,,127,1,1,2
16146,16146,,66,0,3,3
16147,16147,,88,3,5,8
16148,16148,,120,0,1,1
16149,16149,,76,0,1,1
16150,16150,,66,4,1,5
16151,16151,,23,0,1,1
16152,16152,,66,1,1,2
16153,16153,,23,0,1,1
16154,16154,,15,1,0,1
16155,16155,,8,0,1,1
16156,16156,,23,0,1,1
16157,16157,,23,0,5,5
16158,16158,,15,1,1,2
16159,16159,,11,2,0,2
16160,16160,,23,3,1,4
16161,16161,,0,1,0,1
16162,16162,,23,0,1,1
16163,16163,,23,1,1,2
16164,16164,,23,0,1,1
16165,16165,,43,1,1,2
16166,16166,,43,1,1,2
16167,16167,,23,1,0,1
16168,16168,,21,2,7,9
16169,16169,,45,0,1,1
16170,16170,,8,0,1,1
16171,16171,,43,0,2,2
16172,16172,,76,2,2,4
16173,16173,,43,0,1,1
16174,16174,,0,1,0,1
16175,16175,,8,0,1,1
16176,16176,,3,3,3,6
16177,16177,,14,0,5,5
16178,16178,,127,1,2,3
16179,16179,,21,0,1,1
16180,16180,,31,3,4,7
16181,16181,,8,5,3,8
16182,16182,,23,0,1,1
16183,16183,,88,2,0,2
16184,16184,,23,1,0,1
16185,16185,,6,0,2,2
16186,16186,,6,1,0,1
16187,16187,,0,1,2,3
16188,16188,,31,1,1,2
16189,16189,,3,1,0,1
16190,16190,,23,1,1,2
16191,16191,,15,1,1,2
16192,16192,,15,2,0,2
16193,16193,,11,2,16,18
16194,16194,,23,7,5,12
16195,16195,,52,3,0,3
16196,16196,,43,1,0,1
16197,16197,,43,2,2,4
16198,16198,,88,3,2,5
16199,16199,,120,5,0,5
16200,16200,,52,0,2,2
16201,16201,,14,6,5,11
16202,16202,,3,4,1,5
16203,16203,,11,3,1,4
16204,16204,,3,1,0,1
16205,16205,,105,0,2,2
16206,16206,,127,3,4,7
16207,16207,,127,1,0,1
16208,16208,,105,0,5,5
16209,16209,,0,1,0,1
16210,16210,,120,1,3,4
16211,16211,,6,1,1,2
16212,16212,,23,1,1,2
16213,16213,,43,0,1,1
16214,16214,,8,2,2,4
16215,16215,,127,4,0,4
16216,16216,,8,0,1,1
16217,16217,,11,2,1,3
16218,16218,,23,0,3,3
16219,16219,,23,1,0,1
16220,16220,,11,1,0,1
16221,16221,,127,1,1,2
16222,16222,,127,1,0,1
16223,16223,,43,0,1,1
16224,16224,,8,1,2,3
16225,16225,,8,1,4,5
16226,16226,,23,3,2,5
16227,16227,,8,1,0,1
16228,16228,,23,1,0,1
16229,16229,,8,1,0,1
16230,16230,,23,0,1,1
16231,16231,,43,2,2,4
16232,16232,,43,4,2,6
16233,16233,,0,2,4,6
16234,16234,,21,0,1,1
16235,16235,,8,0,15,15
16236,16236,,21,2,0,2
16237,16237,,21,3,4,7
16238,16238,,21,3,0,3
16239,16239,,127,0,1,1
16240,16240,,127,5,3,8
16241,16241,,43,4,0,4
16242,16242,,43,3,2,5
16243,16243,,105,2,1,3
16244,16244,,21,2,1,3
16245,16245,,0,1,0,1
16246,16246,,43,1,4,5
16247,16247,,8,1,1,2
16248,16248,,76,1,2,3
16249,16249,,8,1,1,2
16250,16250,,0,0,2,2
16251,16251,,8,2,0,2
16252,16252,,8,0,2,2
16253,16253,,8,2,0,2
16254,16254,,3,1,1,2
16255,16255,,45,1,1,2
16256,16256,,3,1,0,1
16257,16257,,11,0,3,3
16258,16258,,11,2,1,3
16259,16259,,43,5,2,7
16260,16260,,21,4,3,7
16261,16261,,31,1,0,1
16262,16262,,21,5,1,6
16263,16263,,6,0,1,1
16264,16264,,31,2,3,5
16265,16265,,8,2,1,3
16266,16266,,52,1,0,1
16267,16267,,127,1,1,2
16268,16268,,31,3,5,8
16269,16269,,8,3,1,4
16270,16270,,11,1,0,1
16271,16271,,8,8,9,17
16272,16272,,111,0,1,1
16273,16273,,111,2,7,9
16274,16274,,76,0,2,2
16275,16275,,88,0,2,2
16276,16276,,8,0,1,1
16277,16277,,24,0,1,1
16278,16278,,23,0,1,1
16279,16279,,76,1,0,1
16280,16280,,43,0,1,1
16281,16281,,21,1,1,2
16282,16282,,43,0,1,1
16283,16283,,8,1,1,2
16284,16284,,14,1,1,2
16285,16285,,120,2,0,2
16286,16286,,23,2,0,2
16287,16287,,23,0,1,1
16288,16288,,8,0,1,1
16289,16289,,43,0,1,1
16290,16290,,8,1,1,2
16291,16291,,8,0,1,1
16292,16292,,56,0,1,1
16293,16293,,14,1,2,3
16294,16294,,23,1,1,2
16295,16295,,23,3,0,3
16296,16296,,111,0,1,1
16297,16297,,14,2,0,2
16298,16298,,14,1,0,1
16299,16299,,11,0,2,2
16300,16300,,8,1,2,3
16301,16301,,15,3,0,3
16302,16302,,8,0,1,1
16303,16303,,18,1,0,1
16304,16304,,3,1,0,1
16305,16305,,8,1,0,1
16306,16306,,142,0,1,1
16307,16307,,142,1,0,1
16308,16308,,8,0,1,1
16309,16309,,76,0,2,2
16310,16310,,3,0,1,1
16311,16311,,8,0,3,3
16312,16312,,8,1,0,1
16313,16313,,31,0,1,1
16314,16314,,52,3,1,4
16315,16315,,8,2,1,3
16316,16316,,127,0,3,3
16317,16317,,43,1,5,6
16318,16318,,0,6,7,13
16319,16319,,6,2,2,4
16320,16320,,15,0,1,1
16321,16321,,11,10,5,15
16322,16322,,8,0,1,1
16323,16323,,21,2,1,3
16324,16324,,21,3,5,8
16325,16325,,15,8,10,18
16326,16326,,18,1,0,1
16327,16327,,11,0,2,2
16328,16328,,23,0,1,1
16329,16329,,8,22,34,56
16330,16330,,23,15,6,21
16331,16331,,45,0,1,1
16332,16332,,11,2,0,2
16333,16333,,66,1,3,4
16334,16334,,21,3,3,6
16335,16335,,21,0,1,1
16336,16336,,21,12,9,21
16337,16337,,3,1,0,1
16338,16338,,21,1,0,1
16339,16339,,23,1,1,2
16340,16340,,8,2,0,2
16341,16341,,52,1,0,1
16342,16342,,8,1,1,2
16343,16343,,23,0,1,1
16344,16344,,43,0,2,2
16345,16345,,43,2,0,2
16346,16346,,88,2,1,3
16347,16347,,21,4,2,6
16348,16348,,21,2,5,7
16349,16349,,21,1,3,4
16350,16350,,0,1,0,1
16351,16351,,8,0,1,1
16352,16352,,66,1,1,2
16353,16353,,43,0,1,1
16354,16354,,24,1,0,1
16355,16355,,8,1,1,2
16356,16356,,43,0,1,1
16357,16357,,3,3,2,5
16358,16358,,15,3,1,4
16359,16359,,21,3,1,4
16360,16360,,23,0,1,1
16361,16361,,11,9,0,9
16362,16362,,31,2,2,4
16363,16363,,0,0,5,5
16364,16364,,23,0,1,1
16365,16365,,11,1,2,3
16366,16366,,0,3,0,3
16367,16367,,111,0,1,1
16368,16368,,6,3,0,3
16369,16369,,31,1,0,1
16370,16370,,127,1,0,1
16371,16371,,8,1,1,2
16372,16372,,8,1,2,3
16373,16373,,127,6,0,6
16374,16374,,111,1,1,2
16375,16375,,127,18,6,24
16376,16376,,15,1,1,2
16377,16377,,15,1,1,2
16378,16378,,15,1,0,1
16379,16379,,24,0,1,1
16380,16380,,24,0,1,1
16381,16381,,23,0,1,1
16382,16382,,76,4,4,8
16383,16383,,8,1,1,2
16384,16384,,105,1,0,1
16385,16385,,8,4,0,4
16386,16386,,18,3,0,3
16387,16387,,6,1,0,1
16388,16388,,6,0,1,1
16389,16389,,18,1,0,1
16390,16390,,21,2,1,3
16391,16391,,8,2,0,2
16392,16392,,8,2,0,2
16393,16393,,8,0,1,1
16394,16394,,143,0,1,1
16395,16395,,143,1,0,1
16396,16396,,23,1,0,1
16397,16397,,127,0,2,2
16398,16398,,52,0,10,10
16399,16399,,21,4,3,7
16400,16400,,0,2,0,2
16401,16401,,88,1,1,2
16402,16402,,52,2,3,5
16403,16403,,21,7,3,10
16404,16404,,3,0,4,4
16405,16405,,21,5,1,6
16406,16406,,23,0,1,1
16407,16407,,14,1,0,1
16408,16408,,43,2,2,4
16409,16409,,43,9,4,13
16410,16410,,5,1,1,2
16411,16411,,23,0,2,2
16412,16412,,14,0,1,1
16413,16413,,66,2,0,2
16414,16414,,127,14,5,19
16415,16415,,3,0,2,2
16416,16416,,76,1,0,1
16417,16417,,76,2,1,3
16418,16418,,23,0,1,1
16419,16419,,21,1,0,1
16420,16420,,8,2,4,6
16421,16421,,8,1,1,2
16422,16422,,21,0,1,1
16423,16423,,11,3,1,4
16424,16424,,3,1,1,2
16425,16425,,8,1,2,3
16426,16426,,18,3,3,6
16427,16427,,111,0,1,1
16428,16428,,14,4,7,11
16429,16429,,76,1,0,1
16430,16430,,52,1,0,1
16431,16431,,15,2,1,3
16432,16432,,31,1,0,1
16433,16433,,23,6,31,37
16434,16434,,0,0,4,4
16435,16435,,8,1,0,1
16436,16436,,45,0,2,2
16437,16437,,45,1,0,1
16438,16438,,144,0,2,2
16439,16439,,144,2,0,2
16440,16440,,88,1,0,1
16441,16441,,88,1,0,1
16442,16442,,8,1,1,2
16443,16443,,8,1,1,2
16444,16444,,11,0,1,1
16445,16445,,3,5,1,6
16446,16446,,23,0,1,1
16447,16447,,24,3,0,3
16448,16448,,23,1,0,1
16449,16449,,8,2,2,4
16450,16450,,127,6,4,10
16451,16451,,45,1,0,1
16452,16452,,23,1,1,2
16453,16453,,45,0,1,1
16454,16454,,6,0,1,1
16455,16455,,11,0,1,1
16456,16456,,127,0,1,1
16457,16457,,8,2,1,3
16458,16458,,11,0,1,1
16459,16459,,11,1,0,1
16460,16460,,23,0,1,1
16461,16461,,11,1,0,1
16462,16462,,0,2,3,5
16463,16463,,24,2,3,5
16464,16464,,145,0,1,1
16465,16465,,145,1,0,1
16466,16466,,8,0,5,5
16467,16467,,43,0,1,1
16468,16468,,23,0,1,1
16469,16469,,0,0,2,2
16470,16470,,21,3,3,6
16471,16471,,3,1,1,2
16472,16472,,11,7,5,12
16473,16473,,3,1,0,1
16474,16474,,8,1,0,1
16475,16475,,88,0,1,1
16476,16476,,43,1,1,2
16477,16477,,120,1,1,2
16478,16478,,8,1,0,1
16479,16479,,21,1,2,3
16480,16480,,15,1,1,2
16481,16481,,8,2,1,3
16482,16482,,14,2,0,2
16483,16483,,146,0,1,1
16484,16484,,146,2,1,3
16485,16485,,76,2,0,2
16486,16486,,0,1,0,1
16487,16487,,127,2,1,3
16488,16488,,5,4,1,5
16489,16489,,11,1,1,2
16490,16490,,11,0,2,2
16491,16491,,11,1,1,2
16492,16492,,3,3,1,4
16493,16493,,23,1,1,2
16494,16494,,147,1,1,2
16495,16495,,147,1,1,2
16496,16496,,21,1,1,2
16497,16497,,21,1,1,2
16498,16498,,11,0,2,2
16499,16499,,14,0,1,1
16500,16500,,23,0,1,1
16501,16501,,66,1,2,3
16502,16502,,3,1,0,1
16503,16503,,111,0,2,2
16504,16504,,45,1,1,2
16505,16505,,14,1,0,1
16506,16506,,18,1,7,8
16507,16507,,18,2,1,3
16508,16508,,5,7,2,9
16509,16509,,21,0,1,1
16510,16510,,23,1,5,6
16511,16511,,76,1,1,2
16512,16512,,8,3,1,4
16513,16513,,127,0,1,1
16514,16514,,43,1,0,1
16515,16515,,23,0,1,1
16516,16516,,45,0,1,1
16517,16517,,8,7,2,9
16518,16518,,24,0,1,1
16519,16519,,3,1,0,1
16520,16520,,43,1,0,1
16521,16521,,43,0,2,2
16522,16522,,45,1,0,1
16523,16523,,3,1,2,3
16524,16524,,11,1,3,4
16525,16525,,18,2,1,3
16526,16526,,43,0,1,1
16527,16527,,43,0,2,2
16528,16528,,43,1,0,1
16529,16529,,43,1,1,2
16530,16530,,14,1,0,1
16531,16531,,8,0,1,1
16532,16532,,45,0,3,3
16533,16533,,23,0,1,1
16534,16534,,31,3,3,6
16535,16535,,14,1,0,1
16536,16536,,0,0,1,1
16537,16537,,23,0,1,1
16538,16538,,23,1,3,4
16539,16539,,148,0,1,1
16540,16540,,148,1,0,1
16541,16541,,105,0,1,1
16542,16542,,105,2,1,3
16543,16543,,146,1,1,2
16544,16544,,76,0,1,1
16545,16545,,76,0,2,2
16546,16546,,23,1,1,2
16547,16547,,23,2,2,4
16548,16548,,149,0,1,1
16549,16549,,149,1,0,1
16550,16550,,3,0,1,1
16551,16551,,15,2,1,3
16552,16552,,105,1,0,1
16553,16553,,23,1,2,3
16554,16554,,21,1,0,1
16555,16555,,8,1,0,1
16556,16556,,31,1,0,1
16557,16557,,43,0,1,1
16558,16558,,43,1,1,2
16559,16559,,21,0,1,1
16560,16560,,23,0,1,1
16561,16561,,21,1,0,1
16562,16562,,8,2,0,2
16563,16563,,8,1,2,3
16564,16564,,8,0,1,1
16565,16565,,127,2,0,2
16566,16566,,31,0,1,1
16567,16567,,8,1,1,2
16568,16568,,23,2,1,3
16569,16569,,127,0,1,1
16570,16570,,23,0,1,1
16571,16571,,21,1,0,1
16572,16572,,31,0,3,3
16573,16573,,31,0,1,1
16574,16574,,11,0,1,1
16575,16575,,23,0,1,1
16576,16576,,23,3,1,4
16577,16577,,21,1,2,3
16578,16578,,0,2,2,4
16579,16579,,23,0,1,1
16580,16580,,105,2,2,4
16581,16581,,3,0,1,1
16582,16582,,18,1,0,1
16583,16583,,18,1,0,1
16584,16584,,8,2,0,2
16585,16585,,18,1,2,3
16586,16586,,6,2,0,2
16587,16587,,3,1,0,1
16588,16588,,8,3,1,4
16589,16589,,3,1,0,1
16590,16590,,18,1,1,2
16591,16591,,23,1,0,1
16592,16592,,23,1,1,2
16593,16593,,5,1,1,2
16594,16594,,8,1,0,1
16595,16595,,23,0,1,1
16596,16596,,15,0,1,1
16597,16597,,21,1,2,3
16598,16598,,23,1,0,1
16599,16599,,23,2,0,2
16600,16600,,15,0,1,1
16601,16601,,21,0,2,2
16602,16602,,88,1,1,2
16603,16603,,43,0,1,1
16604,16604,,14,3,0,3
16605,16605,,8,0,1,1
16606,16606,,21,0,1,1
16607,16607,,23,1,0,1
16608,16608,,21,1,0,1
16609,16609,,31,1,0,1
16610,16610,,31,1,1,2
16611,16611,,11,5,3,8
16612,16612,,45,0,1,1
16613,16613,,21,2,1,3
16614,16614,,23,4,3,7
16615,16615,,5,0,3,3
16616,16616,,45,0,2,2
16617,16617,,11,0,1,1
16618,16618,,111,0,3,3
16619,16619,,15,4,2,6
16620,16620,,62,1,0,1
16621,16621,,23,1,1,2
16622,16622,,21,0,1,1
16623,16623,,23,1,0,1
16624,16624,,23,7,4,11
16625,16625,,111,0,3,3
16626,16626,,88,1,3,4
16627,16627,,111,0,4,4
16628,16628,,14,1,0,1
16629,16629,,8,0,1,1
16630,16630,,8,4,4,8
16631,16631,,8,2,1,3
16632,16632,,8,1,0,1
16633,16633,,8,1,0,1
16634,16634,,8,2,0,2
16635,16635,,45,2,0,2
16636,16636,,45,1,1,2
16637,16637,,31,0,2,2
16638,16638,,105,4,1,5
16639,16639,,111,0,1,1
16640,16640,,8,1,0,1
16641,16641,,127,1,3,4
16642,16642,,8,0,1,1
16643,16643,,14,0,1,1
16644,16644,,8,0,2,2
16645,16645,,8,4,4,8
16646,16646,,3,1,0,1
16647,16647,,52,1,1,2
16648,16648,,21,0,2,2
16649,16649,,23,0,1,1
16650,16650,,5,1,0,1
16651,16651,,52,1,0,1
16652,16652,,111,0,1,1
16653,16653,,21,1,0,1
16654,16654,,6,1,1,2
16655,16655,,88,0,1,1
16656,16656,,23,0,1,1
16657,16657,,111,0,2,2
16658,16658,,45,2,0,2
16659,16659,,43,5,6,11
16660,16660,,15,0,1,1
16661,16661,,15,2,0,2
16662,16662,,105,1,1,2
16663,16663,,43,1,0,1
16664,16664,,23,1,0,1
16665,16665,,0,1,0,1
16666,16666,,52,0,2,2
16667,16667,,15,1,1,2
16668,16668,,14,1,0,1
16669,16669,,14,1,3,4
16670,16670,,120,1,2,3
16671,16671,,11,1,1,2
16672,16672,,11,0,2,2
16673,16673,,23,0,3,3
16674,16674,,66,0,1,1
16675,16675,,3,1,1,2
16676,16676,,21,1,0,1
16677,16677,,8,1,1,2
16678,16678,,23,1,1,2
16679,16679,,127,1,0,1
16680,16680,,111,2,4,6
16681,16681,,76,2,1,3
16682,16682,,23,2,5,7
16683,16683,,18,0,3,3
16684,16684,,14,1,1,2
16685,16685,,8,2,0,2
16686,16686,,52,1,0,1
16687,16687,,111,14,14,28
16688,16688,,15,0,2,2
16689,16689,,45,0,2,2
16690,16690,,15,1,0,1
16691,16691,,76,0,1,1
16692,16692,,8,2,2,4
16693,16693,,0,1,0,1
16694,16694,,23,1,0,1
16695,16695,,15,0,3,3
16696,16696,,23,2,0,2
16697,16697,,3,7,7,14
16698,16698,,23,3,0,3
16699,16699,,23,0,1,1
16700,16700,,0,0,4,4
16701,16701,,15,0,1,1
16702,16702,,8,3,9,12
16703,16703,,3,1,2,3
16704,16704,,14,3,3,6
16705,16705,,45,1,0,1
16706,16706,,23,2,0,2
16707,16707,,23,0,1,1
16708,16708,,0,0,1,1
16709,16709,,14,0,1,1
16710,16710,,66,2,3,5
16711,16711,,23,0,1,1
16712,16712,,5,6,2,8
16713,16713,,3,1,0,1
16714,16714,,3,1,5,6
16715,16715,,23,1,1,2
16716,16716,,8,1,3,4
16717,16717,,21,1,0,1
16718,16718,,52,0,1,1
16719,16719,,21,1,2,3
16720,16720,,21,2,2,4
16721,16721,,43,0,1,1
16722,16722,,14,2,1,3
16723,16723,,23,2,0,2
16724,16724,,23,0,1,1
16725,16725,,23,1,1,2
16726,16726,,23,1,0,1
16727,16727,,3,1,0,1
16728,16728,,43,20,9,29
16729,16729,,76,1,1,2
16730,16730,,14,1,1,2
16731,16731,,14,3,3,6
16732,16732,,14,1,0,1
16733,16733,,5,3,3,6
16734,16734,,11,1,1,2
16735,16735,,8,0,2,2
16736,16736,,0,5,7,12
16737,16737,,8,1,2,3
16738,16738,,23,2,3,5
16739,16739,,8,3,1,4
16740,16740,,21,4,1,5
16741,16741,,52,6,3,9
16742,16742,,14,1,0,1
16743,16743,,43,0,2,2
16744,16744,,14,0,1,1
16745,16745,,31,1,1,2
16746,16746,,31,1,0,1
16747,16747,,8,1,3,4
16748,16748,,8,1,0,1
16749,16749,,23,1,1,2
16750,16750,,8,0,1,1
16751,16751,,8,0,1,1
16752,16752,,76,1,0,1
16753,16753,,3,1,1,2
16754,16754,,23,1,1,2
16755,16755,,31,0,2,2
16756,16756,,18,2,1,3
16757,16757,,23,3,3,6
16758,16758,,21,13,14,27
16759,16759,,15,1,1,2
16760,16760,,23,1,1,2
16761,16761,,23,1,0,1
16762,16762,,8,0,2,2
16763,16763,,23,2,1,3
16764,16764,,23,1,1,2
16765,16765,,23,1,1,2
16766,16766,,11,37,35,72
16767,16767,,111,2,2,4
16768,16768,,111,1,0,1
16769,16769,,23,1,0,1
16770,16770,,3,2,0,2
16771,16771,,14,2,1,3
16772,16772,,23,1,0,1
16773,16773,,111,2,0,2
16774,16774,,111,1,0,1
16775,16775,,45,0,1,1
16776,16776,,45,0,1,1
16777,16777,,11,0,1,1
16778,16778,,8,2,1,3
16779,16779,,21,1,0,1
16780,16780,,11,1,1,2
16781,16781,,21,0,1,1
16782,16782,,88,1,0,1
16783,16783,,24,4,3,7
16784,16784,,21,0,1,1
16785,16785,,24,0,1,1
16786,16786,,127,1,1,2
16787,16787,,14,0,1,1
16788,16788,,127,0,1,1
16789,16789,,127,1,1,2
16790,16790,,66,1,0,1
16791,16791,,21,0,2,2
16792,16792,,111,1,1,2
16793,16793,,111,2,3,5
16794,16794,,76,0,2,2
16795,16795,,76,0,2,2
16796,16796,,14,3,0,3
16797,16797,,3,1,0,1
16798,16798,,111,1,2,3
16799,16799,,127,1,0,1
16800,16800,,8,1,4,5
16801,16801,,23,1,0,1
16802,16802,,23,1,1,2
16803,16803,,8,2,1,3
16804,16804,,8,1,0,1
16805,16805,,43,1,0,1
16806,16806,,8,1,2,3
16807,16807,,76,1,0,1
16808,16808,,111,8,1,9
16809,16809,,45,1,2,3
16810,16810,,6,1,4,5
16811,16811,,23,2,5,7
16812,16812,,127,1,1,2
16813,16813,,127,1,1,2
16814,16814,,127,1,1,2
16815,16815,,8,0,8,8
16816,16816,,6,0,1,1
16817,16817,,6,1,1,2
16818,16818,,15,0,1,1
16819,16819,,14,4,0,4
16820,16820,,0,0,1,1
16821,16821,,76,1,0,1
16822,16822,,127,3,0,3
16823,16823,,127,2,0,2
16824,16824,,45,0,1,1
16825,16825,,8,1,0,1
16826,16826,,127,0,3,3
16827,16827,,127,1,1,2
16828,16828,,5,0,1,1
16829,16829,,8,1,0,1
16830,16830,,11,1,0,1
16831,16831,,6,3,2,5
16832,16832,,5,1,2,3
16833,16833,,0,0,1,1
16834,16834,,23,0,1,1
16835,16835,,8,3,1,4
16836,16836,,15,5,1,6
16837,16837,,21,1,1,2
16838,16838,,21,1,0,1
16839,16839,,8,1,0,1
16840,16840,,8,1,1,2
16841,16841,,8,0,2,2
16842,16842,,43,1,1,2
16843,16843,,23,2,1,3
16844,16844,,23,1,2,3
16845,16845,,8,0,1,1
16846,16846,,14,2,1,3
16847,16847,,66,1,0,1
16848,16848,,43,2,0,2
16849,16849,,43,3,0,3
16850,16850,,14,2,1,3
16851,16851,,3,0,2,2
16852,16852,,21,1,1,2
16853,16853,,0,6,4,10
16854,16854,,0,1,1,2
16855,16855,,3,1,0,1
16856,16856,,14,0,1,1
16857,16857,,11,0,1,1
16858,16858,,14,1,0,1
16859,16859,,43,1,1,2
16860,16860,,23,0,2,2
16861,16861,,8,0,1,1
16862,16862,,8,0,1,1
16863,16863,,8,2,0,2
16864,16864,,8,2,0,2
16865,16865,,0,1,1,2
16866,16866,,111,1,1,2
16867,16867,,8,1,0,1
16868,16868,,43,0,1,1
16869,16869,,127,0,1,1
16870,16870,,11,1,0,1
16871,16871,,21,0,2,2
16872,16872,,8,1,1,2
16873,16873,,8,0,1,1
16874,16874,,3,1,1,2
16875,16875,,11,0,1,1
16876,16876,,14,0,1,1
16877,16877,,8,0,1,1
16878,16878,,8,0,1,1
16879,16879,,21,2,2,4
16880,16880,,8,1,1,2
16881,16881,,14,1,1,2
16882,16882,,23,0,2,2
16883,16883,,0,1,1,2
16884,16884,,23,1,0,1
16885,16885,,14,2,4,6
16886,16886,,11,1,0,1
16887,16887,,8,0,1,1
16888,16888,,23,0,1,1
16889,16889,,8,1,0,1
16890,16890,,23,1,0,1
16891,16891,,150,0,1,1
16892,16892,,150,1,0,1
16893,16893,,8,1,0,1
16894,16894,,6,1,2,3
16895,16895,,14,0,1,1
16896,16896,,43,1,1,2
16897,16897,,43,2,0,2
16898,16898,,23,1,1,2
16899,16899,,8,0,3,3
16900,16900,,14,1,0,1
16901,16901,,43,0,1,1
16902,16902,,43,3,2,5
16903,16903,,14,7,19,26
16904,16904,,43,1,0,1
16905,16905,,43,5,6,11
16906,16906,,23,2,1,3
16907,16907,,8,1,0,1
16908,16908,,0,0,1,1
16909,16909,,23,1,1,2
16910,16910,,23,1,1,2
16911,16911,,15,0,1,1
16912,16912,,31,0,1,1
16913,16913,,111,0,2,2
16914,16914,,8,0,1,1
16915,16915,,21,1,1,2
16916,16916,,31,1,0,1
16917,16917,,14,3,0,3
16918,16918,,127,1,0,1
16919,16919,,14,0,1,1
16920,16920,,8,6,4,10
16921,16921,,24,1,0,1
16922,16922,,8,1,0,1
16923,16923,,8,0,1,1
16924,16924,,14,0,1,1
16925,16925,,43,1,0,1
16926,16926,,23,0,1,1
16927,16927,,31,0,1,1
16928,16928,,8,1,2,3
16929,16929,,21,1,1,2
16930,16930,,23,1,1,2
16931,16931,,23,0,1,1
16932,16932,,14,3,2,5
16933,16933,,23,1,0,1
16934,16934,,8,0,1,1
16935,16935,,31,1,1,2
16936,16936,,8,1,0,1
16937,16937,,0,0,2,2
16938,16938,,111,1,0,1
16939,16939,,21,1,10,11
16940,16940,,88,1,1,2
16941,16941,,11,7,9,16
16942,16942,,11,2,2,4
16943,16943,,52,4,1,5
16944,16944,,52,0,1,1
16945,16945,,14,0,1,1
16946,16946,,0,1,0,1
16947,16947,,21,0,1,1
16948,16948,,23,0,1,1
16949,16949,,127,3,3,6
16950,16950,,52,0,4,4
16951,16951,,43,0,1,1
16952,16952,,11,1,0,1
16953,16953,,0,1,0,1
16954,16954,,21,4,4,8
16955,16955,,15,2,0,2
16956,16956,,3,0,1,1
16957,16957,,3,0,1,1
16958,16958,,14,1,1,2
16959,16959,,0,1,1,2
16960,16960,,0,0,1,1
16961,16961,,15,0,5,5
16962,16962,,43,0,2,2
16963,16963,,14,0,1,1
16964,16964,,43,2,0,2
16965,16965,,43,3,1,4
16966,16966,,127,0,2,2
16967,16967,,14,0,1,1
16968,16968,,8,1,1,2
16969,16969,,8,0,1,1
16970,16970,,8,1,1,2
16971,16971,,24,1,1,2
16972,16972,,23,1,2,3
16973,16973,,8,1,1,2
16974,16974,,21,1,0,1
16975,16975,,15,0,1,1
16976,16976,,21,3,2,5
16977,16977,,21,2,2,4
16978,16978,,8,1,1,2
16979,16979,,14,1,0,1
16980,16980,,0,1,3,4
16981,16981,,21,2,8,10
16982,16982,,6,2,1,3
16983,16983,,15,0,2,2
16984,16984,,11,2,0,2
16985,16985,,127,1,5,6
16986,16986,,8,8,7,15
16987,16987,,23,0,1,1
16988,16988,,111,0,1,1
16989,16989,,14,0,2,2
16990,16990,,111,0,4,4
16991,16991,,23,2,0,2
16992,16992,,8,0,1,1
16993,16993,,127,1,2,3
16994,16994,,23,2,1,3
16995,16995,,31,2,1,3
16996,16996,,66,1,3,4
16997,16997,,76,0,1,1
16998,16998,,18,1,1,2
16999,16999,,8,1,0,1
17000,17000,,8,1,0,1
17001,17001,,151,0,1,1
17002,17002,,151,1,0,1
17003,17003,,23,1,2,3
17004,17004,,8,2,1,3
17005,17005,,111,1,0,1
17006,17006,,14,1,1,2
17007,17007,,23,1,0,1
17008,17008,,127,0,1,1
17009,17009,,23,0,1,1
17010,17010,,66,1,1,2
17011,17011,,66,1,0,1
17012,17012,,8,0,1,1
17013,17013,,23,1,1,2
17014,17014,,111,0,1,1
17015,17015,,111,0,2,2
17016,17016,,111,1,0,1
17017,17017,,11,1,2,3
17018,17018,,0,0,1,1
17019,17019,,31,1,1,2
17020,17020,,105,1,1,2
17021,17021,,21,5,4,9
17022,17022,,23,2,0,2
17023,17023,,23,4,4,8
17024,17024,,21,0,1,1
17025,17025,,23,1,0,1
17026,17026,,23,0,1,1
17027,17027,,23,0,2,2
17028,17028,,8,1,4,5
17029,17029,,5,3,1,4
17030,17030,,23,2,3,5
17031,17031,,18,2,0,2
17032,17032,,127,1,1,2
17033,17033,,8,1,0,1
17034,17034,,23,0,4,4
17035,17035,,43,0,1,1
17036,17036,,105,0,2,2
17037,17037,,8,0,1,1
17038,17038,,111,1,0,1
17039,17039,,111,1,2,3
17040,17040,,111,1,1,2
17041,17041,,21,11,16,27
17042,17042,,88,2,2,4
17043,17043,,14,5,0,5
17044,17044,,3,3,0,3
17045,17045,,14,0,1,1
17046,17046,,14,1,2,3
17047,17047,,8,0,2,2
17048,17048,,43,1,0,1
17049,17049,,21,4,1,5
17050,17050,,0,1,0,1
17051,17051,,43,0,1,1
17052,17052,,43,0,1,1
17053,17053,,105,2,1,3
17054,17054,,15,1,2,3
17055,17055,,105,0,1,1
17056,17056,,45,0,2,2
17057,17057,,15,1,1,2
17058,17058,,18,0,3,3
17059,17059,,24,4,4,8
17060,17060,,111,1,4,5
17061,17061,,8,0,1,1
17062,17062,,0,2,1,3
17063,17063,,111,3,1,4
17064,17064,,11,2,3,5
17065,17065,,120,0,2,2
17066,17066,,66,1,0,1
17067,17067,,21,0,1,1
17068,17068,,3,2,1,3
17069,17069,,8,0,1,1
17070,17070,,15,1,0,1
17071,17071,,23,1,0,1
17072,17072,,23,1,0,1
17073,17073,,8,0,1,1
17074,17074,,45,1,1,2
17075,17075,,8,1,1,2
17076,17076,,14,3,1,4
17077,17077,,8,9,7,16
17078,17078,,127,1,1,2
17079,17079,,0,1,1,2
17080,17080,,23,16,22,38
17081,17081,,23,3,4,7
17082,17082,,76,2,1,3
17083,17083,,23,1,1,2
17084,17084,,8,0,2,2
17085,17085,,127,0,4,4
17086,17086,,52,1,3,4
17087,17087,,0,0,1,1
17088,17088,,21,2,4,6
17089,17089,,111,2,1,3
17090,17090,,8,1,1,2
17091,17091,,8,1,1,2
17092,17092,,23,0,2,2
17093,17093,,23,1,0,1
17094,17094,,8,2,0,2
17095,17095,,14,1,0,1
17096,17096,,14,1,1,2
17097,17097,,23,1,0,1
17098,17098,,43,2,0,2
17099,17099,,66,3,1,4
17100,17100,,23,1,0,1
17101,17101,,8,0,1,1
17102,17102,,8,1,1,2
17103,17103,,127,1,1,2
17104,17104,,88,1,1,2
17105,17105,,21,5,0,5
17106,17106,,127,1,0,1
17107,17107,,127,2,1,3
17108,17108,,45,0,2,2
17109,17109,,152,0,1,1
17110,17110,,152,2,0,2
17111,17111,,152,0,1,1
17112,17112,,23,0,1,1
17113,17113,,5,2,0,2
17114,17114,,21,0,6,6
17115,17115,,111,0,1,1
17116,17116,,105,2,1,3
17117,17117,,66,0,4,4
17118,17118,,66,5,0,5
17119,17119,,14,1,0,1
17120,17120,,14,1,0,1
17121,17121,,52,1,0,1
17122,17122,,127,1,2,3
17123,17123,,14,1,0,1
17124,17124,,23,0,1,1
17125,17125,,127,1,0,1
17126,17126,,31,1,1,2
17127,17127,,15,1,1,2
17128,17128,,15,1,0,1
17129,17129,,31,1,0,1
17130,17130,,23,0,1,1
17131,17131,,66,2,1,3
17132,17132,,21,1,0,1
17133,17133,,88,2,1,3
17134,17134,,23,1,0,1
17135,17135,,3,1,1,2
17136,17136,,3,1,2,3
17137,17137,,5,0,1,1
17138,17138,,0,1,3,4
17139,17139,,23,1,3,4
17140,17140,,8,0,1,1
17141,17141,,24,0,1,1
17142,17142,,23,14,33,47
17143,17143,,23,0,3,3
17144,17144,,153,0,1,1
17145,17145,,153,1,0,1
17146,17146,,194,0,2,2
17147,17147,,14,4,1,5
17148,17148,,6,1,0,1
17149,17149,,43,3,6,9
17150,17150,,23,1,1,2
17151,17151,,8,0,1,1
17152,17152,,0,1,7,8
17153,17153,,23,2,14,16
17154,17154,,23,1,0,1
17155,17155,,23,6,18,24
17156,17156,,111,1,0,1
17157,17157,,23,1,1,2
17158,17158,,24,1,1,2
17159,17159,,45,0,1,1
17160,17160,,5,5,1,6
17161,17161,,8,1,0,1
17162,17162,,8,2,6,8
17163,17163,,23,1,0,1
17164,17164,,23,1,0,1
17165,17165,,8,1,1,2
17166,17166,,66,0,1,1
17167,17167,,27,1,0,1
17168,17168,,3,1,1,2
17169,17169,,23,1,0,1
17170,17170,,14,3,1,4
17171,17171,,52,0,1,1
17172,17172,,105,0,1,1
17173,17173,,23,2,2,4
17174,17174,,3,1,0,1
17175,17175,,23,1,1,2
17176,17176,,23,0,1,1
17177,17177,,23,1,1,2
17178,17178,,127,4,2,6
17179,17179,,52,1,1,2
17180,17180,,14,2,2,4
17181,17181,,23,1,1,2
17182,17182,,21,2,2,4
17183,17183,,105,2,1,3
17184,17184,,105,1,0,1
17185,17185,,3,0,1,1
17186,17186,,43,0,1,1
17187,17187,,14,1,1,2
17188,17188,,14,1,0,1
17189,17189,,31,2,1,3
17190,17190,,31,1,1,2
17191,17191,,8,1,2,3
17192,17192,,31,1,0,1
17193,17193,,15,1,1,2
17194,17194,,15,2,1,3
17195,17195,,23,2,1,3
17196,17196,,14,6,0,6
17197,17197,,21,2,1,3
17198,17198,,0,3,0,3
17199,17199,,31,0,1,1
17200,17200,,6,1,0,1
17201,17201,,76,1,3,4
17202,17202,,24,1,0,1
17203,17203,,8,0,1,1
17204,17204,,8,0,1,1
17205,17205,,23,1,0,1
17206,17206,,31,0,3,3
17207,17207,,8,2,1,3
17208,17208,,154,0,1,1
17209,17209,,154,1,0,1
17210,17210,,8,2,1,3
17211,17211,,21,1,1,2
17212,17212,,23,1,0,1
17213,17213,,45,0,1,1
17214,17214,,3,1,1,2
17215,17215,,11,0,3,3
17216,17216,,3,0,1,1
17217,17217,,11,0,1,1
17218,17218,,76,1,3,4
17219,17219,,43,1,0,1
17220,17220,,3,1,1,2
17221,17221,,14,1,0,1
17222,17222,,23,0,1,1
17223,17223,,15,3,4,7
17224,17224,,52,0,2,2
17225,17225,,127,0,1,1
17226,17226,,43,2,0,2
17227,17227,,8,1,1,2
17228,17228,,43,0,2,2
17229,17229,,43,4,6,10
17230,17230,,43,0,1,1
17231,17231,,52,1,3,4
17232,17232,,0,1,1,2
17233,17233,,23,1,1,2
17234,17234,,23,1,0,1
17235,17235,,23,1,1,2
17236,17236,,127,0,3,3
17237,17237,,0,0,4,4
17238,17238,,43,1,0,1
17239,17239,,76,1,0,1
17240,17240,,8,2,2,4
17241,17241,,11,2,3,5
17242,17242,,45,1,0,1
17243,17243,,23,0,1,1
17244,17244,,15,0,1,1
17245,17245,,8,2,4,6
17246,17246,,11,0,1,1
17247,17247,,23,1,0,1
17248,17248,,6,1,0,1
17249,17249,,24,0,2,2
17250,17250,,155,0,1,1
17251,17251,,155,1,0,1
17252,17252,,43,0,1,1
17253,17253,,43,0,1,1
17254,17254,,88,2,0,2
17255,17255,,11,1,0,1
17256,17256,,8,0,1,1
17257,17257,,14,1,2,3
17258,17258,,111,2,2,4
17259,17259,,111,2,2,4
17260,17260,,5,0,1,1
17261,17261,,21,1,1,2
17262,17262,,21,0,1,1
17263,17263,,24,8,11,19
17264,17264,,8,1,1,2
17265,17265,,3,0,1,1
17266,17266,,3,4,4,8
17267,17267,,23,3,0,3
17268,17268,,23,1,1,2
17269,17269,,23,0,2,2
17270,17270,,15,0,1,1
17271,17271,,8,14,3,17
17272,17272,,8,2,0,2
17273,17273,,14,0,2,2
17274,17274,,23,0,1,1
17275,17275,,43,0,1,1
17276,17276,,156,0,1,1
17277,17277,,156,1,0,1
17278,17278,,14,0,1,1
17279,17279,,52,2,5,7
17280,17280,,8,0,1,1
17281,17281,,43,2,7,9
17282,17282,,120,3,1,4
17283,17283,,21,0,1,1
17284,17284,,23,1,0,1
17285,17285,,24,2,1,3
17286,17286,,21,2,1,3
17287,17287,,23,0,1,1
17288,17288,,175,1,2,3
17289,17289,,175,0,1,1
17290,17290,,111,0,1,1
17291,17291,,21,0,1,1
17292,17292,,127,3,3,6
17293,17293,,120,0,1,1
17294,17294,,23,2,0,2
17295,17295,,18,0,2,2
17296,17296,,18,1,0,1
17297,17297,,8,1,1,2
17298,17298,,14,1,1,2
17299,17299,,23,1,0,1
17300,17300,,18,1,1,2
17301,17301,,8,2,0,2
17302,17302,,8,0,1,1
17303,17303,,15,0,1,1
17304,17304,,8,1,0,1
17305,17305,,8,0,2,2
17306,17306,,8,1,0,1
17307,17307,,14,3,1,4
17308,17308,,23,1,0,1
17309,17309,,23,0,2,2
17310,17310,,6,0,3,3
17311,17311,,24,3,0,3
17312,17312,,31,1,0,1
17313,17313,,45,1,0,1
17314,17314,,23,1,1,2
17315,17315,,3,0,1,1
17316,17316,,11,2,8,10
17317,17317,,127,1,0,1
17318,17318,,21,0,1,1
17319,17319,,23,0,2,2
17320,17320,,21,0,2,2
17321,17321,,0,0,1,1
17322,17322,,0,0,1,1
17323,17323,,3,1,1,2
17324,17324,,52,1,0,1
17325,17325,,3,0,1,1
17326,17326,,43,0,4,4
17327,17327,,21,1,0,1
17328,17328,,88,0,1,1
17329,17329,,88,1,0,1
17330,17330,,23,0,1,1
17331,17331,,127,0,1,1
17332,17332,,43,1,3,4
17333,17333,,23,1,0,1
17334,17334,,11,0,1,1
17335,17335,,18,4,2,6
17336,17336,,52,0,1,1
17337,17337,,88,1,0,1
17338,17338,,111,0,1,1
17339,17339,,23,0,1,1
17340,17340,,3,1,0,1
17341,17341,,111,1,1,2
17342,17342,,111,9,1,10
17343,17343,,23,2,0,2
17344,17344,,43,0,1,1
17345,17345,,31,1,2,3
17346,17346,,23,2,1,3
17347,17347,,15,0,1,1
17348,17348,,127,1,1,2
17349,17349,,21,1,5,6
17350,17350,,15,3,5,8
17351,17351,,8,0,1,1
17352,17352,,8,0,1,1
17353,17353,,3,1,0,1
17354,17354,,8,0,4,4
17355,17355,,3,3,1,4
17356,17356,,105,0,2,2
17357,17357,,8,0,1,1
17358,17358,,127,1,0,1
17359,17359,,43,0,1,1
17360,17360,,66,1,0,1
17361,17361,,24,0,1,1
17362,17362,,111,2,0,2
17363,17363,,18,1,1,2
17364,17364,,18,0,1,1
17365,17365,,157,0,2,2
17366,17366,,157,1,0,1
17367,17367,,6,2,4,6
17368,17368,,23,7,7,14
17369,17369,,15,7,5,12
17370,17370,,14,0,2,2
17371,17371,,23,1,0,1
17372,17372,,15,4,1,5
17373,17373,,24,0,3,3
17374,17374,,24,1,0,1
17375,17375,,24,0,1,1
17376,17376,,23,0,3,3
17377,17377,,15,1,1,2
17378,17378,,11,2,0,2
17379,17379,,127,2,0,2
17380,17380,,31,2,4,6
17381,17381,,8,2,2,4
17382,17382,,8,3,1,4
17383,17383,,3,0,1,1
17384,17384,,24,17,6,23
17385,17385,,23,0,1,1
17386,17386,,31,1,0,1
17387,17387,,23,0,1,1
17388,17388,,66,0,1,1
17389,17389,,127,2,3,5
17390,17390,,45,1,1,2
17391,17391,,14,1,1,2
17392,17392,,14,1,0,1
17393,17393,,0,2,3,5
17394,17394,,0,0,1,1
17395,17395,,0,0,1,1
17396,17396,,15,3,3,6
17397,17397,,24,15,8,23
17398,17398,,127,1,3,4
17399,17399,,3,2,0,2
17400,17400,,21,0,2,2
17401,17401,,21,1,5,6
17402,17402,,21,1,1,2
17403,17403,,23,1,0,1
17404,17404,,23,2,7,9
17405,17405,,8,0,4,4
17406,17406,,11,0,4,4
17407,17407,,88,1,0,1
17408,17408,,8,1,4,5
17409,17409,,158,0,1,1
17410,17410,,158,1,0,1
17411,17411,,15,0,5,5
17412,17412,,15,2,2,4
17413,17413,,15,1,0,1
17414,17414,,23,3,4,7
17415,17415,,23,1,1,2
17416,17416,,24,0,1,1
17417,17417,,11,1,1,2
17418,17418,,23,0,1,1
17419,17419,,23,1,1,2
17420,17420,,8,2,0,2
17421,17421,,8,2,2,4
17422,17422,,88,0,1,1
17423,17423,,11,1,1,2
17424,17424,,21,1,1,2
17425,17425,,15,0,1,1
17426,17426,,21,1,1,2
17427,17427,,127,0,5,5
17428,17428,,127,3,0,3
17429,17429,,6,2,2,4
17430,17430,,23,2,1,3
17431,17431,,23,0,1,1
17432,17432,,8,4,3,7
17433,17433,,8,0,1,1
17434,17434,,105,3,2,5
17435,17435,,15,2,0,2
17436,17436,,15,1,0,1
17437,17437,,111,1,0,1
17438,17438,,11,1,0,1
17439,17439,,23,1,1,2
17440,17440,,5,1,1,2
17441,17441,,8,2,5,7
17442,17442,,8,2,0,2
17443,17443,,31,2,4,6
17444,17444,,15,3,3,6
17445,17445,,18,0,6,6
17446,17446,,52,0,1,1
17447,17447,,18,3,1,4
17448,17448,,31,1,0,1
17449,17449,,8,1,0,1
17450,17450,,23,1,1,2
17451,17451,,18,2,5,7
17452,17452,,8,1,0,1
17453,17453,,15,0,1,1
17454,17454,,111,1,0,1
17455,17455,,3,1,2,3
17456,17456,,3,2,2,4
17457,17457,,52,1,3,4
17458,17458,,52,1,0,1
17459,17459,,8,1,0,1
17460,17460,,43,0,1,1
17461,17461,,14,1,0,1
17462,17462,,43,0,1,1
17463,17463,,0,0,1,1
17464,17464,,21,3,0,3
17465,17465,,23,1,0,1
17466,17466,,8,0,1,1
17467,17467,,8,0,1,1
17468,17468,,3,1,2,3
17469,17469,,52,1,1,2
17470,17470,,23,2,1,3
17471,17471,,23,0,1,1
17472,17472,,21,1,1,2
17473,17473,,23,0,1,1
17474,17474,,127,0,2,2
17475,17475,,111,1,2,3
17476,17476,,52,1,0,1
17477,17477,,159,0,1,1
17478,17478,,159,1,0,1
17479,17479,,24,1,0,1
17480,17480,,15,1,3,4
17481,17481,,23,1,1,2
17482,17482,,23,4,6,10
17483,17483,,6,3,0,3
17484,17484,,8,2,1,3
17485,17485,,23,0,1,1
17486,17486,,11,0,2,2
17487,17487,,14,1,0,1
17488,17488,,14,0,8,8
17489,17489,,18,0,2,2
17490,17490,,23,16,24,40
17491,17491,,23,1,0,1
17492,17492,,8,0,2,2
17493,17493,,23,1,1,2
17494,17494,,21,1,1,2
17495,17495,,23,1,1,2
17496,17496,,24,1,2,3
17497,17497,,45,4,3,7
17498,17498,,23,1,1,2
17499,17499,,31,0,2,2
17500,17500,,31,0,1,1
17501,17501,,21,0,2,2
17502,17502,,8,0,1,1
17503,17503,,18,1,0,1
17504,17504,,8,2,0,2
17505,17505,,23,0,2,2
17506,17506,,43,7,3,10
17507,17507,,0,0,1,1
17508,17508,,31,0,1,1
17509,17509,,21,1,0,1
17510,17510,,23,2,0,2
17511,17511,,8,2,0,2
17512,17512,,18,1,2,3
17513,17513,,14,1,0,1
17514,17514,,31,1,0,1
17515,17515,,160,0,1,1
17516,17516,,160,1,0,1
17517,17517,,3,0,1,1
17518,17518,,8,3,3,6
17519,17519,,14,1,0,1
17520,17520,,3,0,1,1
17521,17521,,127,1,0,1
17522,17522,,43,1,3,4
17523,17523,,43,1,2,3
17524,17524,,5,0,2,2
17525,17525,,0,0,1,1
17526,17526,,0,1,2,3
17527,17527,,66,0,1,1
17528,17528,,157,1,0,1
17529,17529,,14,0,1,1
17530,17530,,8,3,0,3
17531,17531,,14,0,1,1
17532,17532,,23,1,2,3
17533,17533,,43,1,1,2
17534,17534,,21,0,4,4
17535,17535,,21,2,0,2
17536,17536,,14,0,1,1
17537,17537,,31,2,0,2
17538,17538,,23,0,4,4
17539,17539,,18,2,0,2
17540,17540,,23,1,0,1
17541,17541,,14,1,1,2
17542,17542,,31,0,3,3
17543,17543,,23,0,2,2
17544,17544,,23,0,2,2
17545,17545,,31,1,1,2
17546,17546,,161,0,2,2
17547,17547,,161,2,0,2
17548,17548,,162,0,1,1
17549,17549,,162,1,0,1
17550,17550,,111,0,1,1
17551,17551,,23,0,1,1
17552,17552,,18,0,4,4
17553,17553,,111,1,0,1
17554,17554,,11,2,0,2
17555,17555,,18,0,1,1
17556,17556,,5,1,1,2
17557,17557,,23,0,1,1
17558,17558,,66,2,0,2
17559,17559,,8,1,1,2
17560,17560,,8,1,0,1
17561,17561,,3,3,2,5
17562,17562,,111,0,1,1
17563,17563,,23,1,1,2
17564,17564,,0,2,2,4
17565,17565,,21,1,0,1
17566,17566,,52,1,2,3
17567,17567,,23,1,1,2
17568,17568,,11,0,1,1
17569,17569,,11,0,1,1
17570,17570,,43,1,2,3
17571,17571,,43,1,1,2
17572,17572,,11,1,0,1
17573,17573,,14,1,2,3
17574,17574,,43,0,1,1
17575,17575,,31,1,3,4
17576,17576,,43,0,1,1
17577,17577,,105,0,1,1
17578,17578,,43,0,3,3
17579,17579,,8,14,9,23
17580,17580,,43,0,8,8
17581,17581,,21,1,2,3
17582,17582,,43,1,0,1
17583,17583,,127,0,2,2
17584,17584,,0,1,1,2
17585,17585,,45,1,0,1
17586,17586,,52,1,1,2
17587,17587,,14,0,1,1
17588,17588,,31,0,1,1
17589,17589,,163,0,1,1
17590,17590,,163,1,0,1
17591,17591,,8,1,0,1
17592,17592,,23,0,3,3
17593,17593,,164,0,1,1
17594,17594,,164,1,0,1
17595,17595,,18,3,5,8
17596,17596,,23,0,2,2
17597,17597,,23,2,2,4
17598,17598,,8,5,0,5
17599,17599,,3,0,1,1
17600,17600,,165,0,1,1
17601,17601,,165,1,0,1
17602,17602,,8,2,0,2
17603,17603,,14,1,0,1
17604,17604,,23,2,1,3
17605,17605,,21,0,2,2
17606,17606,,8,1,0,1
17607,17607,,23,0,3,3
17608,17608,,45,0,1,1
17609,17609,,52,1,0,1
17610,17610,,8,0,2,2
17611,17611,,14,1,0,1
17612,17612,,3,0,2,2
17613,17613,,166,0,1,1
17614,17614,,166,1,0,1
17615,17615,,43,0,4,4
17616,17616,,23,1,1,2
17617,17617,,21,0,2,2
17618,17618,,5,0,1,1
17619,17619,,43,0,1,1
17620,17620,,43,1,1,2
17621,17621,,23,0,1,1
17622,17622,,23,0,1,1
17623,17623,,14,1,5,6
17624,17624,,167,1,1,2
17625,17625,,167,1,1,2
17626,17626,,15,2,0,2
17627,17627,,3,1,1,2
17628,17628,,23,0,1,1
17629,17629,,21,0,1,1
17630,17630,,23,0,3,3
17631,17631,,23,0,1,1
17632,17632,,23,1,0,1
17633,17633,,3,2,0,2
17634,17634,,8,0,4,4
17635,17635,,8,3,7,10
17636,17636,,3,1,0,1
17637,17637,,23,6,2,8
17638,17638,,52,0,1,1
17639,17639,,21,0,1,1
17640,17640,,0,2,10,12
17641,17641,,52,0,1,1
17642,17642,,127,1,1,2
17643,17643,,105,8,4,12
17644,17644,,15,1,2,3
17645,17645,,31,1,0,1
17646,17646,,76,1,4,5
17647,17647,,76,0,1,1
17648,17648,,11,1,1,2
17649,17649,,11,0,3,3
17650,17650,,23,2,4,6
17651,17651,,23,5,2,7
17652,17652,,3,1,1,2
17653,17653,,127,1,1,2
17654,17654,,8,1,0,1
17655,17655,,23,0,1,1
17656,17656,,127,0,1,1
17657,17657,,8,4,0,4
17658,17658,,8,3,0,3
17659,17659,,23,1,0,1
17660,17660,,11,1,2,3
17661,17661,,23,0,1,1
17662,17662,,127,2,1,3
17663,17663,,11,0,2,2
17664,17664,,18,2,1,3
17665,17665,,21,1,0,1
17666,17666,,11,0,2,2
17667,17667,,11,4,6,10
17668,17668,,21,1,5,6
17669,17669,,111,0,2,2
17670,17670,,23,0,1,1
17671,17671,,23,2,1,3
17672,17672,,23,0,1,1
17673,17673,,23,0,1,1
17674,17674,,5,0,2,2
17675,17675,,5,4,0,4
17676,17676,,15,1,0,1
17677,17677,,88,0,1,1
17678,17678,,120,2,5,7
17679,17679,,8,1,0,1
17680,17680,,8,0,2,2
17681,17681,,0,0,1,1
17682,17682,,3,1,0,1
17683,17683,,23,2,1,3
17684,17684,,127,1,2,3
17685,17685,,111,1,0,1
17686,17686,,24,1,0,1
17687,17687,,168,0,1,1
17688,17688,,168,1,0,1
17689,17689,,31,1,0,1
17690,17690,,18,0,2,2
17691,17691,,127,1,0,1
17692,17692,,127,2,0,2
17693,17693,,23,0,1,1
17694,17694,,3,2,1,3
17695,17695,,23,0,1,1
17696,17696,,43,0,2,2
17697,17697,,3,1,0,1
17698,17698,,8,0,1,1
17699,17699,,45,1,1,2
17700,17700,,8,1,0,1
17701,17701,,24,1,0,1
17702,17702,,24,1,0,1
17703,17703,,111,0,13,13
17704,17704,,15,0,1,1
17705,17705,,23,1,0,1
17706,17706,,3,2,1,3
17707,17707,,14,0,1,1
17708,17708,,169,0,1,1
17709,17709,,169,1,0,1
17710,17710,,0,6,1,7
17711,17711,,8,2,0,2
17712,17712,,21,0,1,1
17713,17713,,31,0,3,3
17714,17714,,11,0,1,1
17715,17715,,8,0,1,1
17716,17716,,15,2,1,3
17717,17717,,15,0,2,2
17718,17718,,11,1,0,1
17719,17719,,11,1,0,1
17720,17720,,111,0,1,1
17721,17721,,21,2,1,3
17722,17722,,45,1,6,7
17723,17723,,45,0,1,1
17724,17724,,24,0,1,1
17725,17725,,15,0,1,1
17726,17726,,31,0,10,10
17727,17727,,8,3,0,3
17728,17728,,21,7,14,21
17729,17729,,170,0,1,1
17730,17730,,170,1,0,1
17731,17731,,52,1,2,3
17732,17732,,52,0,1,1
17733,17733,,8,1,0,1
17734,17734,,45,1,4,5
17735,17735,,88,0,1,1
17736,17736,,0,4,4,8
17737,17737,,23,1,0,1
17738,17738,,105,4,2,6
17739,17739,,43,0,2,2
17740,17740,,8,1,1,2
17741,17741,,43,0,1,1
17742,17742,,14,0,1,1
17743,17743,,15,2,2,4
17744,17744,,88,0,1,1
17745,17745,,127,0,1,1
17746,17746,,43,1,3,4
17747,17747,,15,1,0,1
17748,17748,,21,0,2,2
17749,17749,,66,1,7,8
17750,17750,,23,0,1,1
17751,17751,,8,2,1,3
17752,17752,,23,4,4,8
17753,17753,,171,0,1,1
17754,17754,,171,1,0,1
17755,17755,,23,0,1,1
17756,17756,,52,1,1,2
17757,17757,,8,0,1,1
17758,17758,,105,1,0,1
17759,17759,,120,1,0,1
17760,17760,,111,1,0,1
17761,17761,,15,1,1,2
17762,17762,,111,0,1,1
17763,17763,,21,4,4,8
17764,17764,,23,1,0,1
17765,17765,,172,1,1,2
17766,17766,,172,1,1,2
17767,17767,,45,0,2,2
17768,17768,,45,1,0,1
17769,17769,,11,5,5,10
17770,17770,,24,1,0,1
17771,17771,,8,3,0,3
17772,17772,,8,1,5,6
17773,17773,,23,1,1,2
17774,17774,,23,0,1,1
17775,17775,,8,0,1,1
17776,17776,,3,3,4,7
17777,17777,,23,2,1,3
17778,17778,,43,1,1,2
17779,17779,,127,2,3,5
17780,17780,,76,1,0,1
17781,17781,,11,0,1,1
17782,17782,,11,0,1,1
17783,17783,,31,1,0,1
17784,17784,,31,0,2,2
17785,17785,,14,3,0,3
17786,17786,,173,0,1,1
17787,17787,,173,1,0,1
17788,17788,,127,5,4,9
17789,17789,,127,1,1,2
17790,17790,,52,1,1,2
17791,17791,,23,2,13,15
17792,17792,,23,1,0,1
17793,17793,,15,1,0,1
17794,17794,,43,0,1,1
17795,17795,,45,1,0,1
17796,17796,,23,1,1,2
17797,17797,,23,1,0,1
17798,17798,,23,1,0,1
17799,17799,,3,0,2,2
17800,17800,,23,0,1,1
17801,17801,,11,0,1,1
17802,17802,,23,1,1,2
17803,17803,,21,0,2,2
17804,17804,,105,1,1,2
17805,17805,,21,0,1,1
17806,17806,,66,1,0,1
17807,17807,,0,0,1,1
17808,17808,,14,2,2,4
17809,17809,,0,0,1,1
17810,17810,,8,4,1,5
17811,17811,,5,0,7,7
17812,17812,,3,0,1,1
17813,17813,,8,1,3,4
17814,17814,,120,0,1,1
17815,17815,,120,1,5,6
17816,17816,,23,1,0,1
17817,17817,,14,3,1,4
17818,17818,,8,2,1,3
17819,17819,,76,1,0,1
17820,17820,,11,0,1,1
17821,17821,,15,1,0,1
17822,17822,,15,13,10,23
17823,17823,,76,0,1,1
17824,17824,,21,5,5,10
17825,17825,,8,1,1,2
17826,17826,,23,1,0,1
17827,17827,,52,1,0,1
17828,17828,,3,1,1,2
17829,17829,,3,5,0,5
17830,17830,,76,2,2,4
17831,17831,,21,3,7,10
17832,17832,,111,1,0,1
17833,17833,,23,2,0,2
17834,17834,,3,8,0,8
17835,17835,,88,2,0,2
17836,17836,,23,0,1,1
17837,17837,,23,1,1,2
17838,17838,,18,0,1,1
17839,17839,,105,1,2,3
17840,17840,,6,3,2,5
17841,17841,,43,0,1,1
17842,17842,,174,0,1,1
17843,17843,,174,1,0,1
17844,17844,,23,1,0,1
17845,17845,,3,1,1,2
17846,17846,,8,2,5,7
17847,17847,,31,3,0,3
17848,17848,,111,4,1,5
17849,17849,,21,1,1,2
17850,17850,,23,0,2,2
17851,17851,,23,0,1,1
17852,17852,,23,2,0,2
17853,17853,,5,2,2,4
17854,17854,,11,1,0,1
17855,17855,,3,0,1,1
17856,17856,,127,0,1,1
17857,17857,,21,0,2,2
17858,17858,,3,0,2,2
17859,17859,,88,0,1,1
17860,17860,,3,2,1,3
17861,17861,,3,0,1,1
17862,17862,,21,3,2,5
17863,17863,,14,1,1,2
17864,17864,,23,0,1,1
17865,17865,,66,0,1,1
17866,17866,,8,1,0,1
17867,17867,,0,1,0,1
17868,17868,,23,1,3,4
17869,17869,,111,1,2,3
17870,17870,,43,1,1,2
17871,17871,,120,8,2,10
17872,17872,,31,0,5,5
17873,17873,,21,0,1,1
17874,17874,,43,0,1,1
17875,17875,,23,0,1,1
17876,17876,,31,1,1,2
17877,17877,,23,1,2,3
17878,17878,,23,0,2,2
17879,17879,,23,2,1,3
17880,17880,,11,3,1,4
17881,17881,,23,1,1,2
17882,17882,,8,0,5,5
17883,17883,,0,1,0,1
17884,17884,,23,1,0,1
17885,17885,,0,1,1,2
17886,17886,,8,1,6,7
17887,17887,,0,3,0,3
17888,17888,,23,0,1,1
17889,17889,,52,1,0,1
17890,17890,,11,2,0,2
17891,17891,,66,0,1,1
17892,17892,,23,1,0,1
17893,17893,,43,1,0,1
17894,17894,,43,1,1,2
17895,17895,,43,1,1,2
17896,17896,,43,1,0,1
17897,17897,,23,1,0,1
17898,17898,,0,0,1,1
17899,17899,,21,1,2,3
17900,17900,,3,2,2,4
17901,17901,,66,3,0,3
17902,17902,,8,2,0,2
17903,17903,,43,1,0,1
17904,17904,,8,1,0,1
17905,17905,,8,0,2,2
17906,17906,,0,1,0,1
17907,17907,,0,0,1,1
17908,17908,,23,1,1,2
17909,17909,,23,0,1,1
17910,17910,,3,0,1,1
17911,17911,,3,1,1,2
17912,17912,,5,2,2,4
17913,17913,,76,1,0,1
17914,17914,,11,4,0,4
17915,17915,,0,1,0,1
17916,17916,,21,2,3,5
17917,17917,,23,1,1,2
17918,17918,,14,1,2,3
17919,17919,,21,2,2,4
17920,17920,,23,2,6,8
17921,17921,,175,1,0,1
17922,17922,,18,2,0,2
17923,17923,,18,0,1,1
17924,17924,,23,0,1,1
17925,17925,,8,3,5,8
17926,17926,,15,2,0,2
17927,17927,,8,1,3,4
17928,17928,,127,3,4,7
17929,17929,,127,6,4,10
17930,17930,,43,0,1,1
17931,17931,,8,1,2,3
17932,17932,,5,3,4,7
17933,17933,,15,0,1,1
17934,17934,,127,1,0,1
17935,17935,,43,1,0,1
17936,17936,,176,0,1,1
17937,17937,,176,1,0,1
17938,17938,,105,2,0,2
17939,17939,,23,1,0,1
17940,17940,,43,0,1,1
17941,17941,,8,1,1,2
17942,17942,,76,2,1,3
17943,17943,,66,0,1,1
17944,17944,,8,0,1,1
17945,17945,,23,1,1,2
17946,17946,,8,1,1,2
17947,17947,,23,0,1,1
17948,17948,,120,1,1,2
17949,17949,,105,0,5,5
17950,17950,,23,1,0,1
17951,17951,,11,3,2,5
17952,17952,,45,1,1,2
17953,17953,,11,0,2,2
17954,17954,,11,0,2,2
17955,17955,,127,2,7,9
17956,17956,,23,1,2,3
17957,17957,,11,1,0,1
17958,17958,,11,0,1,1
17959,17959,,14,1,0,1
17960,17960,,8,1,2,3
17961,17961,,8,1,1,2
17962,17962,,43,0,1,1
17963,17963,,14,1,1,2
17964,17964,,23,1,0,1
17965,17965,,11,0,1,1
17966,17966,,52,0,2,2
17967,17967,,23,1,0,1
17968,17968,,23,1,1,2
17969,17969,,23,1,1,2
17970,17970,,43,4,0,4
17971,17971,,3,1,0,1
17972,17972,,127,1,0,1
17973,17973,,18,0,2,2
17974,17974,,23,1,2,3
17975,17975,,23,3,1,4
17976,17976,,18,1,0,1
17977,17977,,23,0,1,1
17978,17978,,14,0,2,2
17979,17979,,127,0,2,2
17980,17980,,127,2,0,2
17981,17981,,18,1,0,1
17982,17982,,11,2,0,2
17983,17983,,45,0,1,1
17984,17984,,23,0,1,1
17985,17985,,23,3,4,7
17986,17986,,8,3,0,3
17987,17987,,66,2,3,5
17988,17988,,23,1,0,1
17989,17989,,45,2,0,2
17990,17990,,8,3,1,4
17991,17991,,43,0,3,3
17992,17992,,15,1,1,2
17993,17993,,23,3,0,3
17994,17994,,88,2,4,6
17995,17995,,76,0,1,1
17996,17996,,11,0,2,2
17997,17997,,127,3,3,6
17998,17998,,43,0,1,1
17999,17999,,23,0,3,3
18000,18000,,18,0,1,1
18001,18001,,66,1,0,1
18002,18002,,66,1,0,1
18003,18003,,23,1,0,1
18004,18004,,111,1,0,1
18005,18005,,23,5,5,10
18006,18006,,31,1,0,1
18007,18007,,31,1,0,1
18008,18008,,43,0,1,1
18009,18009,,0,0,1,1
18010,18010,,11,7,7,14
18011,18011,,23,3,5,8
18012,18012,,52,0,1,1
18013,18013,,52,1,0,1
18014,18014,,23,1,0,1
18015,18015,,8,3,1,4
18016,18016,,43,0,1,1
18017,18017,,43,3,3,6
18018,18018,,0,0,1,1
18019,18019,,21,3,3,6
18020,18020,,52,1,0,1
18021,18021,,23,0,1,1
18022,18022,,14,1,1,2
18023,18023,,23,1,0,1
18024,18024,,76,2,0,2
18025,18025,,43,1,0,1
18026,18026,,127,0,1,1
18027,18027,,0,1,4,5
18028,18028,,0,1,0,1
18029,18029,,8,2,0,2
18030,18030,,127,1,3,4
18031,18031,,66,0,1,1
18032,18032,,105,1,4,5
18033,18033,,31,0,2,2
18034,18034,,31,0,2,2
18035,18035,,127,0,1,1
18036,18036,,127,1,1,2
18037,18037,,8,0,1,1
18038,18038,,23,0,1,1
18039,18039,,127,0,3,3
18040,18040,,23,1,1,2
18041,18041,,45,1,2,3
18042,18042,,23,0,3,3
18043,18043,,24,0,1,1
18044,18044,,111,0,2,2
18045,18045,,111,2,1,3
18046,18046,,23,0,1,1
18047,18047,,111,1,0,1
18048,18048,,111,0,2,2
18049,18049,,66,0,1,1
18050,18050,,8,1,1,2
18051,18051,,23,0,1,1
18052,18052,,8,1,2,3
18053,18053,,23,0,2,2
18054,18054,,23,2,1,3
18055,18055,,76,0,5,5
18056,18056,,23,1,0,1
18057,18057,,8,1,1,2
18058,18058,,15,4,0,4
18059,18059,,15,0,1,1
18060,18060,,8,0,1,1
18061,18061,,8,2,0,2
18062,18062,,88,1,2,3
18063,18063,,14,3,3,6
18064,18064,,111,17,26,43
18065,18065,,8,3,2,5
18066,18066,,52,1,0,1
18067,18067,,23,1,0,1
18068,18068,,18,3,4,7
18069,18069,,8,1,0,1
18070,18070,,15,0,2,2
18071,18071,,111,0,2,2
18072,18072,,21,0,2,2
18073,18073,,88,3,0,3
18074,18074,,76,0,1,1
18075,18075,,8,0,1,1
18076,18076,,15,1,1,2
18077,18077,,52,3,0,3
18078,18078,,5,0,12,12
18079,18079,,14,1,1,2
18080,18080,,66,1,0,1
18081,18081,,23,1,0,1
18082,18082,,43,0,1,1
18083,18083,,43,3,3,6
18084,18084,,8,0,1,1
18085,18085,,66,1,1,2
18086,18086,,15,0,1,1
18087,18087,,43,0,1,1
18088,18088,,23,1,0,1
18089,18089,,23,1,0,1
18090,18090,,21,3,3,6
18091,18091,,23,0,1,1
18092,18092,,43,0,1,1
18093,18093,,8,1,1,2
18094,18094,,88,0,1,1
18095,18095,,15,0,1,1
18096,18096,,111,0,1,1
18097,18097,,8,1,2,3
18098,18098,,111,1,0,1
18099,18099,,21,1,0,1
18100,18100,,43,1,0,1
18101,18101,,23,0,1,1
18102,18102,,8,0,1,1
18103,18103,,23,3,2,5
18104,18104,,23,1,3,4
18105,18105,,23,0,1,1
18106,18106,,23,2,3,5
18107,18107,,88,0,2,2
18108,18108,,23,1,0,1
18109,18109,,111,0,1,1
18110,18110,,111,1,0,1
18111,18111,,23,1,0,1
18112,18112,,23,5,2,7
18113,18113,,111,0,1,1
18114,18114,,8,0,2,2
18115,18115,,15,0,1,1
18116,18116,,8,5,3,8
18117,18117,,3,2,2,4
18118,18118,,3,3,2,5
18119,18119,,45,3,2,5
18120,18120,,3,1,2,3
18121,18121,,21,1,0,1
18122,18122,,31,0,2,2
18123,18123,,23,0,2,2
18124,18124,,0,0,3,3
18125,18125,,0,1,0,1
18126,18126,,21,0,1,1
18127,18127,,23,0,1,1
18128,18128,,127,0,1,1
18129,18129,,23,0,1,1
18130,18130,,6,1,1,2
18131,18131,,127,0,2,2
18132,18132,,31,0,1,1
18133,18133,,23,1,3,4
18134,18134,,66,1,0,1
18135,18135,,127,1,0,1
18136,18136,,23,3,5,8
18137,18137,,23,3,2,5
18138,18138,,24,1,1,2
18139,18139,,66,0,1,1
18140,18140,,127,4,0,4
18141,18141,,23,0,1,1
18142,18142,,43,2,0,2
18143,18143,,23,0,1,1
18144,18144,,14,0,1,1
18145,18145,,23,1,0,1
18146,18146,,31,1,1,2
18147,18147,,18,1,2,3
18148,18148,,14,1,0,1
18149,18149,,31,14,3,17
18150,18150,,127,1,0,1
18151,18151,,127,2,0,2
18152,18152,,8,0,1,1
18153,18153,,23,3,0,3
18154,18154,,23,0,1,1
18155,18155,,3,0,1,1
18156,18156,,88,0,1,1
18157,18157,,3,1,0,1
18158,18158,,15,0,1,1
18159,18159,,45,1,1,2
18160,18160,,23,1,0,1
18161,18161,,23,1,2,3
18162,18162,,127,0,4,4
18163,18163,,15,0,1,1
18164,18164,,15,0,2,2
18165,18165,,8,0,1,1
18166,18166,,8,1,0,1
18167,18167,,111,2,2,4
18168,18168,,111,2,2,4
18169,18169,,45,0,1,1
18170,18170,,127,3,5,8
18171,18171,,23,1,0,1
18172,18172,,66,2,0,2
18173,18173,,6,0,1,1
18174,18174,,23,1,0,1
18175,18175,,8,1,0,1
18176,18176,,23,0,2,2
18177,18177,,23,1,0,1
18178,18178,,3,0,1,1
18179,18179,,15,3,2,5
18180,18180,,21,2,0,2
18181,18181,,52,3,0,3
18182,18182,,43,0,2,2
18183,18183,,11,1,0,1
18184,18184,,127,1,4,5
18185,18185,,11,0,1,1
18186,18186,,88,2,0,2
18187,18187,,3,0,1,1
18188,18188,,14,1,0,1
18189,18189,,43,3,2,5
18190,18190,,21,0,2,2
18191,18191,,5,2,2,4
18192,18192,,43,3,4,7
18193,18193,,31,1,0,1
18194,18194,,31,3,0,3
18195,18195,,0,0,3,3
18196,18196,,23,1,0,1
18197,18197,,111,2,1,3
18198,18198,,18,0,1,1
18199,18199,,23,3,0,3
18200,18200,,23,2,0,2
18201,18201,,23,0,1,1
18202,18202,,6,5,2,7
18203,18203,,88,0,1,1
18204,18204,,15,2,0,2
18205,18205,,8,0,1,1
18206,18206,,14,1,1,2
18207,18207,,23,1,1,2
18208,18208,,8,3,1,4
18209,18209,,24,1,1,2
18210,18210,,88,1,0,1
18211,18211,,23,0,1,1
18212,18212,,45,0,1,1
18213,18213,,8,0,1,1
18214,18214,,18,1,0,1
18215,18215,,23,1,0,1
18216,18216,,88,1,0,1
18217,18217,,23,0,1,1
18218,18218,,31,2,0,2
18219,18219,,43,1,0,1
18220,18220,,43,1,0,1
18221,18221,,88,1,3,4
18222,18222,,0,2,0,2
18223,18223,,15,0,4,4
18224,18224,,88,1,0,1
18225,18225,,31,1,0,1
18226,18226,,76,1,0,1
18227,18227,,23,1,1,2
18228,18228,,3,1,0,1
18229,18229,,5,0,1,1
18230,18230,,127,2,1,3
18231,18231,,43,1,0,1
18232,18232,,43,1,1,2
18233,18233,,43,0,1,1
18234,18234,,43,0,1,1
18235,18235,,0,3,3,6
18236,18236,,88,1,0,1
18237,18237,,88,1,0,1
18238,18238,,0,1,0,1
18239,18239,,11,2,0,2
18240,18240,,23,1,0,1
18241,18241,,0,1,0,1
18242,18242,,23,0,1,1
18243,18243,,21,3,1,4
18244,18244,,21,0,1,1
18245,18245,,23,1,4,5
18246,18246,,31,1,2,3
18247,18247,,127,1,0,1
18248,18248,,0,1,0,1
18249,18249,,21,0,3,3
18250,18250,,23,1,0,1
18251,18251,,8,0,2,2
18252,18252,,43,3,0,3
18253,18253,,8,1,3,4
18254,18254,,23,1,0,1
18255,18255,,88,1,0,1
18256,18256,,3,1,0,1
18257,18257,,88,1,0,1
18258,18258,,8,1,0,1
18259,18259,,23,0,1,1
18260,18260,,15,0,1,1
18261,18261,,8,0,2,2
18262,18262,,43,0,1,1
18263,18263,,177,0,1,1
18264,18264,,177,1,0,1
18265,18265,,14,1,1,2
18266,18266,,3,2,1,3
18267,18267,,43,0,1,1
18268,18268,,14,3,7,10
18269,18269,,23,1,1,2
18270,18270,,43,1,0,1
18271,18271,,23,1,0,1
18272,18272,,8,1,1,2
18273,18273,,31,0,2,2
18274,18274,,88,0,1,1
18275,18275,,8,0,1,1
18276,18276,,15,1,1,2
18277,18277,,88,1,1,2
18278,18278,,52,0,1,1
18279,18279,,8,1,1,2
18280,18280,,0,1,0,1
18281,18281,,43,0,2,2
18282,18282,,105,0,2,2
18283,18283,,23,1,1,2
18284,18284,,15,1,1,2
18285,18285,,11,0,5,5
18286,18286,,6,1,0,1
18287,18287,,23,0,1,1
18288,18288,,11,2,2,4
18289,18289,,52,2,0,2
18290,18290,,24,1,3,4
18291,18291,,111,0,1,1
18292,18292,,45,2,1,3
18293,18293,,120,1,1,2
18294,18294,,120,3,0,3
18295,18295,,14,1,0,1
18296,18296,,127,3,2,5
18297,18297,,6,3,1,4
18298,18298,,11,0,1,1
18299,18299,,23,4,4,8
18300,18300,,15,2,1,3
18301,18301,,76,3,0,3
18302,18302,,23,1,0,1
18303,18303,,23,8,0,8
18304,18304,,21,1,0,1
18305,18305,,21,0,1,1
18306,18306,,31,1,0,1
18307,18307,,3,1,2,3
18308,18308,,127,0,2,2
18309,18309,,120,0,1,1
18310,18310,,178,1,1,2
18311,18311,,178,1,1,2
18312,18312,,43,2,6,8
18313,18313,,8,1,0,1
18314,18314,,52,3,2,5
18315,18315,,127,0,1,1
18316,18316,,23,0,2,2
18317,18317,,21,1,0,1
18318,18318,,179,0,1,1
18319,18319,,179,1,0,1
18320,18320,,8,1,0,1
18321,18321,,43,4,2,6
18322,18322,,23,1,0,1
18323,18323,,8,1,0,1
18324,18324,,105,1,1,2
18325,18325,,105,0,3,3
18326,18326,,105,1,0,1
18327,18327,,21,0,2,2
18328,18328,,23,2,0,2
18329,18329,,88,2,1,3
18330,18330,,23,0,1,1
18331,18331,,66,3,0,3
18332,18332,,31,1,0,1
18333,18333,,31,1,1,2
18334,18334,,31,2,0,2
18335,18335,,18,1,0,1
18336,18336,,23,0,1,1
18337,18337,,127,1,1,2
18338,18338,,23,0,3,3
18339,18339,,8,0,1,1
18340,18340,,8,2,0,2
18341,18341,,31,0,1,1
18342,18342,,14,1,2,3
18343,18343,,23,1,1,2
18344,18344,,8,0,1,1
18345,18345,,14,1,0,1
18346,18346,,5,0,4,4
18347,18347,,31,0,1,1
18348,18348,,18,2,1,3
18349,18349,,24,1,0,1
18350,18350,,8,0,2,2
18351,18351,,88,1,3,4
18352,18352,,76,1,0,1
18353,18353,,111,2,1,3
18354,18354,,0,1,3,4
18355,18355,,0,1,1,2
18356,18356,,18,1,1,2
18357,18357,,31,0,1,1
18358,18358,,31,0,2,2
18359,18359,,15,1,1,2
18360,18360,,31,0,1,1
18361,18361,,15,1,1,2
18362,18362,,8,3,0,3
18363,18363,,31,6,0,6
18364,18364,,5,0,2,2
18365,18365,,11,2,0,2
18366,18366,,23,1,0,1
18367,18367,,3,1,3,4
18368,18368,,8,1,3,4
18369,18369,,23,1,1,2
18370,18370,,8,2,0,2
18371,18371,,23,0,1,1
18372,18372,,43,0,1,1
18373,18373,,180,0,1,1
18374,18374,,180,1,0,1
18375,18375,,3,5,0,5
18376,18376,,8,0,2,2
18377,18377,,0,0,1,1
18378,18378,,8,1,1,2
18379,18379,,76,2,1,3
18380,18380,,127,1,1,2
18381,18381,,8,0,1,1
18382,18382,,194,1,0,1
18383,18383,,194,1,1,2
18384,18384,,31,0,1,1
18385,18385,,45,1,0,1
18386,18386,,8,2,3,5
18387,18387,,8,2,3,5
18388,18388,,8,0,1,1
18389,18389,,8,0,3,3
18390,18390,,8,1,0,1
18391,18391,,23,1,2,3
18392,18392,,127,0,2,2
18393,18393,,31,0,1,1
18394,18394,,31,0,1,1
18395,18395,,88,0,1,1
18396,18396,,21,0,2,2
18397,18397,,23,1,0,1
18398,18398,,127,1,1,2
18399,18399,,127,1,1,2
18400,18400,,88,0,2,2
18401,18401,,23,3,1,4
18402,18402,,23,2,0,2
18403,18403,,3,1,0,1
18404,18404,,127,0,1,1
18405,18405,,23,0,1,1
18406,18406,,43,2,0,2
18407,18407,,3,0,1,1
18408,18408,,3,1,0,1
18409,18409,,66,1,0,1
18410,18410,,43,0,1,1
18411,18411,,127,0,2,2
18412,18412,,8,2,0,2
18413,18413,,127,1,1,2
18414,18414,,23,1,1,2
18415,18415,,21,1,0,1
18416,18416,,3,1,0,1
18417,18417,,45,4,1,5
18418,18418,,127,1,1,2
18419,18419,,15,2,2,4
18420,18420,,76,1,0,1
18421,18421,,23,1,1,2
18422,18422,,15,1,1,2
18423,18423,,15,1,0,1
18424,18424,,23,2,0,2
18425,18425,,66,0,1,1
18426,18426,,66,1,0,1
18427,18427,,23,0,1,1
18428,18428,,11,0,1,1
18429,18429,,45,0,2,2
18430,18430,,23,1,4,5
18431,18431,,43,0,1,1
18432,18432,,23,0,1,1
18433,18433,,18,1,1,2
18434,18434,,23,2,0,2
18435,18435,,52,0,1,1
18436,18436,,23,0,2,2
18437,18437,,8,0,1,1
18438,18438,,23,0,1,1
18439,18439,,3,0,2,2
18440,18440,,8,2,0,2
18441,18441,,21,0,1,1
18442,18442,,23,1,0,1
18443,18443,,43,1,1,2
18444,18444,,23,0,3,3
18445,18445,,88,2,0,2
18446,18446,,66,4,1,5
18447,18447,,127,1,1,2
18448,18448,,127,0,1,1
18449,18449,,45,2,1,3
18450,18450,,23,0,1,1
18451,18451,,66,2,0,2
18452,18452,,181,0,1,1
18453,18453,,181,2,0,2
18454,18454,,181,0,1,1
18455,18455,,23,1,4,5
18456,18456,,111,0,3,3
18457,18457,,0,1,2,3
18458,18458,,23,2,2,4
18459,18459,,23,1,1,2
18460,18460,,31,1,1,2
18461,18461,,31,1,0,1
18462,18462,,88,1,0,1
18463,18463,,43,0,1,1
18464,18464,,8,0,1,1
18465,18465,,23,6,6,12
18466,18466,,8,0,1,1
18467,18467,,45,0,2,2
18468,18468,,15,0,3,3
18469,18469,,23,1,0,1
18470,18470,,5,0,2,2
18471,18471,,23,0,1,1
18472,18472,,15,2,1,3
18473,18473,,127,0,2,2
18474,18474,,23,0,1,1
18475,18475,,11,5,2,7
18476,18476,,3,0,1,1
18477,18477,,43,0,1,1
18478,18478,,23,3,8,11
18479,18479,,182,0,1,1
18480,18480,,182,1,0,1
18481,18481,,127,1,0,1
18482,18482,,127,1,0,1
18483,18483,,8,1,1,2
18484,18484,,15,2,0,2
18485,18485,,15,1,1,2
18486,18486,,11,0,1,1
18487,18487,,8,1,0,1
18488,18488,,183,0,1,1
18489,18489,,183,1,0,1
18490,18490,,21,1,4,5
18491,18491,,66,2,4,6
18492,18492,,43,0,1,1
18493,18493,,43,1,1,2
18494,18494,,14,0,2,2
18495,18495,,14,0,1,1
18496,18496,,88,1,0,1
18497,18497,,45,4,0,4
18498,18498,,23,2,1,3
18499,18499,,11,0,1,1
18500,18500,,8,0,1,1
18501,18501,,14,1,0,1
18502,18502,,43,0,1,1
18503,18503,,76,0,4,4
18504,18504,,52,0,3,3
18505,18505,,3,1,1,2
18506,18506,,3,1,1,2
18507,18507,,15,1,2,3
18508,18508,,31,1,0,1
18509,18509,,23,0,1,1
18510,18510,,21,0,1,1
18511,18511,,111,1,0,1
18512,18512,,24,2,1,3
18513,18513,,24,0,1,1
18514,18514,,15,1,3,4
18515,18515,,11,3,1,4
18516,18516,,21,1,2,3
18517,18517,,8,0,2,2
18518,18518,,43,2,0,2
18519,18519,,21,6,2,8
18520,18520,,52,3,0,3
18521,18521,,11,0,1,1
18522,18522,,52,0,1,1
18523,18523,,43,1,0,1
18524,18524,,21,0,1,1
18525,18525,,127,0,3,3
18526,18526,,14,5,0,5
18527,18527,,14,0,1,1
18528,18528,,23,1,1,2
18529,18529,,15,2,1,3
18530,18530,,8,0,2,2
18531,18531,,43,0,1,1
18532,18532,,21,1,0,1
18533,18533,,23,0,2,2
18534,18534,,31,0,1,1
18535,18535,,105,1,1,2
18536,18536,,43,4,2,6
18537,18537,,14,1,0,1
18538,18538,,11,0,1,1
18539,18539,,43,1,0,1
18540,18540,,52,0,2,2
18541,18541,,111,1,0,1
18542,18542,,8,1,0,1
18543,18543,,18,4,1,5
18544,18544,,111,1,0,1
18545,18545,,23,0,2,2
18546,18546,,127,3,3,6
18547,18547,,23,1,2,3
18548,18548,,8,1,2,3
18549,18549,,45,0,1,1
18550,18550,,8,0,1,1
18551,18551,,21,0,1,1
18552,18552,,8,1,1,2
18553,18553,,23,5,3,8
18554,18554,,8,1,0,1
18555,18555,,8,1,1,2
18556,18556,,184,0,1,1
18557,18557,,184,1,0,1
18558,18558,,0,1,0,1
18559,18559,,18,2,3,5
18560,18560,,23,3,2,5
18561,18561,,3,0,2,2
18562,18562,,18,1,0,1
18563,18563,,111,4,0,4
18564,18564,,127,1,0,1
18565,18565,,8,0,1,1
18566,18566,,105,0,1,1
18567,18567,,23,2,2,4
18568,18568,,3,0,1,1
18569,18569,,11,0,1,1
18570,18570,,111,2,3,5
18571,18571,,127,2,0,2
18572,18572,,127,1,0,1
18573,18573,,43,0,1,1
18574,18574,,52,0,1,1
18575,18575,,24,2,2,4
18576,18576,,88,2,0,2
18577,18577,,3,2,2,4
18578,18578,,5,0,1,1
18579,18579,,23,0,1,1
18580,18580,,120,2,0,2
18581,18581,,0,1,1,2
18582,18582,,23,1,0,1
18583,18583,,11,1,0,1
18584,18584,,8,0,2,2
18585,18585,,14,1,1,2
18586,18586,,76,0,1,1
18587,18587,,23,1,0,1
18588,18588,,8,4,1,5
18589,18589,,8,1,3,4
18590,18590,,0,3,1,4
18591,18591,,23,0,1,1
18592,18592,,8,2,0,2
18593,18593,,23,2,0,2
18594,18594,,15,1,0,1
18595,18595,,23,1,0,1
18596,18596,,127,0,1,1
18597,18597,,23,1,1,2
18598,18598,,14,1,2,3
18599,18599,,23,1,1,2
18600,18600,,127,3,1,4
18601,18601,,23,1,0,1
18602,18602,,14,0,1,1
18603,18603,,8,1,1,2
18604,18604,,11,1,1,2
18605,18605,,111,2,1,3
18606,18606,,18,0,1,1
18607,18607,,24,6,4,10
18608,18608,,14,1,0,1
18609,18609,,31,1,1,2
18610,18610,,45,0,1,1
18611,18611,,45,0,1,1
18612,18612,,15,1,1,2
18613,18613,,23,1,1,2
18614,18614,,11,1,2,3
18615,18615,,14,0,1,1
18616,18616,,14,0,2,2
18617,18617,,5,0,1,1
18618,18618,,45,1,2,3
18619,18619,,23,0,2,2
18620,18620,,111,0,1,1
18621,18621,,88,1,1,2
18622,18622,,45,0,1,1
18623,18623,,21,1,0,1
18624,18624,,8,1,0,1
18625,18625,,111,2,1,3
18626,18626,,21,1,1,2
18627,18627,,15,0,1,1
18628,18628,,43,0,3,3
18629,18629,,18,1,1,2
18630,18630,,24,1,1,2
18631,18631,,23,1,1,2
18632,18632,,23,1,1,2
18633,18633,,31,1,2,3
18634,18634,,23,2,1,3
18635,18635,,3,1,0,1
18636,18636,,8,1,0,1
18637,18637,,23,2,3,5
18638,18638,,45,0,1,1
18639,18639,,3,1,0,1
18640,18640,,23,1,3,4
18641,18641,,11,3,3,6
18642,18642,,21,5,5,10
18643,18643,,127,1,0,1
18644,18644,,0,1,1,2
18645,18645,,0,1,0,1
18646,18646,,52,1,1,2
18647,18647,,43,0,3,3
18648,18648,,120,4,0,4
18649,18649,,66,3,2,5
18650,18650,,66,0,1,1
18651,18651,,120,0,1,1
18652,18652,,23,0,1,1
18653,18653,,23,1,1,2
18654,18654,,23,1,0,1
18655,18655,,45,1,1,2
18656,18656,,45,1,2,3
18657,18657,,31,2,1,3
18658,18658,,31,1,1,2
18659,18659,,41,0,2,2
18660,18660,,21,4,4,8
18661,18661,,111,1,0,1
18662,18662,,23,2,2,4
18663,18663,,76,0,2,2
18664,18664,,76,1,0,1
18665,18665,,23,1,1,2
18666,18666,,66,0,3,3
18667,18667,,23,0,1,1
18668,18668,,120,0,7,7
18669,18669,,23,2,1,3
18670,18670,,8,0,1,1
18671,18671,,23,0,2,2
18672,18672,,127,1,0,1
18673,18673,,111,0,2,2
18674,18674,,127,0,2,2
18675,18675,,8,1,0,1
18676,18676,,3,1,1,2
18677,18677,,111,0,1,1
18678,18678,,23,1,1,2
18679,18679,,23,1,1,2
18680,18680,,18,0,1,1
18681,18681,,24,0,2,2
18682,18682,,23,0,1,1
18683,18683,,8,0,1,1
18684,18684,,31,0,2,2
18685,18685,,31,1,0,1
18686,18686,,43,0,1,1
18687,18687,,127,1,2,3
18688,18688,,8,1,0,1
18689,18689,,8,4,0,4
18690,18690,,8,0,1,1
18691,18691,,111,0,2,2
18692,18692,,3,2,1,3
18693,18693,,15,1,1,2
18694,18694,,23,0,1,1
18695,18695,,21,1,0,1
18696,18696,,23,0,1,1
18697,18697,,8,2,0,2
18698,18698,,23,0,1,1
18699,18699,,23,4,2,6
18700,18700,,8,1,0,1
18701,18701,,43,0,1,1
18702,18702,,43,0,1,1
18703,18703,,23,2,0,2
18704,18704,,18,1,0,1
18705,18705,,3,1,0,1
18706,18706,,127,0,2,2
18707,18707,,3,2,1,3
18708,18708,,43,0,1,1
18709,18709,,3,0,1,1
18710,18710,,23,0,1,1
18711,18711,,14,1,0,1
18712,18712,,3,1,2,3
18713,18713,,8,1,1,2
18714,18714,,18,0,1,1
18715,18715,,8,1,0,1
18716,18716,,23,1,1,2
18717,18717,,31,10,14,24
18718,18718,,45,1,0,1
18719,18719,,43,1,0,1
18720,18720,,23,2,2,4
18721,18721,,11,1,0,1
18722,18722,,15,1,1,2
18723,18723,,111,0,1,1
18724,18724,,15,0,3,3
18725,18725,,11,0,1,1
18726,18726,,8,1,0,1
18727,18727,,52,2,1,3
18728,18728,,23,2,2,4
18729,18729,,120,2,1,3
18730,18730,,24,1,0,1
18731,18731,,24,0,1,1
18732,18732,,23,0,1,1
18733,18733,,66,1,0,1
18734,18734,,66,1,2,3
18735,18735,,21,1,0,1
18736,18736,,45,3,1,4
18737,18737,,45,0,1,1
18738,18738,,52,1,1,2
18739,18739,,66,0,1,1
18740,18740,,3,1,0,1
18741,18741,,185,0,1,1
18742,18742,,185,1,0,1
18743,18743,,21,0,1,1
18744,18744,,14,2,1,3
18745,18745,,3,1,1,2
18746,18746,,11,0,1,1
18747,18747,,23,0,1,1
18748,18748,,8,1,1,2
18749,18749,,45,0,1,1
18750,18750,,0,1,0,1
18751,18751,,23,0,1,1
18752,18752,,11,1,0,1
18753,18753,,14,1,0,1
18754,18754,,23,1,0,1
18755,18755,,8,0,2,2
18756,18756,,14,0,1,1
18757,18757,,31,0,1,1
18758,18758,,45,0,2,2
18759,18759,,127,0,1,1
18760,18760,,23,0,1,1
18761,18761,,8,0,1,1
18762,18762,,43,1,1,2
18763,18763,,186,0,1,1
18764,18764,,186,1,0,1
18765,18765,,31,0,1,1
18766,18766,,5,2,0,2
18767,18767,,111,0,1,1
18768,18768,,3,1,1,2
18769,18769,,52,0,1,1
18770,18770,,31,2,0,2
18771,18771,,187,0,1,1
18772,18772,,187,1,0,1
18773,18773,,88,1,1,2
18774,18774,,127,0,1,1
18775,18775,,23,1,1,2
18776,18776,,45,1,1,2
18777,18777,,43,6,6,12
18778,18778,,23,2,5,7
18779,18779,,11,1,0,1
18780,18780,,52,0,1,1
18781,18781,,23,0,1,1
18782,18782,,111,0,3,3
18783,18783,,5,2,1,3
18784,18784,,23,2,0,2
18785,18785,,11,1,0,1
18786,18786,,21,1,0,1
18787,18787,,127,2,0,2
18788,18788,,23,0,1,1
18789,18789,,43,1,0,1
18790,18790,,43,1,0,1
18791,18791,,8,2,1,3
18792,18792,,43,0,2,2
18793,18793,,11,0,1,1
18794,18794,,43,5,5,10
18795,18795,,127,2,0,2
18796,18796,,120,7,1,8
18797,18797,,43,0,1,1
18798,18798,,8,1,3,4
18799,18799,,111,3,0,3
18800,18800,,8,0,2,2
18801,18801,,85,2,1,3
18802,18802,,76,0,5,5
18803,18803,,111,0,1,1
18804,18804,,23,2,5,7
18805,18805,,23,1,1,2
18806,18806,,43,0,1,1
18807,18807,,23,1,1,2
18808,18808,,23,1,1,2
18809,18809,,43,1,2,3
18810,18810,,5,0,1,1
18811,18811,,11,1,0,1
18812,18812,,43,2,0,2
18813,18813,,8,1,0,1
18814,18814,,8,1,0,1
18815,18815,,43,0,1,1
18816,18816,,23,0,1,1
18817,18817,,23,0,1,1
18818,18818,,127,2,2,4
18819,18819,,23,0,1,1
18820,18820,,3,1,1,2
18821,18821,,8,0,2,2
18822,18822,,127,1,2,3
18823,18823,,23,2,1,3
18824,18824,,23,2,0,2
18825,18825,,5,4,0,4
18826,18826,,23,1,1,2
18827,18827,,45,1,0,1
18828,18828,,0,0,2,2
18829,18829,,8,0,1,1
18830,18830,,66,2,0,2
18831,18831,,66,2,1,3
18832,18832,,66,1,4,5
18833,18833,,0,0,2,2
18834,18834,,111,0,1,1
18835,18835,,21,3,5,8
18836,18836,,88,3,3,6
18837,18837,,66,1,0,1
18838,18838,,14,1,0,1
18839,18839,,23,1,1,2
18840,18840,,120,4,2,6
18841,18841,,23,0,1,1
18842,18842,,23,0,1,1
18843,18843,,8,0,2,2
18844,18844,,15,1,0,1
18845,18845,,8,0,2,2
18846,18846,,127,0,1,1
18847,18847,,15,2,0,2
18848,18848,,111,1,0,1
18849,18849,,31,1,1,2
18850,18850,,43,0,1,1
18851,18851,,111,0,1,1
18852,18852,,43,0,1,1
18853,18853,,23,0,1,1
18854,18854,,11,3,0,3
18855,18855,,8,0,1,1
18856,18856,,15,1,0,1
18857,18857,,8,0,6,6
18858,18858,,43,1,2,3
18859,18859,,52,3,1,4
18860,18860,,21,0,1,1
18861,18861,,23,2,0,2
18862,18862,,0,0,1,1
18863,18863,,31,0,1,1
18864,18864,,127,1,1,2
18865,18865,,8,1,0,1
18866,18866,,23,1,0,1
18867,18867,,23,1,0,1
18868,18868,,11,0,3,3
18869,18869,,23,1,0,1
18870,18870,,8,1,0,1
18871,18871,,8,1,3,4
18872,18872,,11,2,1,3
18873,18873,,15,0,1,1
18874,18874,,23,0,1,1
18875,18875,,127,2,0,2
18876,18876,,111,2,2,4
18877,18877,,23,0,1,1
18878,18878,,8,1,0,1
18879,18879,,23,1,1,2
18880,18880,,5,1,0,1
18881,18881,,18,1,0,1
18882,18882,,8,0,4,4
18883,18883,,3,2,1,3
18884,18884,,5,0,1,1
18885,18885,,23,0,1,1
18886,18886,,23,3,2,5
18887,18887,,21,1,0,1
18888,18888,,23,0,1,1
18889,18889,,23,1,0,1
18890,18890,,88,2,0,2
18891,18891,,15,0,1,1
18892,18892,,8,1,0,1
18893,18893,,127,1,0,1
18894,18894,,18,2,1,3
18895,18895,,11,1,0,1
18896,18896,,8,1,0,1
18897,18897,,23,0,1,1
18898,18898,,23,1,1,2
18899,18899,,23,0,1,1
18900,18900,,111,0,1,1
18901,18901,,105,1,2,3
18902,18902,,105,1,0,1
18903,18903,,111,1,0,1
18904,18904,,8,0,2,2
18905,18905,,14,2,0,2
18906,18906,,11,1,0,1
18907,18907,,120,1,0,1
18908,18908,,23,0,1,1
18909,18909,,76,1,1,2
18910,18910,,8,0,1,1
18911,18911,,43,2,0,2
18912,18912,,127,2,1,3
18913,18913,,8,1,1,2
18914,18914,,24,2,1,3
18915,18915,,111,1,1,2
18916,18916,,23,1,0,1
18917,18917,,52,2,5,7
18918,18918,,14,0,1,1
18919,18919,,105,0,2,2
18920,18920,,105,1,0,1
18921,18921,,52,1,0,1
18922,18922,,21,0,1,1
18923,18923,,3,0,1,1
18924,18924,,43,1,0,1
18925,18925,,43,1,1,2
18926,18926,,43,1,1,2
18927,18927,,8,1,0,1
18928,18928,,14,0,1,1
18929,18929,,52,1,1,2
18930,18930,,43,2,0,2
18931,18931,,21,0,2,2
18932,18932,,0,0,1,1
18933,18933,,52,1,0,1
18934,18934,,52,1,2,3
18935,18935,,23,0,1,1
18936,18936,,23,1,1,2
18937,18937,,21,0,1,1
18938,18938,,23,0,1,1
18939,18939,,23,1,0,1
18940,18940,,21,1,1,2
18941,18941,,127,1,0,1
18942,18942,,52,0,1,1
18943,18943,,43,0,1,1
18944,18944,,66,0,1,1
18945,18945,,66,0,1,1
18946,18946,,127,1,2,3
18947,18947,,45,0,1,1
18948,18948,,23,1,0,1
18949,18949,,45,1,0,1
18950,18950,,111,0,1,1
18951,18951,,127,0,1,1
18952,18952,,15,1,0,1
18953,18953,,15,0,1,1
18954,18954,,18,3,0,3
18955,18955,,105,3,2,5
18956,18956,,76,0,2,2
18957,18957,,0,1,0,1
18958,18958,,23,2,1,3
18959,18959,,8,1,0,1
18960,18960,,23,1,0,1
18961,18961,,11,1,0,1
18962,18962,,18,1,0,1
18963,18963,,76,1,0,1
18964,18964,,21,1,1,2
18965,18965,,23,0,1,1
18966,18966,,11,1,0,1
18967,18967,,24,0,1,1
18968,18968,,24,0,1,1
18969,18969,,11,0,1,1
18970,18970,,127,1,0,1
18971,18971,,18,0,2,2
18972,18972,,23,1,0,1
18973,18973,,15,3,4,7
18974,18974,,15,1,6,7
18975,18975,,11,0,1,1
18976,18976,,23,0,1,1
18977,18977,,127,0,1,1
18978,18978,,15,0,1,1
18979,18979,,43,0,1,1
18980,18980,,76,0,2,2
18981,18981,,14,1,1,2
18982,18982,,127,0,1,1
18983,18983,,43,3,1,4
18984,18984,,15,0,1,1
18985,18985,,127,2,0,2
18986,18986,,23,7,2,9
18987,18987,,43,1,0,1
18988,18988,,52,0,2,2
18989,18989,,76,1,1,2
18990,18990,,21,0,2,2
18991,18991,,43,5,6,11
18992,18992,,88,1,1,2
18993,18993,,88,2,0,2
18994,18994,,3,1,0,1
18995,18995,,127,0,4,4
18996,18996,,45,1,2,3
18997,18997,,31,0,1,1
18998,18998,,0,3,0,3
18999,18999,,23,0,2,2
19000,19000,,3,0,1,1
19001,19001,,127,1,1,2
19002,19002,,8,7,2,9
19003,19003,,21,1,1,2
19004,19004,,3,1,0,1
19005,19005,,88,3,0,3
19006,19006,,23,1,1,2
19007,19007,,43,1,0,1
19008,19008,,23,0,2,2
19009,19009,,8,3,3,6
19010,19010,,8,1,2,3
19011,19011,,18,1,0,1
19012,19012,,23,0,1,1
19013,19013,,23,0,2,2
19014,19014,,111,0,2,2
19015,19015,,8,0,2,2
19016,19016,,8,0,2,2
19017,19017,,23,1,0,1
19018,19018,,8,5,0,5
19019,19019,,105,0,4,4
19020,19020,,45,2,0,2
19021,19021,,11,1,0,1
19022,19022,,8,0,1,1
19023,19023,,43,2,2,4
19024,19024,,0,1,0,1
19025,19025,,0,0,1,1
19026,19026,,3,1,0,1
19027,19027,,105,2,1,3
19028,19028,,23,4,0,4
19029,19029,,127,1,1,2
19030,19030,,45,1,2,3
19031,19031,,15,3,0,3
19032,19032,,3,0,1,1
19033,19033,,88,1,1,2
19034,19034,,31,0,1,1
19035,19035,,31,0,1,1
19036,19036,,14,0,1,1
19037,19037,,43,2,0,2
19038,19038,,23,1,0,1
19039,19039,,43,2,1,3
19040,19040,,43,0,1,1
19041,19041,,8,2,2,4
19042,19042,,52,0,2,2
19043,19043,,52,0,2,2
19044,19044,,0,1,0,1
19045,19045,,23,0,1,1
19046,19046,,43,5,3,8
19047,19047,,43,2,0,2
19048,19048,,88,1,0,1
19049,19049,,21,0,1,1
19050,19050,,11,5,1,6
19051,19051,,8,1,0,1
19052,19052,,188,0,2,2
19053,19053,,188,2,0,2
19054,19054,,24,0,1,1
19055,19055,,11,3,1,4
19056,19056,,23,0,1,1
19057,19057,,18,0,1,1
19058,19058,,8,2,1,3
19059,19059,,8,1,1,2
19060,19060,,45,0,3,3
19061,19061,,0,0,1,1
19062,19062,,11,1,1,2
19063,19063,,23,1,4,5
19064,19064,,8,1,0,1
19065,19065,,45,1,1,2
19066,19066,,24,1,0,1
19067,19067,,23,0,1,1
19068,19068,,88,1,1,2
19069,19069,,23,0,1,1
19070,19070,,23,1,0,1
19071,19071,,8,6,8,14
19072,19072,,23,0,1,1
19073,19073,,23,0,1,1
19074,19074,,23,0,1,1
19075,19075,,23,0,1,1
19076,19076,,189,0,1,1
19077,19077,,189,1,0,1
19078,19078,,111,0,3,3
19079,19079,,43,0,1,1
19080,19080,,14,2,1,3
19081,19081,,14,1,2,3
19082,19082,,14,1,0,1
19083,19083,,14,0,1,1
19084,19084,,43,2,2,4
19085,19085,,8,0,10,10
19086,19086,,8,1,0,1
19087,19087,,23,0,1,1
19088,19088,,5,0,3,3
19089,19089,,8,1,0,1
19090,19090,,8,1,1,2
19091,19091,,11,1,0,1
19092,19092,,11,0,1,1
19093,19093,,8,2,3,5
19094,19094,,8,1,1,2
19095,19095,,15,1,0,1
19096,19096,,15,1,1,2
19097,19097,,3,1,0,1
19098,19098,,43,0,1,1
19099,19099,,105,0,1,1
19100,19100,,15,1,0,1
19101,19101,,23,0,1,1
19102,19102,,23,1,0,1
19103,19103,,21,1,1,2
19104,19104,,23,0,1,1
19105,19105,,23,0,1,1
19106,19106,,23,2,1,3
19107,19107,,66,0,1,1
19108,19108,,127,1,1,2
19109,19109,,45,0,1,1
19110,19110,,0,3,2,5
19111,19111,,23,1,0,1
19112,19112,,3,1,0,1
19113,19113,,43,0,1,1
19114,19114,,21,1,0,1
19115,19115,,43,1,0,1
19116,19116,,23,3,1,4
19117,19117,,8,1,0,1
19118,19118,,8,1,1,2
19119,19119,,23,0,1,1
19120,19120,,43,0,1,1
19121,19121,,21,1,0,1
19122,19122,,8,3,4,7
19123,19123,,3,4,0,4
19124,19124,,23,0,1,1
19125,19125,,8,0,2,2
19126,19126,,8,1,0,1
19127,19127,,18,0,1,1
19128,19128,,43,1,0,1
19129,19129,,43,0,1,1
19130,19130,,43,1,0,1
19131,19131,,43,2,0,2
19132,19132,,43,1,1,2
19133,19133,,105,2,1,3
19134,19134,,120,1,1,2
19135,19135,,31,0,2,2
19136,19136,,76,1,0,1
19137,19137,,76,0,1,1
19138,19138,,23,0,1,1
19139,19139,,43,0,2,2
19140,19140,,43,2,4,6
19141,19141,,8,1,0,1
19142,19142,,43,1,0,1
19143,19143,,23,0,1,1
19144,19144,,23,0,2,2
19145,19145,,21,0,1,1
19146,19146,,0,2,0,2
19147,19147,,8,1,0,1
19148,19148,,23,0,1,1
19149,19149,,23,0,1,1
19150,19150,,111,0,3,3
19151,19151,,15,1,0,1
19152,19152,,23,2,0,2
19153,19153,,15,1,0,1
19154,19154,,18,0,1,1
19155,19155,,88,0,3,3
19156,19156,,127,0,1,1
19157,19157,,23,1,0,1
19158,19158,,8,0,1,1
19159,19159,,11,1,1,2
19160,19160,,23,1,4,5
19161,19161,,8,0,1,1
19162,19162,,76,0,2,2
19163,19163,,23,0,2,2
19164,19164,,43,1,0,1
19165,19165,,15,1,0,1
19166,19166,,52,1,0,1
19167,19167,,23,0,1,1
19168,19168,,190,0,1,1
19169,19169,,190,1,0,1
19170,19170,,120,2,0,2
19171,19171,,23,5,8,13
19172,19172,,3,0,2,2
19173,19173,,23,0,4,4
19174,19174,,23,7,0,7
19175,19175,,21,3,0,3
19176,19176,,23,3,4,7
19177,19177,,23,3,1,4
19178,19178,,31,0,1,1
19179,19179,,23,1,0,1
19180,19180,,11,0,2,2
19181,19181,,23,0,1,1
19182,19182,,111,1,1,2
19183,19183,,45,1,1,2
19184,19184,,0,1,1,2
19185,19185,,43,0,1,1
19186,19186,,0,0,1,1
19187,19187,,11,0,1,1
19188,19188,,23,1,1,2
19189,19189,,11,0,1,1
19190,19190,,18,0,1,1
19191,19191,,23,1,1,2
19192,19192,,191,0,1,1
19193,19193,,191,1,0,1
19194,19194,,31,0,2,2
19195,19195,,23,1,2,3
19196,19196,,14,2,2,4
19197,19197,,3,1,0,1
19198,19198,,21,1,1,2
19199,19199,,21,2,2,4
19200,19200,,31,0,1,1
19201,19201,,31,0,4,4
19202,19202,,8,0,2,2
19203,19203,,3,0,1,1
19204,19204,,111,0,1,1
19205,19205,,111,0,1,1
19206,19206,,111,0,1,1
19207,19207,,43,1,0,1
19208,19208,,14,0,1,1
19209,19209,,43,0,1,1
19210,19210,,11,0,1,1
19211,19211,,23,0,1,1
19212,19212,,43,1,0,1
19213,19213,,120,1,0,1
19214,19214,,8,3,0,3
19215,19215,,192,0,1,1
19216,19216,,192,1,0,1
19217,19217,,18,1,0,1
19218,19218,,14,0,1,1
19219,19219,,11,2,3,5
19220,19220,,76,1,0,1
19221,19221,,23,3,5,8
19222,19222,,8,1,0,1
19223,19223,,23,3,0,3
19224,19224,,43,0,1,1
19225,19225,,8,1,0,1
19226,19226,,23,1,0,1
19227,19227,,23,1,0,1
19228,19228,,120,1,0,1
19229,19229,,43,0,1,1
19230,19230,,76,1,0,1
19231,19231,,23,0,2,2
19232,19232,,23,1,0,1
19233,19233,,88,1,0,1
19234,19234,,193,0,1,1
19235,19235,,193,1,0,1
19236,19236,,23,0,1,1
19237,19237,,6,0,1,1
19238,19238,,23,0,1,1
19239,19239,,23,0,1,1
19240,19240,,0,0,1,1
19241,19241,,23,1,0,1
19242,19242,,23,3,1,4
19243,19243,,23,1,1,2
19244,19244,,23,1,0,1
19245,19245,,11,1,0,1
19246,19246,,21,0,9,9
19247,19247,,21,0,2,2
19248,19248,,66,0,1,1
19249,19249,,11,2,1,3
19250,19250,,23,0,1,1
19251,19251,,11,0,2,2
19252,19252,,11,1,1,2
19253,19253,,111,0,1,1
19254,19254,,111,1,0,1
19255,19255,,18,1,0,1
19256,19256,,21,1,0,1
19257,19257,,24,2,0,2
19258,19258,,31,1,6,7
19259,19259,,8,2,0,2
19260,19260,,23,0,1,1
19261,19261,,31,2,1,3
19262,19262,,23,4,3,7
19263,19263,,21,1,0,1
19264,19264,,43,0,2,2
19265,19265,,21,1,0,1
19266,19266,,23,1,1,2
19267,19267,,23,1,1,2
19268,19268,,45,0,1,1
19269,19269,,194,1,0,1
19270,19270,,194,0,1,1
19271,19271,,111,1,1,2
19272,19272,,8,0,2,2
19273,19273,,3,0,1,1
19274,19274,,8,1,0,1
19275,19275,,15,2,2,4
19276,19276,,23,1,0,1
19277,19277,,0,0,1,1
19278,19278,,31,1,0,1
19279,19279,,11,1,0,1
19280,19280,,43,0,1,1
19281,19281,,8,2,2,4
19282,19282,,6,1,0,1
19283,19283,,105,2,1,3
19284,19284,,52,0,1,1
19285,19285,,76,0,2,2
19286,19286,,195,0,1,1
19287,19287,,195,1,0,1
19288,19288,,3,2,1,3
19289,19289,,45,0,1,1
19290,19290,,52,0,1,1
19291,19291,,3,1,1,2
19292,19292,,23,2,2,4
19293,19293,,23,10,12,22
19294,19294,,5,0,2,2
19295,19295,,43,0,1,1
19296,19296,,127,1,0,1
19297,19297,,0,0,1,1
19298,19298,,23,1,0,1
19299,19299,,0,0,1,1
19300,19300,,23,1,2,3
19301,19301,,15,0,1,1
19302,19302,,15,0,1,1
19303,19303,,43,2,1,3
19304,19304,,43,0,1,1
19305,19305,,43,1,0,1
19306,19306,,43,4,6,10
19307,19307,,43,2,2,4
19308,19308,,11,0,1,1
19309,19309,,23,1,0,1
19310,19310,,15,0,1,1
19311,19311,,11,8,0,8
19312,19312,,43,2,2,4
19313,19313,,31,2,0,2
19314,19314,,52,1,1,2
19315,19315,,52,1,0,1
19316,19316,,23,0,3,3
19317,19317,,8,0,1,1
19318,19318,,52,1,0,1
19319,19319,,31,1,0,1
19320,19320,,8,1,0,1
19321,19321,,21,1,1,2
19322,19322,,120,1,1,2
19323,19323,,23,5,18,23
19324,19324,,23,1,1,2
19325,19325,,23,0,1,1
19326,19326,,23,0,1,1
19327,19327,,23,0,1,1
19328,19328,,8,0,1,1
19329,19329,,3,1,1,2
19330,19330,,8,0,1,1
19331,19331,,111,0,1,1
19332,19332,,8,1,4,5
19333,19333,,45,1,0,1
19334,19334,,45,0,1,1
19335,19335,,45,2,0,2
19336,19336,,11,0,2,2
19337,19337,,6,0,1,1
19338,19338,,196,0,1,1
19339,19339,,196,1,0,1
19340,19340,,23,1,1,2
19341,19341,,23,2,2,4
19342,19342,,23,0,1,1
19343,19343,,23,1,0,1
19344,19344,,11,1,0,1
19345,19345,,127,1,0,1
19346,19346,,76,1,1,2
19347,19347,,8,0,1,1
19348,19348,,11,0,3,3
19349,19349,,8,1,0,1
19350,19350,,21,0,2,2
19351,19351,,5,0,1,1
19352,19352,,43,0,1,1
19353,19353,,23,1,0,1
19354,19354,,3,0,2,2
19355,19355,,127,0,1,1
19356,19356,,23,0,1,1
19357,19357,,11,0,4,4
19358,19358,,21,1,1,2
19359,19359,,23,4,0,4
19360,19360,,105,0,1,1
19361,19361,,52,1,0,1
19362,19362,,8,4,3,7
19363,19363,,0,0,2,2
19364,19364,,8,1,0,1
19365,19365,,23,1,0,1
19366,19366,,15,2,0,2
19367,19367,,194,0,1,1
19368,19368,,43,0,2,2
19369,19369,,8,1,3,4
19370,19370,,23,1,0,1
19371,19371,,21,1,1,2
19372,19372,,21,0,1,1
19373,19373,,45,1,0,1
19374,19374,,66,0,2,2
19375,19375,,43,0,2,2
19376,19376,,3,0,1,1
19377,19377,,8,0,1,1
19378,19378,,8,2,1,3
19379,19379,,43,7,0,7
19380,19380,,23,0,1,1
19381,19381,,197,0,1,1
19382,19382,,197,1,0,1
19383,19383,,0,2,2,4
19384,19384,,14,0,1,1
19385,19385,,23,0,2,2
19386,19386,,8,1,2,3
19387,19387,,0,1,0,1
19388,19388,,23,1,0,1
19389,19389,,21,2,1,3
19390,19390,,21,0,1,1
19391,19391,,8,1,0,1
19392,19392,,14,1,0,1
19393,19393,,21,1,0,1
19394,19394,,43,1,0,1
19395,19395,,14,0,2,2
19396,19396,,105,1,1,2
19397,19397,,3,2,2,4
19398,19398,,3,1,1,2
19399,19399,,52,1,1,2
19400,19400,,43,2,0,2
19401,19401,,23,1,1,2
19402,19402,,127,0,1,1
19403,19403,,198,1,2,3
19404,19404,,198,1,1,2
19405,19405,,198,1,0,1
19406,19406,,31,1,0,1
19407,19407,,14,1,0,1
19408,19408,,23,0,1,1
19409,19409,,8,1,0,1
19410,19410,,8,0,3,3
19411,19411,,23,1,0,1
19412,19412,,23,0,1,1
19413,19413,,8,1,0,1
19414,19414,,0,3,0,3
19415,19415,,127,1,3,4
19416,19416,,8,1,0,1
19417,19417,,23,0,1,1
19418,19418,,8,1,0,1
19419,19419,,15,0,1,1
19420,19420,,15,1,1,2
19421,19421,,23,0,1,1
19422,19422,,111,0,1,1
19423,19423,,0,2,2,4
19424,19424,,127,1,1,2
19425,19425,,23,0,1,1
19426,19426,,21,2,0,2
19427,19427,,43,0,1,1
19428,19428,,43,0,1,1
19429,19429,,8,0,3,3
19430,19430,,21,1,0,1
19431,19431,,24,0,1,1
19432,19432,,21,1,0,1
19433,19433,,21,1,0,1
19434,19434,,3,0,1,1
19435,19435,,0,1,0,1
19436,19436,,88,1,2,3
19437,19437,,23,0,1,1
19438,19438,,127,0,1,1
19439,19439,,11,1,0,1
19440,19440,,11,1,0,1
19441,19441,,105,0,1,1
19442,19442,,127,0,2,2
19443,19443,,120,4,1,5
19444,19444,,111,1,4,5
19445,19445,,8,2,0,2
19446,19446,,0,1,2,3
19447,19447,,199,1,1,2
19448,19448,,199,1,1,2
19449,19449,,8,0,1,1
19450,19450,,23,0,1,1
19451,19451,,24,0,1,1
19452,19452,,45,2,1,3
19453,19453,,0,0,1,1
19454,19454,,14,1,0,1
19455,19455,,52,1,0,1
19456,19456,,31,0,1,1
19457,19457,,23,0,1,1
19458,19458,,23,1,0,1
19459,19459,,23,2,1,3
19460,19460,,6,0,1,1
19461,19461,,52,2,0,2
19462,19462,,8,1,1,2
19463,19463,,92,2,0,2
19464,19464,,127,0,1,1
19465,19465,,23,0,1,1
19466,19466,,8,0,2,2
19467,19467,,23,8,5,13
19468,19468,,23,1,3,4
19469,19469,,23,1,1,2
19470,19470,,105,5,8,13
19471,19471,,3,0,1,1
19472,19472,,21,1,0,1
19473,19473,,127,2,0,2
19474,19474,,21,1,2,3
19475,19475,,127,1,0,1
19476,19476,,3,1,1,2
19477,19477,,3,0,1,1
19478,19478,,23,4,1,5
19479,19479,,31,1,0,1
19480,19480,,23,1,2,3
19481,19481,,8,0,1,1
19482,19482,,111,1,0,1
19483,19483,,52,0,1,1
19484,19484,,11,1,2,3
19485,19485,,14,1,0,1
19486,19486,,8,0,1,1
19487,19487,,8,1,1,2
19488,19488,,8,8,15,23
19489,19489,,14,1,0,1
19490,19490,,3,0,1,1
19491,19491,,76,0,1,1
19492,19492,,8,2,3,5
19493,19493,,127,1,2,3
19494,19494,,5,1,0,1
19495,19495,,8,1,0,1
19496,19496,,3,0,1,1
19497,19497,,8,0,1,1
19498,19498,,105,3,0,3
19499,19499,,6,4,3,7
19500,19500,,127,0,1,1
19501,19501,,23,0,1,1
19502,19502,,23,0,1,1
19503,19503,,18,2,1,3
19504,19504,,23,1,0,1
19505,19505,,43,1,0,1
19506,19506,,52,1,0,1
19507,19507,,23,1,1,2
19508,19508,,8,2,0,2
19509,19509,,15,0,1,1
19510,19510,,21,4,2,6
19511,19511,,21,2,2,4
19512,19512,,43,0,1,1
19513,19513,,21,1,0,1
19514,19514,,45,0,2,2
19515,19515,,11,1,0,1
19516,19516,,31,1,3,4
19517,19517,,88,0,1,1
19518,19518,,0,0,2,2
19519,19519,,23,0,1,1
19520,19520,,3,0,1,1
19521,19521,,5,2,0,2
19522,19522,,23,0,1,1
19523,19523,,21,0,1,1
19524,19524,,105,0,1,1
19525,19525,,111,1,0,1
19526,19526,,8,1,3,4
19527,19527,,8,1,0,1
19528,19528,,31,1,0,1
19529,19529,,8,0,1,1
19530,19530,,31,2,6,8
19531,19531,,45,0,1,1
19532,19532,,3,0,1,1
19533,19533,,200,0,1,1
19534,19534,,200,1,0,1
19535,19535,,111,1,0,1
19536,19536,,76,2,2,4
19537,19537,,23,2,3,5
19538,19538,,31,1,1,2
19539,19539,,21,1,1,2
19540,19540,,11,0,1,1
19541,19541,,21,3,0,3
19542,19542,,111,2,0,2
19543,19543,,43,1,0,1
19544,19544,,8,1,0,1
19545,19545,,0,0,1,1
19546,19546,,43,1,0,1
19547,19547,,111,0,2,2
19548,19548,,23,0,1,1
19549,19549,,23,0,2,2
19550,19550,,23,1,1,2
19551,19551,,23,3,4,7
19552,19552,,127,0,1,1
19553,19553,,21,0,2,2
19554,19554,,8,1,0,1
19555,19555,,43,1,1,2
19556,19556,,0,1,1,2
19557,19557,,3,0,1,1
19558,19558,,21,2,0,2
19559,19559,,21,0,2,2
19560,19560,,18,0,1,1
19561,19561,,111,3,0,3
19562,19562,,127,0,1,1
19563,19563,,88,0,1,1
19564,19564,,0,1,0,1
19565,19565,,52,0,1,1
19566,19566,,43,1,0,1
19567,19567,,8,3,1,4
19568,19568,,111,1,0,1
19569,19569,,31,1,0,1
19570,19570,,43,1,0,1
19571,19571,,8,1,0,1
19572,19572,,23,0,1,1
19573,19573,,127,1,2,3
19574,19574,,43,0,1,1
19575,19575,,111,1,1,2
19576,19576,,8,0,1,1
19577,19577,,201,0,1,1
19578,19578,,201,1,0,1
19579,19579,,3,1,1,2
19580,19580,,111,0,1,1
19581,19581,,24,1,1,2
19582,19582,,111,2,0,2
19583,19583,,3,1,0,1
19584,19584,,76,1,2,3
19585,19585,,45,0,1,1
19586,19586,,45,0,1,1
19587,19587,,127,1,0,1
19588,19588,,23,1,1,2
19589,19589,,127,0,1,1
19590,19590,,202,0,1,1
19591,19591,,202,1,0,1
19592,19592,,8,1,0,1
19593,19593,,21,0,1,1
19594,19594,,23,0,2,2
19595,19595,,66,0,1,1
19596,19596,,21,0,2,2
19597,19597,,5,2,2,4
19598,19598,,23,0,1,1
19599,19599,,76,1,1,2
19600,19600,,203,1,1,2
19601,19601,,203,1,1,2
19602,19602,,43,0,1,1
19603,19603,,23,0,1,1
19604,19604,,43,0,1,1
19605,19605,,127,0,2,2
19606,19606,,0,1,0,1
19607,19607,,21,0,1,1
19608,19608,,23,1,0,1
19609,19609,,14,1,1,2
19610,19610,,23,0,1,1
19611,19611,,23,1,0,1
19612,19612,,23,0,1,1
19613,19613,,23,0,1,1
19614,19614,,127,0,1,1
19615,19615,,127,0,1,1
19616,19616,,3,0,1,1
19617,19617,,23,0,1,1
19618,19618,,23,0,1,1
19619,19619,,127,1,1,2
19620,19620,,43,1,4,5
19621,19621,,76,0,3,3
19622,19622,,52,2,4,6
19623,19623,,43,0,1,1
19624,19624,,52,1,0,1
19625,19625,,76,0,1,1
19626,19626,,8,2,0,2
19627,19627,,14,0,1,1
19628,19628,,14,1,1,2
19629,19629,,0,0,1,1
19630,19630,,105,0,1,1
19631,19631,,23,0,3,3
19632,19632,,127,2,0,2
19633,19633,,31,1,0,1
19634,19634,,105,1,3,4
19635,19635,,204,0,1,1
19636,19636,,204,1,0,1
19637,19637,,52,1,0,1
19638,19638,,23,1,1,2
19639,19639,,43,1,0,1
19640,19640,,23,1,1,2
19641,19641,,43,0,1,1
19642,19642,,21,1,0,1
19643,19643,,3,0,1,1
19644,19644,,3,2,1,3
19645,19645,,3,1,1,2
19646,19646,,52,0,1,1
19647,19647,,23,1,1,2
19648,19648,,127,0,1,1
19649,19649,,31,1,0,1
19650,19650,,23,1,0,1
19651,19651,,23,0,2,2
19652,19652,,105,0,1,1
19653,19653,,23,0,1,1
19654,19654,,45,0,1,1
19655,19655,,111,1,0,1
19656,19656,,14,0,1,1
19657,19657,,23,2,0,2
19658,19658,,24,1,0,1
19659,19659,,111,0,1,1
19660,19660,,111,2,0,2
19661,19661,,15,3,0,3
19662,19662,,11,0,1,1
19663,19663,,127,0,1,1
19664,19664,,127,0,1,1
19665,19665,,111,2,3,5
19666,19666,,23,2,2,4
19667,19667,,15,3,3,6
19668,19668,,31,1,0,1
19669,19669,,45,0,1,1
19670,19670,,111,1,1,2
19671,19671,,0,1,0,1
19672,19672,,127,0,1,1
19673,19673,,23,1,1,2
19674,19674,,8,1,1,2
19675,19675,,205,0,1,1
19676,19676,,205,1,0,1
19677,19677,,206,0,1,1
19678,19678,,206,1,0,1
19679,19679,,76,2,0,2
19680,19680,,23,1,0,1
19681,19681,,14,0,1,1
19682,19682,,23,0,1,1
19683,19683,,23,0,1,1
19684,19684,,43,0,2,2
19685,19685,,43,0,1,1
19686,19686,,3,2,2,4
19687,19687,,23,0,1,1
19688,19688,,14,0,1,1
19689,19689,,45,3,0,3
19690,19690,,120,1,0,1
19691,19691,,8,1,1,2
19692,19692,,23,1,0,1
19693,19693,,21,2,0,2
19694,19694,,76,0,1,1
19695,19695,,76,0,1,1
19696,19696,,23,0,1,1
19697,19697,,18,1,1,2
19698,19698,,31,2,1,3
19699,19699,,127,1,1,2
19700,19700,,3,0,1,1
19701,19701,,127,11,5,16
19702,19702,,31,1,1,2
19703,19703,,3,0,1,1
19704,19704,,52,1,0,1
19705,19705,,31,0,1,1
19706,19706,,31,0,1,1
19707,19707,,88,0,1,1
19708,19708,,43,1,1,2
19709,19709,,21,0,1,1
19710,19710,,14,0,2,2
19711,19711,,8,1,3,4
19712,19712,,127,0,1,1
19713,19713,,15,0,1,1
19714,19714,,31,0,1,1
19715,19715,,8,0,1,1
19716,19716,,8,0,1,1
19717,19717,,14,2,2,4
19718,19718,,23,2,0,2
19719,19719,,23,1,1,2
19720,19720,,127,0,1,1
19721,19721,,79,1,0,1
19722,19722,,6,1,1,2
19723,19723,,52,2,0,2
19724,19724,,24,1,1,2
19725,19725,,23,1,1,2
19726,19726,,23,4,0,4
19727,19727,,11,0,1,1
19728,19728,,21,1,1,2
19729,19729,,23,1,1,2
19730,19730,,14,1,0,1
19731,19731,,43,0,1,1
19732,19732,,14,1,1,2
19733,19733,,3,6,0,6
19734,19734,,3,1,0,1
19735,19735,,23,0,4,4
19736,19736,,23,1,0,1
19737,19737,,23,0,1,1
19738,19738,,88,0,1,1
19739,19739,,127,2,0,2
19740,19740,,43,1,1,2
19741,19741,,3,2,0,2
19742,19742,,120,0,3,3
19743,19743,,23,0,1,1
19744,19744,,105,2,7,9
19745,19745,,105,7,7,14
19746,19746,,76,3,1,4
19747,19747,,21,2,0,2
19748,19748,,52,1,0,1
19749,19749,,23,0,1,1
19750,19750,,23,0,1,1
19751,19751,,8,1,2,3
19752,19752,,207,0,1,1
19753,19753,,207,1,0,1
19754,19754,,15,0,2,2
19755,19755,,23,0,1,1
19756,19756,,3,1,0,1
19757,19757,,15,3,3,6
19758,19758,,23,0,1,1
19759,19759,,21,0,1,1
19760,19760,,18,0,2,2
19761,19761,,18,1,0,1
19762,19762,,208,0,1,1
19763,19763,,208,1,0,1
19764,19764,,111,0,1,1
19765,19765,,105,0,7,7
19766,19766,,88,0,2,2
19767,19767,,23,1,0,1
19768,19768,,23,0,1,1
19769,19769,,127,0,1,1
19770,19770,,52,0,1,1
19771,19771,,21,0,3,3
19772,19772,,11,0,1,1
19773,19773,,23,1,0,1
19774,19774,,23,2,1,3
19775,19775,,23,1,0,1
19776,19776,,23,0,1,1
19777,19777,,23,1,2,3
19778,19778,,15,0,1,1
19779,19779,,14,1,1,2
19780,19780,,66,0,1,1
19781,19781,,21,0,1,1
19782,19782,,23,0,1,1
19783,19783,,43,0,1,1
19784,19784,,11,1,0,1
19785,19785,,23,0,1,1
19786,19786,,127,1,1,2
19787,19787,,127,0,2,2
19788,19788,,31,0,1,1
19789,19789,,3,0,2,2
19790,19790,,23,0,2,2
19791,19791,,23,0,1,1
19792,19792,,0,1,0,1
19793,19793,,52,1,0,1
19794,19794,,127,1,0,1
19795,19795,,23,1,1,2
19796,19796,,43,1,1,2
19797,19797,,96,1,0,1
19798,19798,,43,0,1,1
19799,19799,,5,10,8,18
19800,19800,,6,1,1,2
19801,19801,,21,1,1,2
19802,19802,,15,1,0,1
19803,19803,,8,0,1,1
19804,19804,,23,0,1,1
19805,19805,,23,0,1,1
19806,19806,,11,2,1,3
19807,19807,,3,2,4,6
19808,19808,,0,1,0,1
19809,19809,,209,0,2,2
19810,19810,,209,2,0,2
19811,19811,,45,1,1,2
19812,19812,,45,0,1,1
19813,19813,,3,0,4,4
19814,19814,,52,1,2,3
19815,19815,,24,1,0,1
19816,19816,,8,1,0,1
19817,19817,,15,1,3,4
19818,19818,,15,2,0,2
19819,19819,,15,1,0,1
19820,19820,,8,1,0,1
19821,19821,,23,1,1,2
19822,19822,,66,0,1,1
19823,19823,,8,1,0,1
19824,19824,,210,1,1,2
19825,19825,,210,1,1,2
19826,19826,,31,0,2,2
19827,19827,,23,3,0,3
19828,19828,,43,1,1,2
19829,19829,,8,0,2,2
19830,19830,,8,1,0,1
19831,19831,,211,0,1,1
19832,19832,,211,1,0,1
19833,19833,,120,2,9,11
19834,19834,,23,1,0,1
19835,19835,,23,1,0,1
19836,19836,,5,0,1,1
19837,19837,,43,1,0,1
19838,19838,,0,2,0,2
19839,19839,,88,2,0,2
19840,19840,,5,0,2,2
19841,19841,,21,1,0,1
19842,19842,,31,2,2,4
19843,19843,,14,0,1,1
19844,19844,,14,0,1,1
19845,19845,,14,3,0,3
19846,19846,,5,0,3,3
19847,19847,,88,1,0,1
19848,19848,,43,0,1,1
19849,19849,,43,0,1,1
19850,19850,,212,0,1,1
19851,19851,,212,1,0,1
19852,19852,,21,0,1,1
19853,19853,,15,1,1,2
19854,19854,,5,1,0,1
19855,19855,,0,2,2,4
19856,19856,,21,1,1,2
19857,19857,,23,4,6,10
19858,19858,,76,0,1,1
19859,19859,,0,0,1,1
19860,19860,,23,0,1,1
19861,19861,,0,1,1,2
19862,19862,,14,3,1,4
19863,19863,,8,1,0,1
19864,19864,,23,1,2,3
19865,19865,,111,1,1,2
19866,19866,,31,1,1,2
19867,19867,,43,0,1,1
19868,19868,,23,0,1,1
19869,19869,,31,0,1,1
19870,19870,,111,1,0,1
19871,19871,,23,0,1,1
19872,19872,,3,1,1,2
19873,19873,,23,2,0,2
19874,19874,,23,0,2,2
19875,19875,,120,0,1,1
19876,19876,,23,1,1,2
19877,19877,,23,1,1,2
19878,19878,,14,1,0,1
19879,19879,,52,1,1,2
19880,19880,,0,4,0,4
19881,19881,,23,1,1,2
19882,19882,,14,1,0,1
19883,19883,,23,5,0,5
19884,19884,,23,1,0,1
19885,19885,,45,1,0,1
19886,19886,,45,1,0,1
19887,19887,,127,1,0,1
19888,19888,,0,0,4,4
19889,19889,,23,0,1,1
19890,19890,,15,1,0,1
19891,19891,,23,1,3,4
19892,19892,,0,1,1,2
19893,19893,,23,0,1,1
19894,19894,,11,1,0,1
19895,19895,,31,0,1,1
19896,19896,,21,1,0,1
19897,19897,,43,1,2,3
19898,19898,,23,0,1,1
19899,19899,,105,2,0,2
19900,19900,,8,0,2,2
19901,19901,,24,2,0,2
19902,19902,,8,0,1,1
19903,19903,,8,2,3,5
19904,19904,,23,1,1,2
19905,19905,,3,7,9,16
19906,19906,,52,1,1,2
19907,19907,,111,1,0,1
19908,19908,,43,1,0,1
19909,19909,,111,0,3,3
19910,19910,,105,1,0,1
19911,19911,,43,1,0,1
19912,19912,,3,1,0,1
19913,19913,,213,0,1,1
19914,19914,,213,1,0,1
19915,19915,,214,0,1,1
19916,19916,,214,1,0,1
19917,19917,,76,1,0,1
19918,19918,,21,1,0,1
19919,19919,,31,1,0,1
19920,19920,,105,3,0,3
19921,19921,,127,0,3,3
19922,19922,,31,1,0,1
19923,19923,,23,1,0,1
19924,19924,,111,1,2,3
19925,19925,,111,1,1,2
19926,19926,,11,1,0,1
19927,19927,,8,1,1,2
19928,19928,,111,0,2,2
19929,19929,,23,1,1,2
19930,19930,,23,0,1,1
19931,19931,,11,1,1,2
19932,19932,,8,0,1,1
19933,19933,,23,0,1,1
19934,19934,,31,0,1,1
19935,19935,,8,0,2,2
19936,19936,,31,0,1,1
19937,19937,,76,0,1,1
19938,19938,,127,1,0,1
19939,19939,,66,1,2,3
19940,19940,,0,1,0,1
19941,19941,,14,1,1,2
19942,19942,,23,0,1,1
19943,19943,,5,0,2,2
19944,19944,,0,0,1,1
19945,19945,,18,0,1,1
19946,19946,,8,0,1,1
19947,19947,,6,1,0,1
19948,19948,,52,1,0,1
19949,19949,,127,0,1,1
19950,19950,,0,0,2,2
19951,19951,,43,1,0,1
19952,19952,,43,1,1,2
19953,19953,,14,1,0,1
19954,19954,,21,0,1,1
19955,19955,,88,1,0,1
19956,19956,,66,0,2,2
19957,19957,,66,1,0,1
19958,19958,,66,2,2,4
19959,19959,,8,0,1,1
19960,19960,,8,2,1,3
19961,19961,,21,1,0,1
19962,19962,,3,0,1,1
19963,19963,,3,1,0,1
19964,19964,,23,0,1,1
19965,19965,,23,1,1,2
19966,19966,,15,1,1,2
19967,19967,,111,0,2,2
19968,19968,,8,1,0,1
19969,19969,,23,0,1,1
19970,19970,,23,0,1,1
19971,19971,,21,1,0,1
19972,19972,,15,1,0,1
19973,19973,,23,0,1,1
19974,19974,,15,1,0,1
19975,19975,,23,1,1,2
19976,19976,,31,1,0,1
19977,19977,,8,1,0,1
19978,19978,,111,1,0,1
19979,19979,,127,1,1,2
19980,19980,,127,0,1,1
19981,19981,,31,0,1,1
19982,19982,,76,0,1,1
19983,19983,,76,1,3,4
19984,19984,,215,1,2,3
19985,19985,,215,1,0,1
19986,19986,,215,1,1,2
19987,19987,,23,0,3,3
19988,19988,,43,1,0,1
19989,19989,,23,1,0,1
19990,19990,,216,0,1,1
19991,19991,,216,1,0,1
19992,19992,,23,0,1,1
19993,19993,,21,0,1,1
19994,19994,,8,0,1,1
19995,19995,,23,1,0,1
19996,19996,,0,1,1,2
19997,19997,,11,2,6,8
19998,19998,,105,1,1,2
19999,19999,,52,1,1,2
20000,20000,,5,1,0,1
20001,20001,,43,0,2,2
20002,20002,,127,3,1,4
20003,20003,,23,0,1,1
20004,20004,,127,1,0,1
20005,20005,,23,1,1,2
20006,20006,,0,1,1,2
20007,20007,,8,0,1,1
20008,20008,,3,1,0,1
20009,20009,,14,1,1,2
20010,20010,,127,0,1,1
20011,20011,,31,0,2,2
20012,20012,,23,1,0,1
20013,20013,,88,0,1,1
20014,20014,,31,0,3,3
20015,20015,,23,1,0,1
20016,20016,,23,1,1,2
20017,20017,,8,0,1,1
20018,20018,,0,0,1,1
20019,20019,,217,0,1,1
20020,20020,,217,1,0,1
20021,20021,,8,0,1,1
20022,20022,,15,1,0,1
20023,20023,,15,0,1,1
20024,20024,,18,1,0,1
20025,20025,,14,1,0,1
20026,20026,,88,2,0,2
20027,20027,,127,2,5,7
20028,20028,,11,0,1,1
20029,20029,,23,1,7,8
20030,20030,,23,1,0,1
20031,20031,,23,1,0,1
20032,20032,,45,3,0,3
20033,20033,,23,4,1,5
20034,20034,,8,0,5,5
20035,20035,,8,11,10,21
20036,20036,,8,0,1,1
20037,20037,,14,0,1,1
20038,20038,,3,0,1,1
20039,20039,,0,1,1,2
20040,20040,,21,0,1,1
20041,20041,,23,1,2,3
20042,20042,,127,1,0,1
20043,20043,,120,1,0,1
20044,20044,,23,1,1,2
20045,20045,,85,1,0,1
20046,20046,,0,0,1,1
20047,20047,,21,0,1,1
20048,20048,,14,0,1,1
20049,20049,,31,1,1,2
20050,20050,,23,0,1,1
20051,20051,,23,0,1,1
20052,20052,,23,0,1,1
20053,20053,,18,1,1,2
20054,20054,,23,0,1,1
20055,20055,,14,1,1,2
20056,20056,,218,0,1,1
20057,20057,,218,1,0,1
20058,20058,,14,1,1,2
20059,20059,,8,2,0,2
20060,20060,,88,0,1,1
20061,20061,,14,0,3,3
20062,20062,,0,1,0,1
20063,20063,,43,2,0,2
20064,20064,,23,3,3,6
20065,20065,,11,1,0,1
20066,20066,,105,0,1,1
20067,20067,,23,0,1,1
20068,20068,,15,0,1,1
20069,20069,,8,0,1,1
20070,20070,,23,1,0,1
20071,20071,,23,1,0,1
20072,20072,,76,1,3,4
20073,20073,,23,0,2,2
20074,20074,,14,1,0,1
20075,20075,,8,3,0,3
20076,20076,,23,1,0,1
20077,20077,,127,0,1,1
20078,20078,,23,0,1,1
20079,20079,,8,1,0,1
20080,20080,,15,1,0,1
20081,20081,,127,0,1,1
20082,20082,,11,0,1,1
20083,20083,,43,1,0,1
20084,20084,,15,0,1,1
20085,20085,,105,2,0,2
20086,20086,,11,0,1,1
20087,20087,,127,0,1,1
20088,20088,,52,0,2,2
20089,20089,,8,0,1,1
20090,20090,,23,2,0,2
20091,20091,,23,0,1,1
20092,20092,,0,0,2,2
20093,20093,,52,1,0,1
20094,20094,,111,1,0,1
20095,20095,,127,1,0,1
20096,20096,,15,1,0,1
20097,20097,,127,2,1,3
20098,20098,,8,0,1,1
20099,20099,,127,1,0,1
20100,20100,,105,2,0,2
20101,20101,,127,1,1,2
20102,20102,,127,0,2,2
20103,20103,,14,0,1,1
20104,20104,,8,1,2,3
20105,20105,,8,1,0,1
20106,20106,,76,0,1,1
20107,20107,,23,1,1,2
20108,20108,,52,1,0,1
20109,20109,,11,1,0,1
20110,20110,,15,1,0,1
20111,20111,,45,1,0,1
20112,20112,,8,1,1,2
20113,20113,,127,0,1,1
20114,20114,,105,1,0,1
20115,20115,,23,0,1,1
20116,20116,,105,0,2,2
20117,20117,,52,0,1,1
20118,20118,,8,2,2,4
20119,20119,,0,1,1,2
20120,20120,,43,0,1,1
20121,20121,,127,0,1,1
20122,20122,,88,2,2,4
20123,20123,,14,1,0,1
20124,20124,,21,2,2,4
20125,20125,,21,2,3,5
20126,20126,,18,0,1,1
20127,20127,,66,0,3,3
20128,20128,,66,1,0,1
20129,20129,,3,0,1,1
20130,20130,,14,0,1,1
20131,20131,,23,0,1,1
20132,20132,,11,1,1,2
20133,20133,,23,1,2,3
20134,20134,,15,0,1,1
20135,20135,,111,1,1,2
20136,20136,,219,0,1,1
20137,20137,,219,1,0,1
20138,20138,,3,0,1,1
20139,20139,,45,1,0,1
20140,20140,,8,1,1,2
20141,20141,,23,0,1,1
20142,20142,,23,0,1,1
20143,20143,,23,2,1,3
20144,20144,,43,1,0,1
20145,20145,,11,0,1,1
20146,20146,,23,0,1,1
20147,20147,,66,2,0,2
20148,20148,,43,0,1,1
20149,20149,,8,0,2,2
20150,20150,,11,2,0,2
20151,20151,,8,1,0,1
20152,20152,,127,0,1,1
20153,20153,,127,0,1,1
20154,20154,,43,0,1,1
20155,20155,,3,0,2,2
20156,20156,,3,1,0,1
20157,20157,,23,1,0,1
20158,20158,,23,0,1,1
20159,20159,,105,0,1,1
20160,20160,,18,1,0,1
20161,20161,,76,4,0,4
20162,20162,,23,0,1,1
20163,20163,,8,0,1,1
20164,20164,,76,1,2,3
20165,20165,,52,1,0,1
20166,20166,,66,0,1,1
20167,20167,,8,1,0,1
20168,20168,,43,0,1,1
20169,20169,,43,0,1,1
20170,20170,,14,2,2,4
20171,20171,,14,2,1,3
20172,20172,,8,1,1,2
20173,20173,,14,1,0,1
20174,20174,,0,2,0,2
20175,20175,,21,1,0,1
20176,20176,,3,0,1,1
20177,20177,,3,0,1,1
20178,20178,,14,1,0,1
20179,20179,,111,0,1,1
20180,20180,,8,0,3,3
20181,20181,,24,2,0,2
20182,20182,,23,2,2,4
20183,20183,,220,0,1,1
20184,20184,,220,1,0,1
20185,20185,,15,1,0,1
20186,20186,,31,0,2,2
20187,20187,,23,2,5,7
20188,20188,,23,1,1,2
20189,20189,,14,0,1,1
20190,20190,,111,3,1,4
20191,20191,,31,0,1,1
20192,20192,,111,0,1,1
20193,20193,,23,1,1,2
20194,20194,,3,1,0,1
20195,20195,,23,0,1,1
20196,20196,,111,1,0,1
20197,20197,,8,0,1,1
20198,20198,,23,0,1,1
20199,20199,,15,2,2,4
20200,20200,,23,0,1,1
20201,20201,,23,1,1,2
20202,20202,,23,6,0,6
20203,20203,,11,1,0,1
20204,20204,,52,1,3,4
20205,20205,,11,1,0,1
20206,20206,,8,1,0,1
20207,20207,,8,0,2,2
20208,20208,,43,0,1,1
20209,20209,,21,2,3,5
20210,20210,,23,1,1,2
20211,20211,,14,2,0,2
20212,20212,,66,1,0,1
20213,20213,,21,1,0,1
20214,20214,,3,0,1,1
20215,20215,,0,1,1,2
20216,20216,,0,0,1,1
20217,20217,,3,1,0,1
20218,20218,,23,0,3,3
20219,20219,,3,1,0,1
20220,20220,,14,1,0,1
20221,20221,,23,0,1,1
20222,20222,,221,0,1,1
20223,20223,,221,1,0,1
20224,20224,,23,0,1,1
20225,20225,,24,0,1,1
20226,20226,,23,0,1,1
20227,20227,,23,0,2,2
20228,20228,,23,1,0,1
20229,20229,,127,0,1,1
20230,20230,,45,1,0,1
20231,20231,,11,0,1,1
20232,20232,,23,0,2,2
20233,20233,,222,0,1,1
20234,20234,,222,1,1,2
20235,20235,,31,1,0,1
20236,20236,,23,0,1,1
20237,20237,,8,0,1,1
20238,20238,,31,0,1,1
20239,20239,,23,0,1,1
20240,20240,,23,0,2,2
20241,20241,,8,1,0,1
20242,20242,,23,0,1,1
20243,20243,,15,0,6,6
20244,20244,,15,1,0,1
20245,20245,,23,0,3,3
20246,20246,,23,2,0,2
20247,20247,,21,0,1,1
20248,20248,,8,1,0,1
20249,20249,,127,2,0,2
20250,20250,,3,1,0,1
20251,20251,,21,0,1,1
20252,20252,,23,0,1,1
20253,20253,,0,0,2,2
20254,20254,,3,0,1,1
20255,20255,,223,1,1,2
20256,20256,,223,1,1,2
20257,20257,,0,1,1,2
20258,20258,,21,1,0,1
20259,20259,,127,0,1,1
20260,20260,,23,0,1,1
20261,20261,,120,2,3,5
20262,20262,,0,1,0,1
20263,20263,,23,2,0,2
20264,20264,,8,0,1,1
20265,20265,,0,0,1,1
20266,20266,,31,1,0,1
20267,20267,,31,1,1,2
20268,20268,,14,1,0,1
20269,20269,,127,1,1,2
20270,20270,,21,1,2,3
20271,20271,,8,0,1,1
20272,20272,,88,0,2,2
20273,20273,,88,1,0,1
20274,20274,,14,0,1,1
20275,20275,,18,0,1,1
20276,20276,,15,0,1,1
20277,20277,,127,0,1,1
20278,20278,,23,1,0,1
20279,20279,,14,1,0,1
20280,20280,,23,1,1,2
20281,20281,,23,0,1,1
20282,20282,,120,2,0,2
20283,20283,,52,0,1,1
20284,20284,,43,1,0,1
20285,20285,,8,1,0,1
20286,20286,,23,1,0,1
20287,20287,,8,2,1,3
20288,20288,,3,1,1,2
20289,20289,,23,1,0,1
20290,20290,,8,1,0,1
20291,20291,,8,1,1,2
20292,20292,,14,0,1,1
20293,20293,,21,1,0,1
20294,20294,,11,2,3,5
20295,20295,,21,1,0,1
20296,20296,,23,0,1,1
20297,20297,,0,1,0,1
20298,20298,,5,3,20,23
20299,20299,,127,3,4,7
20300,20300,,43,0,1,1
20301,20301,,23,2,3,5
20302,20302,,76,1,1,2
20303,20303,,43,0,1,1
20304,20304,,8,0,2,2
20305,20305,,8,1,0,1
20306,20306,,15,1,0,1
20307,20307,,23,0,1,1
20308,20308,,23,0,1,1
20309,20309,,224,0,1,1
20310,20310,,224,1,0,1
20311,20311,,23,1,0,1
20312,20312,,111,3,0,3
20313,20313,,8,1,1,2
20314,20314,,8,0,1,1
20315,20315,,8,1,0,1
20316,20316,,225,1,1,2
20317,20317,,225,1,1,2
20318,20318,,23,1,1,2
20319,20319,,15,1,1,2
20320,20320,,127,3,2,5
20321,20321,,127,0,2,2
20322,20322,,31,0,1,1
20323,20323,,11,0,1,1
20324,20324,,45,1,0,1
20325,20325,,0,3,3,6
20326,20326,,14,0,2,2
20327,20327,,24,1,0,1
20328,20328,,23,0,1,1
20329,20329,,8,0,1,1
20330,20330,,15,1,0,1
20331,20331,,52,1,1,2
20332,20332,,66,1,0,1
20333,20333,,23,0,2,2
20334,20334,,23,1,0,1
20335,20335,,14,1,0,1
20336,20336,,111,0,1,1
20337,20337,,127,1,0,1
20338,20338,,5,0,2,2
20339,20339,,43,0,1,1
20340,20340,,3,0,4,4
20341,20341,,8,0,1,1
20342,20342,,0,2,0,2
20343,20343,,18,0,1,1
20344,20344,,23,1,0,1
20345,20345,,0,1,1,2
20346,20346,,111,0,2,2
20347,20347,,15,1,0,1
20348,20348,,111,1,0,1
20349,20349,,8,1,1,2
20350,20350,,8,3,0,3
20351,20351,,43,0,1,1
20352,20352,,226,0,1,1
20353,20353,,226,1,0,1
20354,20354,,8,0,1,1
20355,20355,,3,1,2,3
20356,20356,,8,0,1,1
20357,20357,,45,2,1,3
20358,20358,,14,1,0,1
20359,20359,,23,0,1,1
20360,20360,,111,0,1,1
20361,20361,,227,0,1,1
20362,20362,,227,1,0,1
20363,20363,,127,0,1,1
20364,20364,,23,1,0,1
20365,20365,,3,1,2,3
20366,20366,,15,0,1,1
20367,20367,,14,1,0,1
20368,20368,,8,0,1,1
20369,20369,,23,1,0,1
20370,20370,,23,0,2,2
20371,20371,,31,0,3,3
20372,20372,,23,1,0,1
20373,20373,,11,2,0,2
20374,20374,,228,1,1,2
20375,20375,,228,1,1,2
20376,20376,,11,1,1,2
20377,20377,,43,0,3,3
20378,20378,,43,1,2,3
20379,20379,,43,1,0,1
20380,20380,,43,1,1,2
20381,20381,,127,0,1,1
20382,20382,,0,1,0,1
20383,20383,,3,1,1,2
20384,20384,,76,0,1,1
20385,20385,,23,1,0,1
20386,20386,,31,0,1,1
20387,20387,,0,1,1,2
20388,20388,,14,1,0,1
20389,20389,,8,0,1,1
20390,20390,,23,0,1,1
20391,20391,,18,1,0,1
20392,20392,,23,1,0,1
20393,20393,,8,1,0,1
20394,20394,,8,1,0,1
20395,20395,,21,0,1,1
20396,20396,,43,0,1,1
20397,20397,,127,1,0,1
20398,20398,,21,0,1,1
20399,20399,,21,1,1,2
20400,20400,,105,1,0,1
20401,20401,,21,4,0,4
20402,20402,,45,0,1,1
20403,20403,,105,1,0,1
20404,20404,,76,2,1,3
20405,20405,,23,1,1,2
20406,20406,,43,1,1,2
20407,20407,,32,1,1,2
20408,20408,,23,1,0,1
20409,20409,,8,1,0,1
20410,20410,,21,1,0,1
20411,20411,,0,0,1,1
20412,20412,,43,0,1,1
20413,20413,,52,2,0,2
20414,20414,,14,2,1,3
20415,20415,,43,0,1,1
20416,20416,,11,0,1,1
20417,20417,,8,17,5,22
20418,20418,,11,1,0,1
20419,20419,,3,1,0,1
20420,20420,,105,2,1,3
20421,20421,,127,1,1,2
20422,20422,,111,0,1,1
20423,20423,,8,2,0,2
20424,20424,,45,0,1,1
20425,20425,,45,0,1,1
20426,20426,,8,0,1,1
20427,20427,,127,3,0,3
20428,20428,,23,1,0,1
20429,20429,,52,0,1,1
20430,20430,,21,1,0,1
20431,20431,,23,0,1,1
20432,20432,,88,1,0,1
20433,20433,,21,2,2,4
20434,20434,,6,2,0,2
20435,20435,,23,2,0,2
20436,20436,,3,0,1,1
20437,20437,,111,1,0,1
20438,20438,,8,1,2,3
20439,20439,,8,1,0,1
20440,20440,,5,0,2,2
20441,20441,,0,0,1,1
20442,20442,,43,1,0,1
20443,20443,,21,1,0,1
20444,20444,,23,1,0,1
20445,20445,,3,1,0,1
20446,20446,,120,1,0,1
20447,20447,,8,4,0,4
20448,20448,,8,1,0,1
20449,20449,,23,1,0,1
20450,20450,,23,0,1,1
20451,20451,,45,7,2,9
20452,20452,,3,0,1,1
20453,20453,,23,0,2,2
20454,20454,,8,1,0,1
20455,20455,,31,0,3,3
20456,20456,,0,1,0,1
20457,20457,,76,0,1,1
20458,20458,,23,1,0,1
20459,20459,,45,1,0,1
20460,20460,,8,2,0,2
20461,20461,,111,1,0,1
20462,20462,,45,2,0,2
20463,20463,,111,1,0,1
20464,20464,,21,0,1,1
20465,20465,,8,0,1,1
20466,20466,,24,1,0,1
20467,20467,,23,1,1,2
20468,20468,,14,1,1,2
20469,20469,,11,1,0,1
20470,20470,,8,0,1,1
20471,20471,,8,1,1,2
20472,20472,,23,1,0,1
20473,20473,,23,1,1,2
20474,20474,,15,2,1,3
20475,20475,,52,2,2,4
20476,20476,,127,2,1,3
20477,20477,,43,0,1,1
20478,20478,,23,0,1,1
20479,20479,,88,3,0,3
20480,20480,,66,0,2,2
20481,20481,,21,1,2,3
20482,20482,,229,0,1,1
20483,20483,,229,1,0,1
20484,20484,,3,0,2,2
20485,20485,,23,0,2,2
20486,20486,,23,0,1,1
20487,20487,,14,1,0,1
20488,20488,,120,1,0,1
20489,20489,,45,1,1,2
20490,20490,,43,3,0,3
20491,20491,,23,1,1,2
20492,20492,,8,1,0,1
20493,20493,,230,0,1,1
20494,20494,,230,1,0,1
20495,20495,,23,1,0,1
20496,20496,,43,0,1,1
20497,20497,,31,1,0,1
20498,20498,,31,0,1,1
20499,20499,,0,0,1,1
20500,20500,,8,1,0,1
20501,20501,,14,0,1,1
20502,20502,,11,0,1,1
20503,20503,,231,0,1,1
20504,20504,,231,1,0,1
20505,20505,,3,0,1,1
20506,20506,,23,2,0,2
20507,20507,,3,1,0,1
20508,20508,,66,1,0,1
20509,20509,,8,3,0,3
20510,20510,,0,0,1,1
20511,20511,,43,1,2,3
20512,20512,,15,11,1,12
20513,20513,,43,1,4,5
20514,20514,,23,0,1,1
20515,20515,,15,0,3,3
20516,20516,,21,0,1,1
20517,20517,,111,1,1,2
20518,20518,,88,0,1,1
20519,20519,,3,3,0,3
20520,20520,,45,1,0,1
20521,20521,,3,1,0,1
20522,20522,,15,0,1,1
20523,20523,,5,1,0,1
20524,20524,,23,1,0,1
20525,20525,,43,2,2,4
20526,20526,,21,1,0,1
20527,20527,,3,1,1,2
20528,20528,,21,1,1,2
20529,20529,,120,0,1,1
20530,20530,,23,0,1,1
20531,20531,,52,1,1,2
20532,20532,,0,2,0,2
20533,20533,,76,1,2,3
20534,20534,,8,1,0,1
20535,20535,,23,1,0,1
20536,20536,,8,1,0,1
20537,20537,,52,0,1,1
20538,20538,,8,1,0,1
20539,20539,,15,1,0,1
20540,20540,,43,0,2,2
20541,20541,,14,0,2,2
20542,20542,,23,1,1,2
20543,20543,,21,1,0,1
20544,20544,,45,1,0,1
20545,20545,,45,0,2,2
20546,20546,,31,0,1,1
20547,20547,,21,1,0,1
20548,20548,,8,1,0,1
20549,20549,,127,0,1,1
20550,20550,,36,0,1,1
20551,20551,,8,1,0,1
20552,20552,,18,1,0,1
20553,20553,,8,1,1,2
20554,20554,,43,2,2,4
20555,20555,,43,2,0,2
20556,20556,,3,0,1,1
20557,20557,,88,0,2,2
20558,20558,,23,0,1,1
20559,20559,,8,1,1,2
20560,20560,,45,2,2,4
20561,20561,,127,0,1,1
20562,20562,,127,2,1,3
20563,20563,,0,0,1,1
20564,20564,,52,0,1,1
20565,20565,,43,0,1,1
20566,20566,,14,1,0,1
20567,20567,,11,1,1,2
20568,20568,,111,4,0,4
20569,20569,,43,0,1,1
20570,20570,,21,1,0,1
20571,20571,,15,1,1,2
20572,20572,,8,1,0,1
20573,20573,,18,0,2,2
20574,20574,,18,3,0,3
20575,20575,,15,0,4,4
20576,20576,,23,0,3,3
20577,20577,,127,2,1,3
20578,20578,,76,1,0,1
20579,20579,,23,1,1,2
20580,20580,,11,1,0,1
20581,20581,,5,1,0,1
20582,20582,,15,1,1,2
20583,20583,,52,1,0,1
20584,20584,,8,1,0,1
20585,20585,,23,0,1,1
20586,20586,,15,1,0,1
20587,20587,,21,0,1,1
20588,20588,,23,1,0,1
20589,20589,,0,1,0,1
20590,20590,,66,0,2,2
20591,20591,,43,1,0,1
20592,20592,,76,0,1,1
20593,20593,,23,1,1,2
20594,20594,,21,1,0,1
20595,20595,,105,0,2,2
20596,20596,,27,1,0,1
20597,20597,,43,1,0,1
20598,20598,,23,0,1,1
20599,20599,,31,0,1,1
20600,20600,,8,2,0,2
20601,20601,,3,0,1,1
20602,20602,,3,0,1,1
20603,20603,,43,0,1,1
20604,20604,,8,6,4,10
20605,20605,,23,1,1,2
20606,20606,,43,0,1,1
20607,20607,,43,1,0,1
20608,20608,,43,1,1,2
20609,20609,,43,1,1,2
20610,20610,,23,2,0,2
20611,20611,,14,0,1,1
20612,20612,,8,1,0,1
20613,20613,,127,0,2,2
20614,20614,,43,1,1,2
20615,20615,,105,0,2,2
20616,20616,,23,0,1,1
20617,20617,,8,3,0,3
20618,20618,,43,0,1,1
20619,20619,,23,0,1,1
20620,20620,,23,1,0,1
20621,20621,,105,0,1,1
20622,20622,,31,2,0,2
20623,20623,,111,2,0,2
20624,20624,,4,1,0,1
20625,20625,,14,1,1,2
20626,20626,,23,1,0,1
20627,20627,,8,1,1,2
20628,20628,,43,1,0,1
20629,20629,,43,1,0,1
20630,20630,,3,1,0,1
20631,20631,,0,1,1,2
20632,20632,,127,0,1,1
20633,20633,,23,0,3,3
20634,20634,,23,1,0,1
20635,20635,,0,1,0,1
20636,20636,,8,3,0,3
20637,20637,,23,0,1,1
20638,20638,,52,1,0,1
20639,20639,,23,1,0,1
20640,20640,,8,1,0,1
20641,20641,,105,0,1,1
20642,20642,,18,1,0,1
20643,20643,,18,0,2,2
20644,20644,,6,2,3,5
20645,20645,,6,0,2,2
20646,20646,,127,0,1,1
20647,20647,,23,1,0,1
20648,20648,,8,1,1,2
20649,20649,,8,0,1,1
20650,20650,,23,0,1,1
20651,20651,,111,0,2,2
20652,20652,,5,0,1,1
20653,20653,,232,0,1,1
20654,20654,,232,1,0,1
20655,20655,,14,0,1,1
20656,20656,,23,1,0,1
20657,20657,,23,0,1,1
20658,20658,,76,1,2,3
20659,20659,,14,0,1,1
20660,20660,,23,1,0,1
20661,20661,,52,0,1,1
20662,20662,,23,2,0,2
20663,20663,,23,1,2,3
20664,20664,,222,1,0,1
20665,20665,,14,0,1,1
20666,20666,,18,0,1,1
20667,20667,,45,0,1,1
20668,20668,,45,1,0,1
20669,20669,,23,1,1,2
20670,20670,,45,1,0,1
20671,20671,,127,0,1,1
20672,20672,,105,1,0,1
20673,20673,,52,1,0,1
20674,20674,,23,0,2,2
20675,20675,,23,1,0,1
20676,20676,,21,0,2,2
20677,20677,,15,0,2,2
20678,20678,,21,1,0,1
20679,20679,,21,0,1,1
20680,20680,,5,0,2,2
20681,20681,,14,1,1,2
20682,20682,,11,1,0,1
20683,20683,,43,0,1,1
20684,20684,,23,0,1,1
20685,20685,,127,1,0,1
20686,20686,,21,0,1,1
20687,20687,,52,1,0,1
20688,20688,,21,0,1,1
20689,20689,,127,0,2,2
20690,20690,,23,0,1,1
20691,20691,,43,1,0,1
20692,20692,,8,1,1,2
20693,20693,,127,0,1,1
20694,20694,,8,1,0,1
20695,20695,,105,0,1,1
20696,20696,,21,1,0,1
20697,20697,,233,0,1,1
20698,20698,,233,1,0,1
20699,20699,,45,1,0,1
20700,20700,,52,2,0,2
20701,20701,,14,1,0,1
20702,20702,,23,3,0,3
20703,20703,,21,0,2,2
20704,20704,,23,0,1,1
20705,20705,,105,0,2,2
20706,20706,,23,1,1,2
20707,20707,,3,1,1,2
20708,20708,,23,1,3,4
20709,20709,,31,2,0,2
20710,20710,,23,1,0,1
20711,20711,,14,0,1,1
20712,20712,,23,0,1,1
20713,20713,,127,1,1,2
20714,20714,,11,0,1,1
20715,20715,,88,0,2,2
20716,20716,,4,1,0,1
20717,20717,,23,1,0,1
20718,20718,,23,1,0,1
20719,20719,,14,1,0,1
20720,20720,,23,0,1,1
20721,20721,,6,4,0,4
20722,20722,,23,1,1,2
20723,20723,,52,1,0,1
20724,20724,,23,1,1,2
20725,20725,,23,2,3,5
20726,20726,,111,1,1,2
20727,20727,,8,3,0,3
20728,20728,,3,0,1,1
20729,20729,,127,1,0,1
20730,20730,,3,0,1,1
20731,20731,,0,2,0,2
20732,20732,,8,0,1,1
20733,20733,,23,1,0,1
20734,20734,,45,0,1,1
20735,20735,,8,1,0,1
20736,20736,,88,2,0,2
20737,20737,,0,0,1,1
20738,20738,,3,0,1,1
20739,20739,,120,0,2,2
20740,20740,,21,1,1,2
20741,20741,,23,0,2,2
20742,20742,,3,0,1,1
20743,20743,,43,0,1,1
20744,20744,,23,1,0,1
20745,20745,,21,0,1,1
20746,20746,,43,0,1,1
20747,20747,,66,1,0,1
20748,20748,,23,1,1,2
20749,20749,,127,1,2,3
20750,20750,,23,1,0,1
20751,20751,,43,0,1,1
20752,20752,,76,1,0,1
20753,20753,,234,2,2,4
20754,20754,,234,2,2,4
20755,20755,,3,1,0,1
20756,20756,,111,1,1,2
20757,20757,,127,1,1,2
20758,20758,,76,2,1,3
20759,20759,,8,0,1,1
20760,20760,,14,0,1,1
20761,20761,,8,0,1,1
20762,20762,,43,1,1,2
20763,20763,,23,1,7,8
20764,20764,,18,1,1,2
20765,20765,,45,1,1,2
20766,20766,,23,0,1,1
20767,20767,,8,0,1,1
20768,20768,,23,1,0,1
20769,20769,,8,0,1,1
20770,20770,,127,0,1,1
20771,20771,,31,1,0,1
20772,20772,,8,1,1,2
20773,20773,,23,1,1,2
20774,20774,,43,0,1,1
20775,20775,,43,1,1,2
20776,20776,,8,0,1,1
20777,20777,,111,1,0,1
20778,20778,,23,1,1,2
20779,20779,,45,0,1,1
20780,20780,,23,1,1,2
20781,20781,,23,2,0,2
20782,20782,,14,1,0,1
20783,20783,,24,0,1,1
20784,20784,,23,0,1,1
20785,20785,,18,1,1,2
20786,20786,,235,0,1,1
20787,20787,,235,1,0,1
20788,20788,,3,1,0,1
20789,20789,,23,1,0,1
20790,20790,,23,1,0,1
20791,20791,,21,0,1,1
20792,20792,,8,1,0,1
20793,20793,,23,0,1,1
20794,20794,,0,0,2,2
20795,20795,,43,1,1,2
20796,20796,,127,0,1,1
20797,20797,,15,0,1,1
20798,20798,,15,0,1,1
20799,20799,,15,0,1,1
20800,20800,,21,0,1,1
20801,20801,,105,1,0,1
20802,20802,,3,1,0,1
20803,20803,,23,1,1,2
20804,20804,,23,1,0,1
20805,20805,,31,0,1,1
20806,20806,,111,1,0,1
20807,20807,,127,1,1,2
20808,20808,,127,1,0,1
20809,20809,,8,1,0,1
20810,20810,,11,1,1,2
20811,20811,,8,1,0,1
20812,20812,,111,1,0,1
20813,20813,,105,0,1,1
20814,20814,,31,1,0,1
20815,20815,,43,1,0,1
20816,20816,,11,0,1,1
20817,20817,,21,2,0,2
20818,20818,,23,0,1,1
20819,20819,,105,1,0,1
20820,20820,,15,1,0,1
20821,20821,,23,0,1,1
20822,20822,,8,0,1,1
20823,20823,,23,1,3,4
20824,20824,,11,0,1,1
20825,20825,,21,0,1,1
20826,20826,,11,1,0,1
20827,20827,,127,0,1,1
20828,20828,,43,0,1,1
20829,20829,,43,0,4,4
20830,20830,,111,0,1,1
20831,20831,,43,0,1,1
20832,20832,,31,1,0,1
20833,20833,,21,1,0,1
20834,20834,,111,1,0,1
20835,20835,,105,1,0,1
20836,20836,,6,0,1,1
20837,20837,,23,0,1,1
20838,20838,,43,2,11,13
20839,20839,,0,0,1,1
20840,20840,,21,0,1,1
20841,20841,,45,1,0,1
20842,20842,,23,2,2,4
20843,20843,,8,1,0,1
20844,20844,,23,2,2,4
20845,20845,,23,0,1,1
20846,20846,,23,0,1,1
20847,20847,,14,1,0,1
20848,20848,,11,0,1,1
20849,20849,,11,1,0,1
20850,20850,,111,1,0,1
20851,20851,,8,0,1,1
20852,20852,,127,0,1,1
20853,20853,,127,2,0,2
20854,20854,,52,0,1,1
20855,20855,,23,1,2,3
20856,20856,,0,1,1,2
20857,20857,,111,1,0,1
20858,20858,,43,1,0,1
20859,20859,,21,0,1,1
20860,20860,,0,0,1,1
20861,20861,,15,0,2,2
20862,20862,,3,2,0,2
20863,20863,,31,0,1,1
20864,20864,,8,0,2,2
20865,20865,,8,0,3,3
20866,20866,,52,1,0,1
20867,20867,,31,1,0,1
20868,20868,,23,1,0,1
20869,20869,,23,0,1,1
20870,20870,,23,1,0,1
20871,20871,,111,0,1,1
20872,20872,,23,1,1,2
20873,20873,,23,1,2,3
20874,20874,,14,1,0,1
20875,20875,,76,0,1,1
20876,20876,,76,0,2,2
20877,20877,,3,1,0,1
20878,20878,,11,1,0,1
20879,20879,,0,0,1,1
20880,20880,,8,2,4,6
20881,20881,,15,0,1,1
20882,20882,,0,1,0,1
20883,20883,,8,2,0,2
20884,20884,,8,2,3,5
20885,20885,,111,0,2,2
20886,20886,,23,1,2,3
20887,20887,,43,1,1,2
20888,20888,,23,1,1,2
20889,20889,,66,0,2,2
20890,20890,,11,0,2,2
20891,20891,,23,1,0,1
20892,20892,,88,1,0,1
20893,20893,,21,0,2,2
20894,20894,,23,0,1,1
20895,20895,,127,1,0,1
20896,20896,,43,0,1,1
20897,20897,,43,0,1,1
20898,20898,,127,0,1,1
20899,20899,,11,0,1,1
20900,20900,,24,1,0,1
20901,20901,,15,1,0,1
20902,20902,,111,2,0,2
20903,20903,,3,0,1,1
20904,20904,,15,0,1,1
20905,20905,,8,1,0,1
20906,20906,,23,1,1,2
20907,20907,,45,0,1,1
20908,20908,,45,0,1,1
20909,20909,,111,0,1,1
20910,20910,,45,1,0,1
20911,20911,,3,0,1,1
20912,20912,,5,1,1,2
20913,20913,,127,2,2,4
20914,20914,,23,1,0,1
20915,20915,,15,1,1,2
20916,20916,,14,1,0,1
20917,20917,,14,1,0,1
20918,20918,,127,0,1,1
20919,20919,,23,1,1,2
20920,20920,,66,1,0,1
20921,20921,,8,1,0,1
20922,20922,,8,1,0,1
20923,20923,,127,0,2,2
20924,20924,,18,1,0,1
20925,20925,,5,0,1,1
20926,20926,,31,1,0,1
20927,20927,,31,1,1,2
20928,20928,,127,1,0,1
20929,20929,,127,1,0,1
20930,20930,,23,0,1,1
20931,20931,,23,1,0,1
20932,20932,,23,0,1,1
20933,20933,,11,0,1,1
20934,20934,,8,1,0,1
20935,20935,,14,0,1,1
20936,20936,,23,0,2,2
20937,20937,,127,1,0,1
20938,20938,,127,1,0,1
20939,20939,,23,0,1,1
20940,20940,,111,0,1,1
20941,20941,,23,2,2,4
20942,20942,,3,1,0,1
20943,20943,,0,0,1,1
20944,20944,,21,0,1,1
20945,20945,,236,0,1,1
20946,20946,,236,1,0,1
20947,20947,,21,1,0,1
20948,20948,,14,0,1,1
20949,20949,,127,0,1,1
20950,20950,,14,1,0,1
20951,20951,,15,1,0,1
20952,20952,,3,0,1,1
20953,20953,,76,2,0,2
20954,20954,,18,0,1,1
20955,20955,,8,0,1,1
20956,20956,,21,1,1,2
20957,20957,,15,1,0,1
20958,20958,,15,1,0,1
20959,20959,,52,1,1,2
20960,20960,,8,1,1,2
20961,20961,,23,1,0,1
20962,20962,,66,0,1,1
20963,20963,,14,0,1,1
20964,20964,,8,2,0,2
20965,20965,,23,0,1,1
20966,20966,,8,0,1,1
20967,20967,,23,0,1,1
20968,20968,,31,0,1,1
20969,20969,,18,0,1,1
20970,20970,,8,1,1,2
20971,20971,,23,0,1,1
20972,20972,,8,1,0,1
20973,20973,,43,0,1,1
20974,20974,,127,0,1,1
20975,20975,,237,0,1,1
20976,20976,,237,1,0,1
20977,20977,,43,2,1,3
20978,20978,,21,1,1,2
20979,20979,,127,0,1,1
20980,20980,,11,0,1,1
20981,20981,,21,0,2,2
20982,20982,,3,2,0,2
20983,20983,,23,0,1,1
20984,20984,,88,1,1,2
20985,20985,,11,1,1,2
20986,20986,,23,0,1,1
20987,20987,,11,1,0,1
20988,20988,,21,0,1,1
20989,20989,,14,1,0,1
20990,20990,,23,1,1,2
20991,20991,,43,0,1,1
20992,20992,,23,1,0,1
20993,20993,,23,0,1,1
20994,20994,,36,1,0,1
20995,20995,,23,1,1,2
20996,20996,,3,1,0,1
20997,20997,,21,1,1,2
20998,20998,,45,1,0,1
20999,20999,,8,1,0,1
21000,21000,,11,0,2,2
21001,21001,,23,0,1,1
21002,21002,,88,1,0,1
21003,21003,,23,1,0,1
21004,21004,,11,0,1,1
21005,21005,,105,0,2,2
21006,21006,,21,1,1,2
21007,21007,,14,0,1,1
21008,21008,,14,1,1,2
21009,21009,,23,1,1,2
21010,21010,,14,0,1,1
21011,21011,,43,0,1,1
21012,21012,,43,0,1,1
21013,21013,,43,1,0,1
21014,21014,,111,0,1,1
21015,21015,,23,0,1,1
21016,21016,,31,0,1,1
21017,21017,,31,1,1,2
21018,21018,,31,0,1,1
21019,21019,,18,0,1,1
21020,21020,,15,2,1,3
21021,21021,,238,0,1,1
21022,21022,,238,1,0,1
21023,21023,,105,1,0,1
21024,21024,,23,0,1,1
21025,21025,,6,0,1,1
21026,21026,,23,0,1,1
21027,21027,,0,1,0,1
21028,21028,,23,1,0,1
21029,21029,,23,1,1,2
21030,21030,,127,0,1,1
21031,21031,,14,2,0,2
21032,21032,,8,0,1,1
21033,21033,,239,0,1,1
21034,21034,,239,1,0,1
21035,21035,,15,1,0,1
21036,21036,,15,0,1,1
21037,21037,,15,1,0,1
21038,21038,,23,1,0,1
21039,21039,,8,0,2,2
21040,21040,,8,0,1,1
21041,21041,,23,0,1,1
21042,21042,,8,2,2,4
21043,21043,,8,1,0,1
21044,21044,,23,1,0,1
21045,21045,,240,0,1,1
21046,21046,,240,1,0,1
21047,21047,,0,1,2,3
21048,21048,,21,0,1,1
21049,21049,,21,1,0,1
21050,21050,,0,1,1,2
21051,21051,,43,1,0,1
21052,21052,,66,0,3,3
21053,21053,,66,2,0,2
21054,21054,,14,0,2,2
21055,21055,,23,1,1,2
21056,21056,,127,0,2,2
21057,21057,,8,1,0,1
21058,21058,,3,0,1,1
21059,21059,,8,0,3,3
21060,21060,,23,1,1,2
21061,21061,,3,1,0,1
21062,21062,,5,1,0,1
21063,21063,,127,0,1,1
21064,21064,,8,0,2,2
21065,21065,,14,1,0,1
21066,21066,,11,1,0,1
21067,21067,,8,0,1,1
21068,21068,,8,0,2,2
21069,21069,,31,1,1,2
21070,21070,,23,0,1,1
21071,21071,,43,0,1,1
21072,21072,,76,2,0,2
21073,21073,,23,0,2,2
21074,21074,,11,1,0,1
21075,21075,,43,1,0,1
21076,21076,,21,2,0,2
21077,21077,,88,0,2,2
21078,21078,,14,0,1,1
21079,21079,,14,2,1,3
21080,21080,,14,0,1,1
21081,21081,,15,1,0,1
21082,21082,,43,1,0,1
21083,21083,,0,1,0,1
21084,21084,,0,0,2,2
21085,21085,,241,0,0,0
21086,21086,,242,0,0,0
21087,21087,,243,0,0,0
21088,21088,,244,0,0,0
21089,21089,,245,0,0,0
21090,21090,,246,0,0,0
21091,21091,,247,0,0,0
21092,21092,,248,0,0,0
21093,21093,,249,0,0,0
21094,21094,,250,0,0,0
21095,21095,,251,0,0,0
21096,21096,,252,0,0,0
21097,21097,,253,0,0,0
21098,21098,,254,0,0,0
21099,21099,,255,0,0,0
21100,21100,,256,0,0,0
21101,21101,,257,0,0,0
21102,21102,,258,0,0,0
21103,21103,,259,0,0,0
21104,21104,,260,0,0,0
21105,21105,,261,0,0,0
21106,21106,,262,0,0,0
21107,21107,,263,0,0,0
21108,21108,,264,0,0,0
21109,21109,,265,0,0,0
21110,21110,,266,0,0,0
21111,21111,,267,0,0,0
21112,21112,,268,0,0,0
21113,21113,,269,0,0,0
21114,21114,,270,0,0,0
21115,21115,,271,0,0,0
21116,21116,,272,0,0,0
21117,21117,,273,0,0,0
21118,21118,,274,0,0,0
21119,21119,,275,0,0,0
21120,21120,,276,0,0,0
21121,21121,,277,0,0,0
21122,21122,,278,0,0,0
21123,21123,,279,0,0,0
21124,21124,,280,0,0,0
21125,21125,,281,0,0,0
21126,21126,,282,0,0,0
21127,21127,,283,0,0,0
21128,21128,,284,0,0,0
21129,21129,,285,0,0,0
21130,21130,,286,0,0,0
21131,21131,,287,0,0,0
21132,21132,,288,0,0,0
21133,21133,,289,0,0,0
21134,21134,,290,0,0,0
21135,21135,,291,0,0,0
21136,21136,,292,0,0,0
21137,21137,,293,0,0,0
21138,21138,,294,0,0,0
21139,21139,,295,0,0,0
21140,21140,,296,0,0,0
21141,21141,,297,0,0,0
21142,21142,,298,0,0,0
21143,21143,,299,0,0,0
21144,21144,,300,0,0,0
21145,21145,,301,0,0,0
21146,21146,,302,0,0,0
21147,21147,,303,0,0,0
21148,21148,,304,0,0,0
21149,21149,,305,0,0,0
21150,21150,,306,0,0,0
21151,21151,,307,0,0,0
21152,21152,,308,0,0,0
21153,21153,,309,0,0,0
21154,21154,,310,0,0,0
21155,21155,,311,0,0,0
21156,21156,,312,0,0,0
21157,21157,,313,0,0,0
21158,21158,,314,0,0,0
21159,21159,,315,0,0,0
21160,21160,,316,0,0,0
21161,21161,,317,0,0,0
21162,21162,,318,0,0,0
21163,21163,,319,0,0,0
21164,21164,,320,0,0,0
21165,21165,,321,0,0,0
21166,21166,,322,0,0,0
21167,21167,,323,0,0,0
21168,21168,,324,0,0,0
21169,21169,,325,0,0,0
21170,21170,,326,0,0,0
21171,21171,,327,0,0,0
21172,21172,,328,0,0,0
21173,21173,,329,0,0,0
21174,21174,,330,0,0,0
21175,21175,,331,0,0,0
21176,21176,,332,0,0,0
21177,21177,,333,0,0,0
21178,21178,,334,0,0,0
21179,21179,,335,0,0,0
21180,21180,,336,0,0,0
21181,21181,,337,0,0,0
21182,21182,,338,0,0,0
21183,21183,,339,0,0,0
21184,21184,,340,0,0,0
21185,21185,,341,0,0,0
21186,21186,,342,0,0,0
21187,21187,,343,0,0,0
21188,21188,,344,0,0,0
21189,21189,,345,0,0,0
21190,21190,,346,0,0,0
21191,21191,,347,0,0,0
21192,21192,,348,0,0,0
21193,21193,,349,0,0,0
21194,21194,,350,0,0,0
21195,21195,,351,0,0,0
21196,21196,,352,0,0,0
21197,21197,,353,0,0,0
21198,21198,,354,0,0,0
21199,21199,,355,0,0,0
21200,21200,,356,0,0,0
21201,21201,,357,0,0,0
21202,21202,,358,0,0,0
21203,21203,,359,0,0,0
21204,21204,,360,0,0,0
21205,21205,,361,0,0,0
21206,21206,,362,0,0,0
21207,21207,,363,0,0,0
21208,21208,,364,0,0,0
21209,21209,,365,0,0,0
21210,21210,,366,0,0,0
21211,21211,,367,0,0,0
21212,21212,,368,0,0,0
21213,21213,,369,0,0,0
21214,21214,,370,0,0,0
21215,21215,,371,0,0,0
21216,21216,,372,0,0,0
21217,21217,,373,0,0,0
21218,21218,,374,0,0,0
21219,21219,,375,0,0,0
21220,21220,,376,0,0,0
21221,21221,,377,0,0,0
21222,21222,,378,0,0,0
21223,21223,,379,0,0,0
21224,21224,,380,0,0,0
21225,21225,,381,0,0,0
21226,21226,,382,0,0,0
21227,21227,,383,0,0,0
21228,21228,,384,0,0,0
21229,21229,,385,0,0,0
21230,21230,,386,0,0,0
21231,21231,,387,0,0,0
21232,21232,,388,0,0,0
21233,21233,,389,0,0,0
21234,21234,,390,0,0,0
21235,21235,,391,0,0,0
21236,21236,,392,0,0,0
21237,21237,,393,0,0,0
21238,21238,,394,0,0,0
21239,21239,,395,0,0,0
21240,21240,,396,0,0,0
21241,21241,,397,0,0,0
21242,21242,,398,0,0,0
21243,21243,,399,0,0,0
21244,21244,,400,0,0,0
21245,21245,,401,0,0,0
21246,21246,,402,0,0,0
21247,21247,,403,0,0,0
21248,21248,,404,0,0,0
21249,21249,,405,0,0,0
21250,21250,,406,0,0,0
21251,21251,,407,0,0,0
21252,21252,,408,0,0,0
21253,21253,,409,0,0,0
21254,21254,,410,0,0,0
21255,21255,,411,0,0,0
21256,21256,,412,0,0,0
21257,21257,,413,0,0,0
21258,21258,,414,0,0,0
21259,21259,,415,0,0,0
21260,21260,,416,0,0,0
21261,21261,,417,0,0,0
21262,21262,,418,0,0,0
21263,21263,,419,0,0,0
21264,21264,,420,0,0,0
21265,21265,,421,0,0,0
21266,21266,,422,0,0,0
21267,21267,,423,0,0,0
21268,21268,,424,0,0,0
21269,21269,,425,0,0,0
21270,21270,,426,0,0,0
21271,21271,,427,0,0,0
21272,21272,,428,0,0,0
21273,21273,,429,0,0,0
21274,21274,,430,0,0,0
21275,21275,,431,0,0,0
21276,21276,,432,0,0,0
21277,21277,,433,0,0,0
21278,21278,,434,0,0,0
21279,21279,,435,0,0,0
21280,21280,,436,0,0,0
21281,21281,,437,0,0,0
21282,21282,,438,0,0,0
21283,21283,,439,0,0,0
21284,21284,,440,0,0,0
21285,21285,,441,0,0,0
21286,21286,,442,0,0,0
21287,21287,,443,0,0,0
21288,21288,,444,0,0,0
21289,21289,,445,0,0,0
21290,21290,,446,0,0,0
21291,21291,,447,0,0,0
21292,21292,,448,0,0,0
21293,21293,,449,0,0,0
21294,21294,,450,0,0,0
21295,21295,,451,0,0,0
21296,21296,,452,0,0,0
21297,21297,,453,0,0,0
21298,21298,,454,0,0,0
21299,21299,,455,0,0,0
21300,21300,,456,0,0,0
21301,21301,,457,0,0,0
21302,21302,,458,0,0,0
21303,21303,,459,0,0,0
21304,21304,,460,0,0,0
21305,21305,,461,0,0,0
21306,21306,,462,0,0,0
21307,21307,,463,0,0,0
21308,21308,,464,0,0,0
21309,21309,,465,0,0,0
21310,21310,,466,0,0,0
21311,21311,,467,0,0,0
21312,21312,,468,0,0,0
21313,21313,,469,0,0,0
21314,21314,,470,0,0,0
21315,21315,,471,0,0,0
21316,21316,,472,0,0,0
21317,21317,,473,0,0,0
21318,21318,,474,0,0,0
21319,21319,,475,0,0,0
21320,21320,,476,0,0,0
21321,21321,,477,0,0,0
21322,21322,,478,0,0,0
21323,21323,,479,0,0,0
21324,21324,,480,0,0,0
21325,21325,,481,0,0,0
21326,21326,,482,0,0,0
21327,21327,,483,0,0,0
21328,21328,,484,0,0,0
21329,21329,,485,0,0,0
21330,21330,,486,0,0,0
21331,21331,,487,0,0,0
21332,21332,,488,0,0,0
21333,21333,,489,0,0,0
21334,21334,,490,0,0,0
21335,21335,,491,0,0,0
21336,21336,,492,0,0,0
21337,21337,,493,0,0,0
21338,21338,,494,0,0,0
21339,21339,,495,0,0,0
21340,21340,,496,0,0,0
21341,21341,,497,0,0,0
21342,21342,,498,0,0,0
21343,21343,,499,0,0,0
21344,21344,,500,0,0,0
21345,21345,,501,0,0,0
21346,21346,,502,0,0,0
21347,21347,,503,0,0,0
21348,21348,,504,0,0,0
21349,21349,,505,0,0,0
21350,21350,,506,0,0,0
21351,21351,,507,0,0,0
21352,21352,,508,0,0,0
21353,21353,,509,0,0,0
21354,21354,,510,0,0,0
21355,21355,,511,0,0,0
21356,21356,,512,0,0,0
21357,21357,,513,0,0,0
21358,21358,,514,0,0,0
21359,21359,,515,0,0,0
21360,21360,,516,0,0,0
21361,21361,,517,0,0,0
21362,21362,,518,0,0,0
21363,21363,,519,0,0,0
21364,21364,,520,0,0,0
21365,21365,,521,0,0,0
21366,21366,,522,0,0,0
21367,21367,,523,0,0,0
21368,21368,,524,0,0,0
21369,21369,,525,0,0,0
21370,21370,,526,0,0,0
21371,21371,,527,0,0,0
21372,21372,,528,0,0,0
21373,21373,,529,0,0,0
21374,21374,,530,0,0,0
21375,21375,,531,0,0,0
21376,21376,,532,0,0,0
21377,21377,,533,0,0,0
21378,21378,,534,0,0,0
21379,21379,,535,0,0,0
21380,21380,,536,0,0,0
21381,21381,,537,0,0,0
21382,21382,,538,0,0,0
21383,21383,,539,0,0,0
21384,21384,,540,0,0,0
21385,21385,,541,0,0,0
21386,21386,,542,0,0,0
21387,21387,,543,0,0,0
21388,21388,,544,0,0,0
21389,21389,,545,0,0,0
21390,21390,,546,0,0,0
21391,21391,,547,0,0,0
21392,21392,,548,0,0,0
21393,21393,,549,0,0,0
21394,21394,,550,0,0,0
21395,21395,,551,0,0,0
21396,21396,,552,0,0,0
21397,21397,,553,0,0,0
21398,21398,,554,0,0,0
21399,21399,,555,0,0,0
21400,21400,,556,0,0,0
21401,21401,,557,0,0,0
21402,21402,,558,0,0,0
21403,21403,,559,0,0,0
21404,21404,,560,0,0,0
21405,21405,,561,0,0,0
21406,21406,,562,0,0,0
21407,21407,,563,0,0,0
21408,21408,,564,0,0,0
21409,21409,,565,0,0,0
21410,21410,,566,0,0,0
21411,21411,,567,0,0,0
21412,21412,,568,0,0,0
21413,21413,,569,0,0,0
21414,21414,,570,0,0,0
21415,21415,,571,0,0,0
21416,21416,,572,0,0,0
21417,21417,,573,0,0,0
21418,21418,,574,0,0,0
21419,21419,,575,0,0,0
21420,21420,,576,0,0,0
21421,21421,,577,0,0,0
21422,21422,,578,0,0,0
21423,21423,,579,0,0,0
21424,21424,,580,0,0,0
21425,21425,,581,0,0,0
21426,21426,,582,0,0,0
21427,21427,,583,0,0,0
21428,21428,,584,0,0,0
21429,21429,,585,0,0,0
21430,21430,,586,0,0,0
21431,21431,,587,0,0,0
21432,21432,,588,0,0,0
21433,21433,,589,0,0,0
21434,21434,,590,0,0,0
21435,21435,,591,0,0,0
21436,21436,,592,0,0,0
21437,21437,,593,0,0,0
21438,21438,,594,0,0,0
21439,21439,,595,0,0,0
21440,21440,,596,0,0,0
21441,21441,,597,0,0,0
21442,21442,,598,0,0,0
21443,21443,,599,0,0,0
21444,21444,,600,0,0,0
21445,21445,,601,0,0,0
21446,21446,,602,0,0,0
21447,21447,,603,0,0,0
21448,21448,,604,0,0,0
21449,21449,,605,0,0,0
21450,21450,,606,0,0,0
21451,21451,,607,0,0,0
21452,21452,,608,0,0,0
21453,21453,,609,0,0,0
21454,21454,,610,0,0,0
21455,21455,,611,0,0,0
21456,21456,,612,0,0,0
21457,21457,,613,0,0,0
21458,21458,,614,0,0,0
21459,21459,,615,0,0,0
21460,21460,,616,0,0,0
21461,21461,,617,0,0,0
21462,21462,,618,0,0,0
21463,21463,,619,0,0,0
21464,21464,,620,0,0,0
21465,21465,,621,0,0,0
21466,21466,,622,0,0,0
21467,21467,,623,0,0,0
21468,21468,,624,0,0,0
21469,21469,,625,0,0,0
21470,21470,,626,0,0,0
21471,21471,,627,0,0,0
21472,21472,,628,0,0,0
21473,21473,,629,0,0,0
21474,21474,,630,0,0,0
21475,21475,,631,0,0,0
21476,21476,,632,0,0,0
21477,21477,,633,0,0,0
21478,21478,,634,0,0,0
21479,21479,,635,0,0,0
21480,21480,,636,0,0,0
21481,21481,,637,0,0,0
21482,21482,,638,0,0,0
21483,21483,,639,0,0,0
21484,21484,,640,0,0,0
21485,21485,,641,0,0,0
21486,21486,,642,0,0,0
21487,21487,,643,0,0,0
21488,21488,,644,0,0,0
21489,21489,,645,0,0,0
21490,21490,,646,0,0,0
21491,21491,,647,0,0,0
21492,21492,,648,0,0,0
21493,21493,,649,0,0,0
21494,21494,,650,0,0,0
21495,21495,,651,0,0,0
21496,21496,,652,0,0,0
21497,21497,,653,0,0,0
21498,21498,,654,0,0,0
21499,21499,,655,0,0,0
21500,21500,,656,0,0,0
21501,21501,,657,0,0,0
21502,21502,,658,0,0,0
21503,21503,,659,0,0,0
21504,21504,,660,0,0,0
21505,21505,,661,0,0,0
21506,21506,,662,0,0,0
21507,21507,,663,0,0,0
21508,21508,,664,0,0,0
21509,21509,,665,0,0,0
21510,21510,,666,0,0,0
21511,21511,,667,0,0,0
21512,21512,,668,0,0,0
21513,21513,,669,0,0,0
21514,21514,,670,0,0,0
21515,21515,,671,0,0,0
21516,21516,,672,0,0,0
21517,21517,,673,0,0,0
21518,21518,,674,0,0,0
21519,21519,,675,0,0,0
21520,21520,,676,0,0,0
21521,21521,,677,0,0,0
21522,21522,,678,0,0,0
21523,21523,,679,0,0,0
21524,21524,,680,0,0,0
21525,21525,,681,0,0,0
21526,21526,,682,0,0,0
21527,21527,,683,0,0,0
21528,21528,,684,0,0,0
21529,21529,,685,0,0,0
21530,21530,,686,0,0,0
21531,21531,,687,0,0,0
21532,21532,,688,0,0,0
21533,21533,,689,0,0,0
21534,21534,,690,0,0,0
21535,21535,,691,0,0,0
21536,21536,,692,0,0,0
21537,21537,,693,0,0,0
21538,21538,,694,0,0,0
21539,21539,,695,0,0,0
21540,21540,,696,0,0,0
21541,21541,,697,0,0,0
21542,21542,,698,0,0,0
21543,21543,,699,0,0,0
21544,21544,,700,0,0,0
21545,21545,,701,0,0,0
21546,21546,,702,0,0,0
21547,21547,,703,0,0,0
21548,21548,,704,0,0,0
21549,21549,,705,0,0,0
21550,21550,,706,0,0,0
21551,21551,,707,0,0,0
21552,21552,,708,0,0,0
21553,21553,,709,0,0,0
21554,21554,,710,0,0,0
21555,21555,,711,0,0,0
21556,21556,,712,0,0,0
21557,21557,,713,0,0,0
21558,21558,,714,0,0,0
21559,21559,,715,0,0,0
21560,21560,,716,0,0,0
21561,21561,,717,0,0,0
21562,21562,,718,0,0,0
21563,21563,,719,0,0,0
21564,21564,,720,0,0,0
21565,21565,,721,0,0,0
21566,21566,,722,0,0,0
21567,21567,,723,0,0,0
21568,21568,,724,0,0,0
21569,21569,,725,0,0,0
21570,21570,,726,0,0,0
21571,21571,,727,0,0,0
21572,21572,,728,0,0,0
21573,21573,,729,0,0,0
21574,21574,,730,0,0,0
21575,21575,,731,0,0,0
21576,21576,,732,0,0,0
21577,21577,,733,0,0,0
21578,21578,,734,0,0,0
21579,21579,,735,0,0,0
21580,21580,,736,0,0,0
21581,21581,,737,0,0,0
21582,21582,,738,0,0,0
21583,21583,,739,0,0,0
21584,21584,,740,0,0,0
21585,21585,,741,0,0,0
21586,21586,,742,0,0,0
21587,21587,,743,0,0,0
21588,21588,,744,0,0,0
21589,21589,,745,0,0,0
21590,21590,,746,0,0,0
21591,21591,,747,0,0,0
21592,21592,,748,0,0,0
21593,21593,,749,0,0,0
21594,21594,,750,0,0,0
21595,21595,,751,0,0,0
21596,21596,,752,0,0,0
21597,21597,,753,0,0,0
21598,21598,,754,0,0,0
21599,21599,,755,0,0,0
21600,21600,,756,0,0,0
21601,21601,,757,0,0,0
21602,21602,,758,0,0,0
21603,21603,,759,0,0,0
21604,21604,,760,0,0,0
21605,21605,,761,0,0,0
21606,21606,,762,0,0,0
21607,21607,,763,0,0,0
21608,21608,,764,0,0,0
21609,21609,,765,0,0,0
21610,21610,,766,0,0,0
21611,21611,,767,0,0,0
21612,21612,,768,0,0,0
21613,21613,,769,0,0,0
21614,21614,,770,0,0,0
21615,21615,,771,0,0,0
21616,21616,,772,0,0,0
21617,21617,,773,0,0,0
21618,21618,,774,0,0,0
21619,21619,,775,0,0,0
21620,21620,,776,0,0,0
21621,21621,,777,0,0,0
21622,21622,,778,0,0,0
21623,21623,,779,0,0,0
21624,21624,,780,0,0,0
21625,21625,,781,0,0,0
21626,21626,,782,0,0,0
21627,21627,,783,0,0,0
21628,21628,,784,0,0,0
21629,21629,,785,0,0,0
21630,21630,,786,0,0,0
21631,21631,,787,0,0,0
21632,21632,,788,0,0,0
21633,21633,,789,0,0,0
21634,21634,,790,0,0,0
21635,21635,,791,0,0,0
21636,21636,,792,0,0,0
21637,21637,,793,0,0,0
21638,21638,,794,0,0,0
21639,21639,,795,0,0,0
21640,21640,,796,0,0,0
21641,21641,,797,0,0,0
21642,21642,,798,0,0,0
21643,21643,,799,0,0,0
21644,21644,,800,0,0,0
21645,21645,,801,0,0,0
21646,21646,,802,0,0,0
21647,21647,,803,0,0,0
21648,21648,,804,0,0,0
21649,21649,,805,0,0,0
21650,21650,,806,0,0,0
21651,21651,,807,0,0,0
21652,21652,,808,0,0,0
21653,21653,,809,0,0,0
21654,21654,,810,0,0,0
21655,21655,,811,0,0,0
21656,21656,,812,0,0,0
21657,21657,,813,0,0,0
21658,21658,,814,0,0,0
21659,21659,,815,0,0,0
21660,21660,,816,0,0,0
21661,21661,,817,0,0,0
21662,21662,,818,0,0,0
21663,21663,,819,0,0,0
21664,21664,,820,0,0,0
21665,21665,,821,0,0,0
21666,21666,,822,0,0,0
21667,21667,,823,0,0,0
21668,21668,,824,0,0,0
21669,21669,,825,0,0,0
21670,21670,,826,0,0,0
21671,21671,,827,0,0,0
21672,21672,,828,0,0,0
21673,21673,,829,0,0,0
21674,21674,,830,0,0,0
21675,21675,,831,0,0,0
21676,21676,,832,0,0,0
21677,21677,,833,0,0,0
21678,21678,,834,0,0,0
21679,21679,,835,0,0,0
21680,21680,,836,0,0,0
21681,21681,,837,0,0,0
21682,21682,,838,0,0,0
21683,21683,,839,0,0,0
21684,21684,,840,0,0,0
21685,21685,,841,0,0,0
21686,21686,,842,0,0,0
21687,21687,,843,0,0,0
21688,21688,,844,0,0,0
21689,21689,,845,0,0,0
21690,21690,,846,0,0,0
21691,21691,,847,0,0,0
21692,21692,,848,0,0,0
21693,21693,,849,0,0,0
21694,21694,,850,0,0,0
21695,21695,,851,0,0,0
21696,21696,,852,0,0,0
21697,21697,,853,0,0,0
21698,21698,,854,0,0,0
21699,21699,,855,0,0,0
21700,21700,,856,0,0,0
21701,21701,,857,0,0,0
21702,21702,,858,0,0,0
21703,21703,,859,0,0,0
21704,21704,,860,0,0,0
21705,21705,,861,0,0,0
21706,21706,,862,0,0,0
21707,21707,,863,0,0,0
21708,21708,,864,0,0,0
21709,21709,,865,0,0,0
21710,21710,,866,0,0,0
21711,21711,,867,0,0,0
21712,21712,,868,0,0,0
21713,21713,,869,0,0,0
21714,21714,,870,0,0,0
21715,21715,,871,0,0,0
21716,21716,,872,0,0,0
21717,21717,,873,0,0,0
21718,21718,,874,0,0,0
21719,21719,,875,0,0,0
21720,21720,,876,0,0,0
21721,21721,,877,0,0,0
21722,21722,,878,0,0,0
21723,21723,,879,0,0,0
21724,21724,,880,0,0,0
21725,21725,,881,0,0,0
21726,21726,,882,0,0,0
21727,21727,,883,0,0,0
21728,21728,,884,0,0,0
21729,21729,,885,0,0,0
21730,21730,,886,0,0,0
21731,21731,,887,0,0,0
21732,21732,,888,0,0,0
21733,21733,,889,0,0,0
21734,21734,,890,0,0,0
21735,21735,,891,0,0,0
21736,21736,,892,0,0,0
21737,21737,,893,0,0,0
21738,21738,,894,0,0,0
21739,21739,,895,0,0,0
21740,21740,,896,0,0,0
21741,21741,,897,0,0,0
21742,21742,,898,0,0,0
21743,21743,,899,0,0,0
21744,21744,,900,0,0,0
21745,21745,,901,0,0,0
21746,21746,,902,0,0,0
21747,21747,,903,0,0,0
21748,21748,,904,0,0,0
21749,21749,,905,0,0,0
21750,21750,,906,0,0,0
21751,21751,,907,0,0,0
21752,21752,,908,0,0,0
21753,21753,,909,0,0,0
21754,21754,,910,0,0,0
21755,21755,,911,0,0,0
21756,21756,,912,0,0,0
21757,21757,,913,0,0,0
21758,21758,,914,0,0,0
21759,21759,,915,0,0,0
21760,21760,,916,0,0,0
21761,21761,,917,0,0,0
21762,21762,,918,0,0,0
21763,21763,,919,0,0,0
21764,21764,,920,0,0,0
21765,21765,,921,0,0,0
21766,21766,,922,0,0,0
21767,21767,,923,0,0,0
21768,21768,,924,0,0,0
21769,21769,,925,0,0,0
21770,21770,,926,0,0,0
21771,21771,,927,0,0,0
21772,21772,,928,0,0,0
21773,21773,,929,0,0,0
21774,21774,,930,0,0,0
21775,21775,,931,0,0,0
21776,21776,,932,0,0,0
21777,21777,,933,0,0,0
21778,21778,,934,0,0,0
21779,21779,,935,0,0,0
21780,21780,,936,0,0,0
21781,21781,,937,0,0,0
21782,21782,,938,0,0,0
21783,21783,,939,0,0,0
21784,21784,,940,0,0,0
21785,21785,,941,0,0,0
21786,21786,,942,0,0,0
21787,21787,,943,0,0,0
21788,21788,,944,0,0,0
21789,21789,,945,0,0,0
21790,21790,,946,0,0,0
21791,21791,,947,0,0,0
21792,21792,,948,0,0,0
21793,21793,,949,0,0,0
21794,21794,,950,0,0,0
21795,21795,,951,0,0,0
21796,21796,,952,0,0,0
21797,21797,,953,0,0,0
21798,21798,,954,0,0,0
21799,21799,,955,0,0,0
21800,21800,,956,0,0,0
21801,21801,,957,0,0,0
21802,21802,,958,0,0,0
21803,21803,,959,0,0,0
21804,21804,,960,0,0,0
21805,21805,,961,0,0,0
21806,21806,,962,0,0,0
21807,21807,,963,0,0,0
21808,21808,,964,0,0,0
21809,21809,,965,0,0,0
21810,21810,,966,0,0,0
21811,21811,,967,0,0,0
21812,21812,,968,0,0,0
21813,21813,,969,0,0,0
21814,21814,,970,0,0,0
21815,21815,,971,0,0,0
21816,21816,,972,0,0,0
21817,21817,,973,0,0,0
21818,21818,,974,0,0,0
21819,21819,,975,0,0,0
21820,21820,,976,0,0,0
21821,21821,,977,0,0,0
21822,21822,,978,0,0,0
21823,21823,,979,0,0,0
21824,21824,,980,0,0,0
21825,21825,,981,0,0,0
21826,21826,,982,0,0,0
21827,21827,,983,0,0,0
21828,21828,,984,0,0,0
21829,21829,,985,0,0,0
21830,21830,,986,0,0,0
21831,21831,,987,0,0,0
21832,21832,,988,0,0,0
21833,21833,,989,0,0,0
21834,21834,,990,0,0,0
21835,21835,,991,0,0,0
21836,21836,,992,0,0,0
21837,21837,,993,0,0,0
21838,21838,,994,0,0,0
21839,21839,,995,0,0,0
21840,21840,,996,0,0,0
21841,21841,,997,0,0,0
21842,21842,,998,0,0,0
21843,21843,,999,0,0,0
21844,21844,,1000,0,0,0
21845,21845,,1001,0,0,0
21846,21846,,1002,0,0,0
21847,21847,,1003,0,0,0
21848,21848,,1004,0,0,0
21849,21849,,1005,0,0,0
21850,21850,,1006,0,0,0
21851,21851,,1007,0,0,0
21852,21852,,1008,0,0,0
21853,21853,,1009,0,0,0
21854,21854,,1010,0,0,0
21855,21855,,1011,0,0,0
21856,21856,,1012,0,0,0
21857,21857,,1013,0,0,0
21858,21858,,1014,0,0,0
21859,21859,,1015,0,0,0
21860,21860,,1016,0,0,0
21861,21861,,1017,0,0,0
21862,21862,,1018,0,0,0
21863,21863,,1019,0,0,0
21864,21864,,1020,0,0,0
21865,21865,,1021,0,0,0
21866,21866,,1022,0,0,0
21867,21867,,1023,0,0,0
21868,21868,,1024,0,0,0
21869,21869,,1025,0,0,0
21870,21870,,1026,0,0,0
21871,21871,,1027,0,0,0
21872,21872,,1028,0,0,0
21873,21873,,1029,0,0,0
21874,21874,,1030,0,0,0
21875,21875,,1031,0,0,0
21876,21876,,1032,0,0,0
21877,21877,,1033,0,0,0
21878,21878,,1034,0,0,0
21879,21879,,1035,0,0,0
21880,21880,,1036,0,0,0
21881,21881,,1037,0,0,0
21882,21882,,1038,0,0,0
21883,21883,,1039,0,0,0
21884,21884,,1040,0,0,0
21885,21885,,1041,0,0,0
21886,21886,,1042,0,0,0
21887,21887,,1043,0,0,0
21888,21888,,1044,0,0,0
21889,21889,,1045,0,0,0
21890,21890,,1046,0,0,0
21891,21891,,1047,0,0,0
21892,21892,,1048,0,0,0
21893,21893,,1049,0,0,0
21894,21894,,1050,0,0,0
21895,21895,,1051,0,0,0
21896,21896,,1052,0,0,0
21897,21897,,1053,0,0,0
21898,21898,,1054,0,0,0
21899,21899,,1055,0,0,0
21900,21900,,1056,0,0,0
21901,21901,,1057,0,0,0
21902,21902,,1058,0,0,0
21903,21903,,1059,0,0,0
21904,21904,,1060,0,0,0
21905,21905,,1061,0,0,0
21906,21906,,1062,0,0,0
21907,21907,,1063,0,0,0
21908,21908,,1064,0,0,0
21909,21909,,1065,0,0,0
21910,21910,,1066,0,0,0
21911,21911,,1067,0,0,0
21912,21912,,1068,0,0,0
21913,21913,,1069,0,0,0
21914,21914,,1070,0,0,0
21915,21915,,1071,0,0,0
21916,21916,,1072,0,0,0
21917,21917,,1073,0,0,0
21918,21918,,1074,0,0,0
21919,21919,,1075,0,0,0
21920,21920,,1076,0,0,0
21921,21921,,1077,0,0,0
21922,21922,,1078,0,0,0
21923,21923,,1079,0,0,0
21924,21924,,1080,0,0,0
21925,21925,,1081,0,0,0
21926,21926,,1082,0,0,0
21927,21927,,1083,0,0,0
21928,21928,,1084,0,0,0
21929,21929,,1085,0,0,0
21930,21930,,1086,0,0,0
21931,21931,,1087,0,0,0
21932,21932,,1088,0,0,0
21933,21933,,1089,0,0,0
21934,21934,,1090,0,0,0
21935,21935,,1091,0,0,0
21936,21936,,1092,0,0,0
21937,21937,,1093,0,0,0
21938,21938,,1094,0,0,0
21939,21939,,1095,0,0,0
21940,21940,,1096,0,0,0
21941,21941,,1097,0,0,0
21942,21942,,1098,0,0,0
21943,21943,,1099,0,0,0
21944,21944,,1100,0,0,0
21945,21945,,1101,0,0,0
21946,21946,,1102,0,0,0
21947,21947,,1103,0,0,0
21948,21948,,1104,0,0,0
21949,21949,,1105,0,0,0
21950,21950,,1106,0,0,0
21951,21951,,1107,0,0,0
21952,21952,,1108,0,0,0
21953,21953,,1109,0,0,0
21954,21954,,1110,0,0,0
21955,21955,,1111,0,0,0
21956,21956,,1112,0,0,0
21957,21957,,1113,0,0,0
21958,21958,,1114,0,0,0
21959,21959,,1115,0,0,0
21960,21960,,1116,0,0,0
21961,21961,,1117,0,0,0
21962,21962,,1118,0,0,0
21963,21963,,1119,0,0,0
21964,21964,,1120,0,0,0
21965,21965,,1121,0,0,0
21966,21966,,1122,0,0,0
21967,21967,,1123,0,0,0
21968,21968,,1124,0,0,0
21969,21969,,1125,0,0,0
21970,21970,,1126,0,0,0
21971,21971,,1127,0,0,0
21972,21972,,1128,0,0,0
21973,21973,,1129,0,0,0
21974,21974,,1130,0,0,0
21975,21975,,1131,0,0,0
21976,21976,,1132,0,0,0
21977,21977,,1133,0,0,0
21978,21978,,1134,0,0,0
21979,21979,,1135,0,0,0
21980,21980,,1136,0,0,0
21981,21981,,1137,0,0,0
21982,21982,,1138,0,0,0
21983,21983,,1139,0,0,0
21984,21984,,1140,0,0,0
21985,21985,,1141,0,0,0
21986,21986,,1142,0,0,0
21987,21987,,1143,0,0,0
21988,21988,,1144,0,0,0
21989,21989,,1145,0,0,0
21990,21990,,1146,0,0,0
21991,21991,,1147,0,0,0
21992,21992,,1148,0,0,0
21993,21993,,1149,0,0,0
21994,21994,,1150,0,0,0
21995,21995,,1151,0,0,0
21996,21996,,1152,0,0,0
21997,21997,,1153,0,0,0
21998,21998,,1154,0,0,0
21999,21999,,1155,0,0,0
22000,22000,,1156,0,0,0
22001,22001,,1157,0,0,0
22002,22002,,1158,0,0,0
22003,22003,,1159,0,0,0
22004,22004,,1160,0,0,0
22005,22005,,1161,0,0,0
22006,22006,,1162,0,0,0
22007,22007,,1163,0,0,0
22008,22008,,1164,0,0,0
22009,22009,,1165,0,0,0
22010,22010,,1166,0,0,0
22011,22011,,1167,0,0,0
22012,22012,,1168,0,0,0
22013,22013,,1169,0,0,0
22014,22014,,1170,0,0,0
22015,22015,,1171,0,0,0
22016,22016,,1172,0,0,0
22017,22017,,1173,0,0,0
22018,22018,,1174,0,0,0
22019,22019,,1175,0,0,0
22020,22020,,1176,0,0,0
22021,22021,,1177,0,0,0
22022,22022,,1178,0,0,0
22023,22023,,1179,0,0,0
22024,22024,,1180,0,0,0
22025,22025,,1181,0,0,0
22026,22026,,1182,0,0,0
22027,22027,,1183,0,0,0
22028,22028,,1184,0,0,0
22029,22029,,1185,0,0,0
22030,22030,,1186,0,0,0
22031,22031,,1187,0,0,0
22032,22032,,1188,0,0,0
22033,22033,,1189,0,0,0
22034,22034,,1190,0,0,0
22035,22035,,1191,0,0,0
22036,22036,,1192,0,0,0
22037,22037,,1193,0,0,0
22038,22038,,1194,0,0,0
22039,22039,,1195,0,0,0
22040,22040,,1196,0,0,0
22041,22041,,1197,0,0,0
22042,22042,,1198,0,0,0
22043,22043,,1199,0,0,0
22044,22044,,1200,0,0,0
22045,22045,,1201,0,0,0
22046,22046,,1202,0,0,0
22047,22047,,1203,0,0,0
22048,22048,,1204,0,0,0
22049,22049,,1205,0,0,0
22050,22050,,1206,0,0,0
22051,22051,,1207,0,0,0
22052,22052,,1208,0,0,0
22053,22053,,1209,0,0,0
22054,22054,,1210,0,0,0
22055,22055,,1211,0,0,0
22056,22056,,1212,0,0,0
22057,22057,,1213,0,0,0
22058,22058,,1214,0,0,0
22059,22059,,1215,0,0,0
22060,22060,,1216,0,0,0
22061,22061,,1217,0,0,0
22062,22062,,1218,0,0,0
22063,22063,,1219,0,0,0
22064,22064,,1220,0,0,0
22065,22065,,1221,0,0,0
22066,22066,,1222,0,0,0
22067,22067,,1223,0,0,0
22068,22068,,1224,0,0,0
22069,22069,,1225,0,0,0
22070,22070,,1226,0,0,0
22071,22071,,1227,0,0,0
22072,22072,,1228,0,0,0
22073,22073,,1229,0,0,0
22074,22074,,1230,0,0,0
22075,22075,,1231,0,0,0
22076,22076,,1232,0,0,0
22077,22077,,1233,0,0,0
22078,22078,,1234,0,0,0
22079,22079,,1235,0,0,0
22080,22080,,1236,0,0,0
22081,22081,,1237,0,0,0
22082,22082,,1238,0,0,0
22083,22083,,1239,0,0,0
22084,22084,,1240,0,0,0
22085,22085,,1241,0,0,0
22086,22086,,1242,0,0,0
22087,22087,,1243,0,0,0
22088,22088,,1244,0,0,0
22089,22089,,1245,0,0,0
22090,22090,,1246,0,0,0
22091,22091,,1247,0,0,0
22092,22092,,1248,0,0,0
22093,22093,,1249,0,0,0
22094,22094,,1250,0,0,0
22095,22095,,1251,0,0,0
22096,22096,,1252,0,0,0
22097,22097,,1253,0,0,0
22098,22098,,1254,0,0,0
22099,22099,,1255,0,0,0
22100,22100,,1256,0,0,0
22101,22101,,1257,0,0,0
22102,22102,,1258,0,0,0
22103,22103,,1259,0,0,0
22104,22104,,1260,0,0,0
22105,22105,,1261,0,0,0
22106,22106,,1262,0,0,0
22107,22107,,1263,0,0,0
22108,22108,,1264,0,0,0
22109,22109,,1265,0,0,0
22110,22110,,1266,0,0,0
22111,22111,,1267,0,0,0
22112,22112,,1268,0,0,0
22113,22113,,1269,0,0,0
22114,22114,,1270,0,0,0
22115,22115,,1271,0,0,0
22116,22116,,1272,0,0,0
22117,22117,,1273,0,0,0
22118,22118,,1274,0,0,0
22119,22119,,1275,0,0,0
22120,22120,,1276,0,0,0
22121,22121,,1277,0,0,0
22122,22122,,1278,0,0,0
22123,22123,,1279,0,0,0
22124,22124,,1280,0,0,0
22125,22125,,1281,0,0,0
22126,22126,,1282,0,0,0
22127,22127,,1283,0,0,0
22128,22128,,1284,0,0,0
22129,22129,,1285,0,0,0
22130,22130,,1286,0,0,0
22131,22131,,1287,0,0,0
22132,22132,,1288,0,0,0
22133,22133,,1289,0,0,0
22134,22134,,1290,0,0,0
22135,22135,,1291,0,0,0
22136,22136,,1292,0,0,0
22137,22137,,1293,0,0,0
22138,22138,,1294,0,0,0
22139,22139,,1295,0,0,0
22140,22140,,1296,0,0,0
22141,22141,,1297,0,0,0
22142,22142,,1298,0,0,0
22143,22143,,1299,0,0,0
22144,22144,,1300,0,0,0
22145,22145,,1301,0,0,0
22146,22146,,1302,0,0,0
22147,22147,,1303,0,0,0
22148,22148,,1304,0,0,0
22149,22149,,1305,0,0,0
22150,22150,,1306,0,0,0
22151,22151,,1307,0,0,0
22152,22152,,1308,0,0,0
22153,22153,,1309,0,0,0
22154,22154,,1310,0,0,0
22155,22155,,1311,0,0,0
22156,22156,,1312,0,0,0
22157,22157,,1313,0,0,0
22158,22158,,1314,0,0,0
22159,22159,,1315,0,0,0
22160,22160,,1316,0,0,0
22161,22161,,1317,0,0,0
22162,22162,,1318,0,0,0
22163,22163,,1319,0,0,0
22164,22164,,1320,0,0,0
22165,22165,,1321,0,0,0
22166,22166,,1322,0,0,0
22167,22167,,1323,0,0,0
22168,22168,,1324,0,0,0
22169,22169,,1325,0,0,0
22170,22170,,1326,0,0,0
22171,22171,,1327,0,0,0
22172,22172,,1328,0,0,0
22173,22173,,1329,0,0,0
22174,22174,,1330,0,0,0
22175,22175,,1331,0,0,0
22176,22176,,1332,0,0,0
22177,22177,,1333,0,0,0
22178,22178,,1334,0,0,0
22179,22179,,1335,0,0,0
22180,22180,,1336,0,0,0
22181,22181,,1337,0,0,0
22182,22182,,1338,0,0,0
22183,22183,,1339,0,0,0
22184,22184,,1340,0,0,0
22185,22185,,1341,0,0,0
22186,22186,,1342,0,0,0
22187,22187,,1343,0,0,0
22188,22188,,1344,0,0,0
22189,22189,,1345,0,0,0
22190,22190,,1346,0,0,0
22191,22191,,1347,0,0,0
22192,22192,,1348,0,0,0
22193,22193,,1349,0,0,0
22194,22194,,1350,0,0,0
22195,22195,,1351,0,0,0
22196,22196,,1352,0,0,0
22197,22197,,1353,0,0,0
22198,22198,,1354,0,0,0
22199,22199,,1355,0,0,0
22200,22200,,1356,0,0,0
22201,22201,,1357,0,0,0
22202,22202,,1358,0,0,0
22203,22203,,1359,0,0,0
22204,22204,,1360,0,0,0
22205,22205,,1361,0,0,0
22206,22206,,1362,0,0,0
22207,22207,,1363,0,0,0
22208,22208,,1364,0,0,0
22209,22209,,1365,0,0,0
22210,22210,,1366,0,0,0
22211,22211,,1367,0,0,0
22212,22212,,1368,0,0,0
22213,22213,,1369,0,0,0
22214,22214,,1370,0,0,0
22215,22215,,1371,0,0,0
22216,22216,,1372,0,0,0
22217,22217,,1373,0,0,0
22218,22218,,1374,0,0,0
22219,22219,,1375,0,0,0
22220,22220,,1376,0,0,0
22221,22221,,1377,0,0,0
22222,22222,,1378,0,0,0
22223,22223,,1379,0,0,0
22224,22224,,1380,0,0,0
22225,22225,,1381,0,0,0
22226,22226,,1382,0,0,0
22227,22227,,1383,0,0,0
22228,22228,,1384,0,0,0
22229,22229,,1385,0,0,0
22230,22230,,1386,0,0,0
22231,22231,,1387,0,0,0
22232,22232,,1388,0,0,0
22233,22233,,1389,0,0,0
22234,22234,,1390,0,0,0
22235,22235,,1391,0,0,0
22236,22236,,1392,0,0,0
22237,22237,,1393,0,0,0
22238,22238,,1394,0,0,0
22239,22239,,1395,0,0,0
22240,22240,,1396,0,0,0
22241,22241,,1397,0,0,0
22242,22242,,1398,0,0,0
22243,22243,,1399,0,0,0
22244,22244,,1400,0,0,0
22245,22245,,1401,0,0,0
22246,22246,,1402,0,0,0
22247,22247,,1403,0,0,0
22248,22248,,1404,0,0,0
22249,22249,,1405,0,0,0
22250,22250,,1406,0,0,0
22251,22251,,1407,0,0,0
22252,22252,,1408,0,0,0
22253,22253,,1409,0,0,0
22254,22254,,1410,0,0,0
22255,22255,,1411,0,0,0
22256,22256,,1412,0,0,0
22257,22257,,1413,0,0,0
22258,22258,,1414,0,0,0
22259,22259,,1415,0,0,0
22260,22260,,1416,0,0,0
22261,22261,,1417,0,0,0
22262,22262,,1418,0,0,0
22263,22263,,1419,0,0,0
22264,22264,,1420,0,0,0
22265,22265,,1421,0,0,0
22266,22266,,1422,0,0,0
22267,22267,,1423,0,0,0
22268,22268,,1424,0,0,0
22269,22269,,1425,0,0,0
22270,22270,,1426,0,0,0
22271,22271,,1427,0,0,0
22272,22272,,1428,0,0,0
22273,22273,,1429,0,0,0
22274,22274,,1430,0,0,0
22275,22275,,1431,0,0,0
22276,22276,,1432,0,0,0
22277,22277,,1433,0,0,0
22278,22278,,1434,0,0,0
22279,22279,,1435,0,0,0
22280,22280,,1436,0,0,0
22281,22281,,1437,0,0,0
22282,22282,,1438,0,0,0
22283,22283,,1439,0,0,0
22284,22284,,1440,0,0,0
22285,22285,,1441,0,0,0
22286,22286,,1442,0,0,0
22287,22287,,1443,0,0,0
22288,22288,,1444,0,0,0
22289,22289,,1445,0,0,0
22290,22290,,1446,0,0,0
22291,22291,,1447,0,0,0
22292,22292,,1448,0,0,0
22293,22293,,1449,0,0,0
22294,22294,,1450,0,0,0
22295,22295,,1451,0,0,0
22296,22296,,1452,0,0,0
22297,22297,,1453,0,0,0
22298,22298,,1454,0,0,0
22299,22299,,1455,0,0,0
22300,22300,,1456,0,0,0
22301,22301,,1457,0,0,0
22302,22302,,1458,0,0,0
22303,22303,,1459,0,0,0
22304,22304,,1460,0,0,0
22305,22305,,1461,0,0,0
22306,22306,,1462,0,0,0
22307,22307,,1463,0,0,0
22308,22308,,1464,0,0,0
22309,22309,,1465,0,0,0
22310,22310,,1466,0,0,0
22311,22311,,1467,0,0,0
22312,22312,,1468,0,0,0
22313,22313,,1469,0,0,0
22314,22314,,1470,0,0,0
22315,22315,,1471,0,0,0
22316,22316,,1472,0,0,0
22317,22317,,1473,0,0,0
22318,22318,,1474,0,0,0
22319,22319,,1475,0,0,0
22320,22320,,1476,0,0,0
22321,22321,,1477,0,0,0
22322,22322,,1478,0,0,0
22323,22323,,1479,0,0,0
22324,22324,,1480,0,0,0
22325,22325,,1481,0,0,0
22326,22326,,1482,0,0,0
22327,22327,,1483,0,0,0
22328,22328,,1484,0,0,0
22329,22329,,1485,0,0,0
22330,22330,,1486,0,0,0
22331,22331,,1487,0,0,0
22332,22332,,1488,0,0,0
22333,22333,,1489,0,0,0
22334,22334,,1490,0,0,0
22335,22335,,1491,0,0,0
22336,22336,,1492,0,0,0
22337,22337,,1493,0,0,0
22338,22338,,1494,0,0,0
22339,22339,,1495,0,0,0
22340,22340,,1496,0,0,0
22341,22341,,1497,0,0,0
22342,22342,,1498,0,0,0
22343,22343,,1499,0,0,0
22344,22344,,1500,0,0,0
22345,22345,,1501,0,0,0
22346,22346,,1502,0,0,0
22347,22347,,1503,0,0,0
22348,22348,,1504,0,0,0
22349,22349,,1505,0,0,0
22350,22350,,1506,0,0,0
22351,22351,,1507,0,0,0
22352,22352,,1508,0,0,0
22353,22353,,1509,0,0,0
22354,22354,,1510,0,0,0
22355,22355,,1511,0,0,0
22356,22356,,1512,0,0,0
22357,22357,,1513,0,0,0
22358,22358,,1514,0,0,0
22359,22359,,1515,0,0,0
22360,22360,,1516,0,0,0
22361,22361,,1517,0,0,0
22362,22362,,1518,0,0,0
22363,22363,,1519,0,0,0
22364,22364,,1520,0,0,0
22365,22365,,1521,0,0,0
22366,22366,,1522,0,0,0
22367,22367,,1523,0,0,0
22368,22368,,1524,0,0,0
22369,22369,,1525,0,0,0
22370,22370,,1526,0,0,0
22371,22371,,1527,0,0,0
22372,22372,,1528,0,0,0
22373,22373,,1529,0,0,0
22374,22374,,1530,0,0,0
22375,22375,,1531,0,0,0
22376,22376,,1532,0,0,0
22377,22377,,1533,0,0,0
22378,22378,,1534,0,0,0
22379,22379,,1535,0,0,0
22380,22380,,1536,0,0,0
22381,22381,,1537,0,0,0
22382,22382,,1538,0,0,0
22383,22383,,1539,0,0,0
22384,22384,,1540,0,0,0
22385,22385,,1541,0,0,0
22386,22386,,1542,0,0,0
22387,22387,,1543,0,0,0
22388,22388,,1544,0,0,0
22389,22389,,1545,0,0,0
22390,22390,,1546,0,0,0
22391,22391,,1547,0,0,0
22392,22392,,1548,0,0,0
22393,22393,,1549,0,0,0
22394,22394,,1550,0,0,0
22395,22395,,1551,0,0,0
22396,22396,,1552,0,0,0
22397,22397,,1553,0,0,0
22398,22398,,1554,0,0,0
22399,22399,,1555,0,0,0
22400,22400,,1556,0,0,0
22401,22401,,1557,0,0,0
22402,22402,,1558,0,0,0
22403,22403,,1559,0,0,0
22404,22404,,1560,0,0,0
22405,22405,,1561,0,0,0
22406,22406,,1562,0,0,0
22407,22407,,1563,0,0,0
22408,22408,,1564,0,0,0
22409,22409,,1565,0,0,0
22410,22410,,1566,0,0,0
22411,22411,,1567,0,0,0
22412,22412,,1568,0,0,0
22413,22413,,1569,0,0,0
22414,22414,,1570,0,0,0
22415,22415,,1571,0,0,0
22416,22416,,1572,0,0,0
22417,22417,,1573,0,0,0
22418,22418,,1574,0,0,0
22419,22419,,1575,0,0,0
22420,22420,,1576,0,0,0
22421,22421,,1577,0,0,0
22422,22422,,1578,0,0,0
22423,22423,,1579,0,0,0
22424,22424,,1580,0,0,0
22425,22425,,1581,0,0,0
22426,22426,,1582,0,0,0
22427,22427,,1583,0,0,0
22428,22428,,1584,0,0,0
22429,22429,,1585,0,0,0
22430,22430,,1586,0,0,0
22431,22431,,1587,0,0,0
22432,22432,,1588,0,0,0
22433,22433,,1589,0,0,0
22434,22434,,1590,0,0,0
22435,22435,,1591,0,0,0
22436,22436,,1592,0,0,0
22437,22437,,1593,0,0,0
22438,22438,,1594,0,0,0
22439,22439,,1595,0,0,0
22440,22440,,1596,0,0,0
22441,22441,,1597,0,0,0
22442,22442,,1598,0,0,0
22443,22443,,1599,0,0,0
22444,22444,,1600,0,0,0
22445,22445,,1601,0,0,0
22446,22446,,1602,0,0,0
22447,22447,,1603,0,0,0
22448,22448,,1604,0,0,0
22449,22449,,1605,0,0,0
22450,22450,,1606,0,0,0
22451,22451,,1607,0,0,0
22452,22452,,1608,0,0,0
22453,22453,,1609,0,0,0
22454,22454,,1610,0,0,0
22455,22455,,1611,0,0,0
22456,22456,,1612,0,0,0
22457,22457,,1613,0,0,0
22458,22458,,1614,0,0,0
22459,22459,,1615,0,0,0
22460,22460,,1616,0,0,0
22461,22461,,1617,0,0,0
22462,22462,,1618,0,0,0
22463,22463,,1619,0,0,0
22464,22464,,1620,0,0,0
22465,22465,,1621,0,0,0
22466,22466,,1622,0,0,0
22467,22467,,1623,0,0,0
22468,22468,,1624,0,0,0
22469,22469,,1625,0,0,0
22470,22470,,1626,0,0,0
22471,22471,,1627,0,0,0
22472,22472,,1628,0,0,0
22473,22473,,1629,0,0,0
22474,22474,,1630,0,0,0
22475,22475,,1631,0,0,0
22476,22476,,1632,0,0,0
22477,22477,,1633,0,0,0
22478,22478,,1634,0,0,0
22479,22479,,1635,0,0,0
22480,22480,,1636,0,0,0
22481,22481,,1637,0,0,0
22482,22482,,1638,0,0,0
22483,22483,,1639,0,0,0
22484,22484,,1640,0,0,0
22485,22485,,1641,0,0,0
22486,22486,,1642,0,0,0
22487,22487,,1643,0,0,0
22488,22488,,1644,0,0,0
22489,22489,,1645,0,0,0
22490,22490,,1646,0,0,0
22491,22491,,1647,0,0,0
22492,22492,,1648,0,0,0
22493,22493,,1649,0,0,0
22494,22494,,1650,0,0,0
22495,22495,,1651,0,0,0
22496,22496,,1652,0,0,0
22497,22497,,1653,0,0,0
22498,22498,,1654,0,0,0
22499,22499,,1655,0,0,0
22500,22500,,1656,0,0,0
22501,22501,,1657,0,0,0
22502,22502,,1658,0,0,0
22503,22503,,1659,0,0,0
22504,22504,,1660,0,0,0
22505,22505,,1661,0,0,0
22506,22506,,1662,0,0,0
22507,22507,,1663,0,0,0
22508,22508,,1664,0,0,0
22509,22509,,1665,0,0,0
22510,22510,,1666,0,0,0
22511,22511,,1667,0,0,0
22512,22512,,1668,0,0,0
22513,22513,,1669,0,0,0
22514,22514,,1670,0,0,0
22515,22515,,1671,0,0,0
22516,22516,,1672,0,0,0
22517,22517,,1673,0,0,0
22518,22518,,1674,0,0,0
22519,22519,,1675,0,0,0
22520,22520,,1676,0,0,0
22521,22521,,1677,0,0,0
22522,22522,,1678,0,0,0
22523,22523,,1679,0,0,0
22524,22524,,1680,0,0,0
22525,22525,,1681,0,0,0
22526,22526,,1682,0,0,0
22527,22527,,1683,0,0,0
22528,22528,,1684,0,0,0
22529,22529,,1685,0,0,0
22530,22530,,1686,0,0,0
22531,22531,,1687,0,0,0
22532,22532,,1688,0,0,0
22533,22533,,1689,0,0,0
22534,22534,,1690,0,0,0
22535,22535,,1691,0,0,0
22536,22536,,1692,0,0,0
22537,22537,,1693,0,0,0
22538,22538,,1694,0,0,0
22539,22539,,1695,0,0,0
22540,22540,,1696,0,0,0
22541,22541,,1697,0,0,0
22542,22542,,1698,0,0,0
22543,22543,,1699,0,0,0
22544,22544,,1700,0,0,0
22545,22545,,1701,0,0,0
22546,22546,,1702,0,0,0
22547,22547,,1703,0,0,0
22548,22548,,1704,0,0,0
22549,22549,,1705,0,0,0
22550,22550,,1706,0,0,0
22551,22551,,1707,0,0,0
22552,22552,,1708,0,0,0
22553,22553,,1709,0,0,0
22554,22554,,1710,0,0,0
22555,22555,,1711,0,0,0
22556,22556,,1712,0,0,0
22557,22557,,1713,0,0,0
22558,22558,,1714,0,0,0
22559,22559,,1715,0,0,0
22560,22560,,1716,0,0,0
22561,22561,,1717,0,0,0
22562,22562,,1718,0,0,0
22563,22563,,1719,0,0,0
22564,22564,,1720,0,0,0
22565,22565,,1721,0,0,0
22566,22566,,1722,0,0,0
22567,22567,,1723,0,0,0
22568,22568,,1724,0,0,0
22569,22569,,1725,0,0,0
22570,22570,,1726,0,0,0
22571,22571,,1727,0,0,0
22572,22572,,1728,0,0,0
22573,22573,,1729,0,0,0
22574,22574,,1730,0,0,0
22575,22575,,1731,0,0,0
22576,22576,,1732,0,0,0
22577,22577,,1733,0,0,0
22578,22578,,1734,0,0,0
22579,22579,,1735,0,0,0
22580,22580,,1736,0,0,0
22581,22581,,1737,0,0,0
22582,22582,,1738,0,0,0
22583,22583,,1739,0,0,0
22584,22584,,1740,0,0,0
22585,22585,,1741,0,0,0
22586,22586,,1742,0,0,0
22587,22587,,1743,0,0,0
22588,22588,,1744,0,0,0
22589,22589,,1745,0,0,0
22590,22590,,1746,0,0,0
22591,22591,,1747,0,0,0
22592,22592,,1748,0,0,0
22593,22593,,1749,0,0,0
22594,22594,,1750,0,0,0
22595,22595,,1751,0,0,0
22596,22596,,1752,0,0,0
22597,22597,,1753,0,0,0
22598,22598,,1754,0,0,0
22599,22599,,1755,0,0,0
22600,22600,,1756,0,0,0
22601,22601,,1757,0,0,0
22602,22602,,1758,0,0,0
22603,22603,,1759,0,0,0
22604,22604,,1760,0,0,0
22605,22605,,1761,0,0,0
22606,22606,,1762,0,0,0
22607,22607,,1763,0,0,0
22608,22608,,1764,0,0,0
22609,22609,,1765,0,0,0
22610,22610,,1766,0,0,0
22611,22611,,1767,0,0,0
22612,22612,,1768,0,0,0
22613,22613,,1769,0,0,0
22614,22614,,1770,0,0,0
22615,22615,,1771,0,0,0
22616,22616,,1772,0,0,0
22617,22617,,1773,0,0,0
22618,22618,,1774,0,0,0
22619,22619,,1775,0,0,0
22620,22620,,1776,0,0,0
22621,22621,,1777,0,0,0
22622,22622,,1778,0,0,0
22623,22623,,1779,0,0,0
22624,22624,,1780,0,0,0
22625,22625,,1781,0,0,0
22626,22626,,1782,0,0,0
22627,22627,,1783,0,0,0
22628,22628,,1784,0,0,0
22629,22629,,1785,0,0,0
22630,22630,,1786,0,0,0
22631,22631,,1787,0,0,0
22632,22632,,1788,0,0,0
22633,22633,,1789,0,0,0
22634,22634,,1790,0,0,0
22635,22635,,1791,0,0,0
22636,22636,,1792,0,0,0
22637,22637,,1793,0,0,0
22638,22638,,1794,0,0,0
22639,22639,,1795,0,0,0
22640,22640,,1796,0,0,0
22641,22641,,1797,0,0,0
22642,22642,,1798,0,0,0
22643,22643,,1799,0,0,0
22644,22644,,1800,0,0,0
22645,22645,,1801,0,0,0
22646,22646,,1802,0,0,0
22647,22647,,1803,0,0,0
22648,22648,,1804,0,0,0
22649,22649,,1805,0,0,0
22650,22650,,1806,0,0,0
22651,22651,,1807,0,0,0
22652,22652,,1808,0,0,0
22653,22653,,1809,0,0,0
22654,22654,,1810,0,0,0
22655,22655,,1811,0,0,0
22656,22656,,1812,0,0,0
22657,22657,,1813,0,0,0
22658,22658,,1814,0,0,0
22659,22659,,1815,0,0,0
22660,22660,,1816,0,0,0
22661,22661,,1817,0,0,0
22662,22662,,1818,0,0,0
22663,22663,,1819,0,0,0
22664,22664,,1820,0,0,0
22665,22665,,1821,0,0,0
22666,22666,,1822,0,0,0
22667,22667,,1823,0,0,0
22668,22668,,1824,0,0,0
22669,22669,,1825,0,0,0
22670,22670,,1826,0,0,0
22671,22671,,1827,0,0,0
22672,22672,,1828,0,0,0
22673,22673,,1829,0,0,0
22674,22674,,1830,0,0,0
22675,22675,,1831,0,0,0
22676,22676,,1832,0,0,0
22677,22677,,1833,0,0,0
22678,22678,,1834,0,0,0
22679,22679,,1835,0,0,0
22680,22680,,1836,0,0,0
22681,22681,,1837,0,0,0
22682,22682,,1838,0,0,0
22683,22683,,1839,0,0,0
22684,22684,,1840,0,0,0
22685,22685,,1841,0,0,0
22686,22686,,1842,0,0,0
22687,22687,,1843,0,0,0
22688,22688,,1844,0,0,0
22689,22689,,1845,0,0,0
22690,22690,,1846,0,0,0
22691,22691,,1847,0,0,0
22692,22692,,1848,0,0,0
22693,22693,,1849,0,0,0
22694,22694,,1850,0,0,0
22695,22695,,1851,0,0,0
22696,22696,,1852,0,0,0
22697,22697,,1853,0,0,0
22698,22698,,1854,0,0,0
22699,22699,,1855,0,0,0
22700,22700,,1856,0,0,0
22701,22701,,1857,0,0,0
22702,22702,,1858,0,0,0
22703,22703,,1859,0,0,0
22704,22704,,1860,0,0,0
22705,22705,,1861,0,0,0
22706,22706,,1862,0,0,0
22707,22707,,1863,0,0,0
22708,22708,,1864,0,0,0
22709,22709,,1865,0,0,0
22710,22710,,1866,0,0,0
22711,22711,,1867,0,0,0
22712,22712,,1868,0,0,0
22713,22713,,1869,0,0,0
22714,22714,,1870,0,0,0
22715,22715,,1871,0,0,0
22716,22716,,1872,0,0,0
22717,22717,,1873,0,0,0
22718,22718,,1874,0,0,0
22719,22719,,1875,0,0,0
22720,22720,,1876,0,0,0
22721,22721,,1877,0,0,0
22722,22722,,1878,0,0,0
22723,22723,,1879,0,0,0
22724,22724,,1880,0,0,0
22725,22725,,1881,0,0,0
22726,22726,,1882,0,0,0
22727,22727,,1883,0,0,0
22728,22728,,1884,0,0,0
22729,22729,,1885,0,0,0
22730,22730,,1886,0,0,0
22731,22731,,1887,0,0,0
22732,22732,,1888,0,0,0
22733,22733,,1889,0,0,0
22734,22734,,1890,0,0,0
22735,22735,,1891,0,0,0
22736,22736,,1892,0,0,0
22737,22737,,1893,0,0,0
22738,22738,,1894,0,0,0
22739,22739,,1895,0,0,0
22740,22740,,1896,0,0,0
22741,22741,,1897,0,0,0
22742,22742,,1898,0,0,0
22743,22743,,1899,0,0,0
22744,22744,,1900,0,0,0
22745,22745,,1901,0,0,0
22746,22746,,1902,0,0,0
22747,22747,,1903,0,0,0
22748,22748,,1904,0,0,0
22749,22749,,1905,0,0,0
22750,22750,,1906,0,0,0
22751,22751,,1907,0,0,0
22752,22752,,1908,0,0,0
22753,22753,,1909,0,0,0
22754,22754,,1910,0,0,0
22755,22755,,1911,0,0,0
22756,22756,,1912,0,0,0
22757,22757,,1913,0,0,0
22758,22758,,1914,0,0,0
22759,22759,,1915,0,0,0
22760,22760,,1916,0,0,0
22761,22761,,1917,0,0,0
22762,22762,,1918,0,0,0
22763,22763,,1919,0,0,0
22764,22764,,1920,0,0,0
22765,22765,,1921,0,0,0
22766,22766,,1922,0,0,0
22767,22767,,1923,0,0,0
22768,22768,,1924,0,0,0
22769,22769,,1925,0,0,0
22770,22770,,1926,0,0,0
22771,22771,,1927,0,0,0
22772,22772,,1928,0,0,0
22773,22773,,1929,0,0,0
22774,22774,,1930,0,0,0
22775,22775,,1931,0,0,0
22776,22776,,1932,0,0,0
22777,22777,,1933,0,0,0
22778,22778,,1934,0,0,0
22779,22779,,1935,0,0,0
22780,22780,,1936,0,0,0
22781,22781,,1937,0,0,0
22782,22782,,1938,0,0,0
22783,22783,,1939,0,0,0
22784,22784,,1940,0,0,0
22785,22785,,1941,0,0,0
22786,22786,,1942,0,0,0
22787,22787,,1943,0,0,0
22788,22788,,1944,0,0,0
22789,22789,,1945,0,0,0
22790,22790,,1946,0,0,0
22791,22791,,1947,0,0,0
22792,22792,,1948,0,0,0
22793,22793,,1949,0,0,0
22794,22794,,1950,0,0,0
22795,22795,,1951,0,0,0
22796,22796,,1952,0,0,0
22797,22797,,1953,0,0,0
22798,22798,,1954,0,0,0
22799,22799,,1955,0,0,0
22800,22800,,1956,0,0,0
22801,22801,,1957,0,0,0
22802,22802,,1958,0,0,0
22803,22803,,1959,0,0,0
22804,22804,,1960,0,0,0
22805,22805,,1961,0,0,0
22806,22806,,1962,0,0,0
22807,22807,,1963,0,0,0
22808,22808,,1964,0,0,0
22809,22809,,1965,0,0,0
22810,22810,,1966,0,0,0
22811,22811,,1967,0,0,0
22812,22812,,1968,0,0,0
22813,22813,,1969,0,0,0
22814,22814,,1970,0,0,0
22815,22815,,1971,0,0,0
22816,22816,,1972,0,0,0
22817,22817,,1973,0,0,0
22818,22818,,1974,0,0,0
22819,22819,,1975,0,0,0
22820,22820,,1976,0,0,0
22821,22821,,1977,0,0,0
22822,22822,,1978,0,0,0
22823,22823,,1979,0,0,0
22824,22824,,1980,0,0,0
22825,22825,,1981,0,0,0
22826,22826,,1982,0,0,0
22827,22827,,1983,0,0,0
22828,22828,,1984,0,0,0
22829,22829,,1985,0,0,0
22830,22830,,1986,0,0,0
22831,22831,,1987,0,0,0
22832,22832,,1988,0,0,0
22833,22833,,1989,0,0,0
22834,22834,,1990,0,0,0
22835,22835,,1991,0,0,0
22836,22836,,1992,0,0,0
22837,22837,,1993,0,0,0
22838,22838,,1994,0,0,0
22839,22839,,1995,0,0,0
22840,22840,,1996,0,0,0
22841,22841,,1997,0,0,0
22842,22842,,1998,0,0,0
22843,22843,,1999,0,0,0
22844,22844,,2000,0,0,0
22845,22845,,2001,0,0,0
22846,22846,,2002,0,0,0
22847,22847,,2003,0,0,0
22848,22848,,2004,0,0,0
22849,22849,,2005,0,0,0
22850,22850,,2006,0,0,0
22851,22851,,2007,0,0,0
22852,22852,,2008,0,0,0
22853,22853,,2009,0,0,0
22854,22854,,2010,0,0,0
22855,22855,,2011,0,0,0
22856,22856,,2012,0,0,0
22857,22857,,2013,0,0,0
22858,22858,,2014,0,0,0
22859,22859,,2015,0,0,0
22860,22860,,2016,0,0,0
22861,22861,,2017,0,0,0
22862,22862,,2018,0,0,0
22863,22863,,2019,0,0,0
22864,22864,,2020,0,0,0
22865,22865,,2021,0,0,0
22866,22866,,2022,0,0,0
22867,22867,,2023,0,0,0
22868,22868,,2024,0,0,0
22869,22869,,2025,0,0,0
22870,22870,,2026,0,0,0
22871,22871,,2027,0,0,0
22872,22872,,2028,0,0,0
22873,22873,,2029,0,0,0
22874,22874,,2030,0,0,0
22875,22875,,2031,0,0,0
22876,22876,,2032,0,0,0
22877,22877,,2033,0,0,0
22878,22878,,2034,0,0,0
22879,22879,,2035,0,0,0
22880,22880,,2036,0,0,0
22881,22881,,2037,0,0,0
22882,22882,,2038,0,0,0
22883,22883,,2039,0,0,0
22884,22884,,2040,0,0,0
22885,22885,,2041,0,0,0
22886,22886,,2042,0,0,0
22887,22887,,2043,0,0,0
22888,22888,,2044,0,0,0
22889,22889,,2045,0,0,0
22890,22890,,2046,0,0,0
22891,22891,,2047,0,0,0
22892,22892,,2048,0,0,0
22893,22893,,2049,0,0,0
22894,22894,,2050,0,0,0
22895,22895,,2051,0,0,0
22896,22896,,2052,0,0,0
22897,22897,,2053,0,0,0
22898,22898,,2054,0,0,0
22899,22899,,2055,0,0,0
22900,22900,,2056,0,0,0
22901,22901,,2057,0,0,0
22902,22902,,2058,0,0,0
22903,22903,,2059,0,0,0
22904,22904,,2060,0,0,0
22905,22905,,2061,0,0,0
22906,22906,,2062,0,0,0
22907,22907,,2063,0,0,0
22908,22908,,2064,0,0,0
22909,22909,,2065,0,0,0
22910,22910,,2066,0,0,0
22911,22911,,2067,0,0,0
22912,22912,,2068,0,0,0
22913,22913,,2069,0,0,0
22914,22914,,2070,0,0,0
22915,22915,,2071,0,0,0
22916,22916,,2072,0,0,0
22917,22917,,2073,0,0,0
22918,22918,,2074,0,0,0
22919,22919,,2075,0,0,0
22920,22920,,2076,0,0,0
22921,22921,,2077,0,0,0
22922,22922,,2078,0,0,0
22923,22923,,2079,0,0,0
22924,22924,,2080,0,0,0
22925,22925,,2081,0,0,0
22926,22926,,2082,0,0,0
22927,22927,,2083,0,0,0
22928,22928,,2084,0,0,0
22929,22929,,2085,0,0,0
22930,22930,,2086,0,0,0
22931,22931,,2087,0,0,0
22932,22932,,2088,0,0,0
22933,22933,,2089,0,0,0
22934,22934,,2090,0,0,0
22935,22935,,2091,0,0,0
22936,22936,,2092,0,0,0
22937,22937,,2093,0,0,0
22938,22938,,2094,0,0,0
22939,22939,,2095,0,0,0
22940,22940,,2096,0,0,0
22941,22941,,2097,0,0,0
22942,22942,,2098,0,0,0
22943,22943,,2099,0,0,0
22944,22944,,2100,0,0,0
22945,22945,,2101,0,0,0
22946,22946,,2102,0,0,0
22947,22947,,2103,0,0,0
22948,22948,,2104,0,0,0
22949,22949,,2105,0,0,0
22950,22950,,2106,0,0,0
22951,22951,,2107,0,0,0
22952,22952,,2108,0,0,0
22953,22953,,2109,0,0,0
22954,22954,,2110,0,0,0
22955,22955,,2111,0,0,0
22956,22956,,2112,0,0,0
22957,22957,,2113,0,0,0
22958,22958,,2114,0,0,0
22959,22959,,2115,0,0,0
22960,22960,,2116,0,0,0
22961,22961,,2117,0,0,0
22962,22962,,2118,0,0,0
22963,22963,,2119,0,0,0
22964,22964,,2120,0,0,0
22965,22965,,2121,0,0,0
22966,22966,,2122,0,0,0
22967,22967,,2123,0,0,0
22968,22968,,2124,0,0,0
22969,22969,,2125,0,0,0
22970,22970,,2126,0,0,0
22971,22971,,2127,0,0,0
22972,22972,,2128,0,0,0
22973,22973,,2129,0,0,0
22974,22974,,2130,0,0,0
22975,22975,,2131,0,0,0
22976,22976,,2132,0,0,0
22977,22977,,2133,0,0,0
22978,22978,,2134,0,0,0
22979,22979,,2135,0,0,0
22980,22980,,2136,0,0,0
22981,22981,,2137,0,0,0
22982,22982,,2138,0,0,0
22983,22983,,2139,0,0,0
22984,22984,,2140,0,0,0
22985,22985,,2141,0,0,0
22986,22986,,2142,0,0,0
22987,22987,,2143,0,0,0
22988,22988,,2144,0,0,0
22989,22989,,2145,0,0,0
22990,22990,,2146,0,0,0
22991,22991,,2147,0,0,0
22992,22992,,2148,0,0,0
22993,22993,,2149,0,0,0
22994,22994,,2150,0,0,0
22995,22995,,2151,0,0,0
22996,22996,,2152,0,0,0
22997,22997,,2153,0,0,0
22998,22998,,2154,0,0,0
22999,22999,,2155,0,0,0
23000,23000,,2156,0,0,0
23001,23001,,2157,0,0,0
23002,23002,,2158,0,0,0
23003,23003,,2159,0,0,0
23004,23004,,2160,0,0,0
23005,23005,,2161,0,0,0
23006,23006,,2162,0,0,0
23007,23007,,2163,0,0,0
23008,23008,,2164,0,0,0
23009,23009,,2165,0,0,0
23010,23010,,2166,0,0,0
23011,23011,,2167,0,0,0
23012,23012,,2168,0,0,0
23013,23013,,2169,0,0,0
23014,23014,,2170,0,0,0
23015,23015,,2171,0,0,0
23016,23016,,2172,0,0,0
23017,23017,,2173,0,0,0
23018,23018,,2174,0,0,0
23019,23019,,2175,0,0,0
23020,23020,,2176,0,0,0
23021,23021,,2177,0,0,0
23022,23022,,2178,0,0,0
23023,23023,,2179,0,0,0
23024,23024,,2180,0,0,0
23025,23025,,2181,0,0,0
23026,23026,,2182,0,0,0
23027,23027,,2183,0,0,0
23028,23028,,2184,0,0,0
23029,23029,,2185,0,0,0
23030,23030,,2186,0,0,0
23031,23031,,2187,0,0,0
23032,23032,,2188,0,0,0
