Id,Label,timeset,indegree,outdegree,degree,modularity_class
0,0,,2709,2015,4724,3
1,1,,2666,1317,3983,4
2,2,,1792,1068,2860,18
3,3,,1590,886,2476,9
4,4,,944,1626,2570,3
5,5,,1517,1077,2594,3
6,6,,1026,1486,2512,5
7,7,,1202,1071,2273,3
8,8,,1464,554,2018,4
9,9,,1303,457,1760,18
10,10,,947,724,1671,94
11,11,,973,763,1736,3
12,12,,733,904,1637,5
13,13,,470,800,1270,3
14,14,,489,814,1303,4
15,15,,792,334,1126,1
16,16,,657,428,1085,7
17,17,,853,224,1077,0
18,18,,689,346,1035,14
19,19,,252,760,1012,0
20,20,,593,373,966,3
21,21,,373,490,863,5
22,22,,347,497,844,5
23,23,,458,319,777,3
24,24,,446,278,724,1
25,25,,335,384,719,4
26,26,,341,379,720,4
27,27,,271,419,690,94
28,28,,270,386,656,18
29,29,,335,342,677,33
30,30,,417,244,661,3
31,31,,464,225,689,14
32,32,,247,356,603,7
33,33,,279,263,542,1
34,34,,334,261,595,8
35,35,,272,341,613,3
36,36,,453,83,536,7
37,37,,322,234,556,5
38,38,,180,337,517,5
39,39,,207,316,523,3
40,40,,230,305,535,1
41,41,,219,203,422,5
42,42,,239,312,551,4
43,43,,323,187,510,5
44,44,,62,408,470,9
45,45,,113,342,455,3
46,46,,191,215,406,4
47,47,,156,242,398,9
48,48,,104,305,409,18
49,49,,223,184,407,105
50,50,,221,153,374,3
51,51,,143,271,414,7
52,52,,129,264,393,18
53,53,,262,151,413,5
54,54,,201,200,401,5
55,55,,259,129,388,8
56,56,,246,128,374,9
57,57,,280,126,406,5
58,58,,227,108,335,4
59,59,,159,250,409,4
60,60,,269,98,367,3
61,61,,270,83,353,27
62,62,,144,218,362,1
63,63,,213,160,373,5
64,64,,230,129,359,5
65,65,,159,223,382,14
66,66,,232,126,358,33
67,67,,224,116,340,22
68,68,,207,175,382,1
69,69,,164,140,304,3
70,70,,193,123,316,5
71,71,,99,242,341,3
72,72,,115,150,265,22
73,73,,193,127,320,94
74,74,,107,203,310,33
75,75,,126,153,279,3
76,76,,94,201,295,18
77,77,,137,129,266,4
78,78,,173,122,295,6
79,79,,138,147,285,1
80,80,,156,116,272,14
81,81,,246,53,299,33
82,82,,183,115,298,4
83,83,,127,163,290,1
84,84,,120,162,282,1
85,85,,169,165,334,1
86,86,,155,93,248,3
87,87,,91,206,297,4
88,88,,110,134,244,4
89,89,,194,97,291,4
90,90,,136,93,229,18
91,91,,95,85,180,2
92,92,,214,62,276,32
93,93,,48,211,259,32
94,94,,76,207,283,14
95,95,,127,98,225,4
96,96,,126,101,227,3
97,97,,65,168,233,22
98,98,,106,152,258,3
99,99,,175,83,258,16
100,100,,102,195,297,14
101,101,,76,93,169,2
102,102,,99,124,223,9
103,103,,91,97,188,5
104,104,,126,89,215,7
105,105,,135,97,232,18
106,106,,42,162,204,18
107,107,,147,98,245,5
108,108,,191,35,226,3
109,109,,70,108,178,3
110,110,,90,135,225,7
111,111,,115,112,227,5
112,112,,112,107,219,3
113,113,,79,129,208,3
114,114,,129,55,184,22
115,115,,65,132,197,7
116,116,,111,79,190,4
117,117,,130,97,227,4
118,118,,98,106,204,77
119,119,,38,165,203,0
120,120,,138,76,214,78
121,121,,144,63,207,32
122,122,,74,105,179,27
123,123,,87,114,201,22
124,124,,99,124,223,9
125,125,,136,61,197,78
126,126,,121,65,186,105
127,127,,79,114,193,5
128,128,,113,102,215,14
129,129,,173,28,201,1
130,130,,117,70,187,4
131,131,,77,103,180,22
132,132,,119,104,223,1
133,133,,84,128,212,4
134,134,,70,93,163,5
135,135,,80,74,154,3
136,136,,147,34,181,18
137,137,,137,69,206,105
138,138,,106,89,195,4
139,139,,76,60,136,3
140,140,,114,89,203,105
141,141,,64,84,148,3
142,142,,1,191,192,4
143,143,,70,119,189,3
144,144,,48,137,185,4
145,145,,81,98,179,5
146,146,,125,56,181,105
147,147,,64,116,180,3
148,148,,67,50,117,4
149,149,,18,130,148,3
150,150,,50,105,155,27
151,151,,122,24,146,0
152,152,,28,122,150,4
153,153,,74,100,174,3
154,154,,32,109,141,9
155,155,,113,27,140,22
156,156,,103,49,152,10
157,157,,72,83,155,3
158,158,,66,102,168,5
159,159,,49,44,93,27
160,160,,66,83,149,9
161,161,,49,52,101,1
162,162,,25,123,148,3
163,163,,50,45,95,3
164,164,,91,33,124,9
165,165,,28,104,132,7
166,166,,28,117,145,32
167,167,,38,91,129,1
168,168,,71,66,137,3
169,169,,60,28,88,3
170,170,,41,92,133,8
171,171,,58,90,148,1
172,172,,104,31,135,6
173,173,,98,41,139,5
174,174,,76,58,134,1
175,175,,88,61,149,7
176,176,,20,119,139,14
177,177,,87,44,131,9
178,178,,38,37,75,5
179,179,,75,55,130,4
180,180,,100,40,140,34
181,181,,29,64,93,1
182,182,,81,71,152,5
183,183,,64,74,138,94
184,184,,91,42,133,0
185,185,,39,98,137,3
186,186,,73,63,136,6
187,187,,102,23,125,5
188,188,,73,44,117,9
189,189,,72,33,105,78
190,190,,107,22,129,77
191,191,,45,66,111,9
192,192,,78,45,123,18
193,193,,11,121,132,3
194,194,,63,59,122,18
195,195,,66,58,124,6
196,196,,72,42,114,19
197,197,,43,81,124,18
198,198,,65,70,135,16
199,199,,35,49,84,18
200,200,,68,52,120,4
201,201,,41,48,89,9
202,202,,68,45,113,4
203,203,,24,68,92,4
204,204,,49,63,112,6
205,205,,32,76,108,18
206,206,,7,96,103,4
207,207,,12,81,93,4
208,208,,40,71,111,3
209,209,,28,84,112,14
210,210,,64,35,99,19
211,211,,93,26,119,27
212,212,,44,81,125,3
213,213,,47,51,98,9
214,214,,42,61,103,0
215,215,,23,87,110,78
216,216,,33,64,97,3
217,217,,65,47,112,105
218,218,,32,81,113,4
219,219,,55,46,101,5
220,220,,66,40,106,94
221,221,,26,86,112,8
222,222,,67,41,108,94
223,223,,57,48,105,33
224,224,,30,78,108,78
225,225,,23,59,82,9
226,226,,43,39,82,27
227,227,,59,46,105,1
228,228,,36,63,99,18
229,229,,71,31,102,3
230,230,,28,72,100,33
231,231,,42,43,85,22
232,232,,56,49,105,94
233,233,,59,55,114,5
234,234,,60,45,105,78
235,235,,82,26,108,3
236,236,,24,56,80,3
237,237,,36,65,101,10
238,238,,54,43,97,4
239,239,,32,37,69,18
240,240,,25,76,101,3
241,241,,53,30,83,18
242,242,,66,24,90,105
243,243,,34,69,103,105
244,244,,35,59,94,5
245,245,,35,64,99,4
246,246,,29,59,88,22
247,247,,35,71,106,5
248,248,,22,70,92,4
249,249,,47,52,99,5
250,250,,6,88,94,8
251,251,,32,60,92,18
252,252,,73,15,88,18
253,253,,18,83,101,105
254,254,,41,49,90,1
255,255,,30,59,89,7
256,256,,28,56,84,3
257,257,,40,47,87,4
258,258,,19,27,46,1
259,259,,32,57,89,5
260,260,,27,54,81,33
261,261,,32,26,58,3
262,262,,67,27,94,94
263,263,,45,51,96,9
264,264,,48,48,96,3
265,265,,68,8,76,9
266,266,,71,35,106,1
267,267,,34,46,80,4
268,268,,51,39,90,77
269,269,,30,61,91,8
270,270,,46,44,90,7
271,271,,31,47,78,22
272,272,,57,40,97,9
273,273,,12,76,88,8
274,274,,29,49,78,4
275,275,,48,45,93,9
276,276,,55,36,91,5
277,277,,33,65,98,27
278,278,,25,54,79,14
279,279,,59,22,81,3
280,280,,67,35,102,1
281,281,,21,64,85,18
282,282,,47,25,72,24
283,283,,9,70,79,3
284,284,,62,23,85,4
285,285,,35,46,81,77
286,286,,35,42,77,4
287,287,,72,18,90,5
288,288,,12,24,36,22
289,289,,37,51,88,77
290,290,,62,29,91,16
291,291,,59,35,94,4
292,292,,26,49,75,22
293,293,,34,48,82,5
294,294,,27,42,69,9
295,295,,23,60,83,94
296,296,,56,37,93,105
297,297,,47,29,76,18
298,298,,50,22,72,8
299,299,,34,41,75,5
300,300,,22,55,77,33
301,301,,36,38,74,3
302,302,,30,57,87,8
303,303,,17,22,39,5
304,304,,28,55,83,94
305,305,,62,29,91,1
306,306,,29,26,55,22
307,307,,17,57,74,18
308,308,,12,61,73,7
309,309,,23,48,71,18
310,310,,42,47,89,34
311,311,,44,38,82,8
312,312,,50,28,78,3
313,313,,48,36,84,33
314,314,,31,36,67,3
315,315,,36,48,84,94
316,316,,31,42,73,4
317,317,,41,47,88,1
318,318,,9,29,38,14
319,319,,49,30,79,18
320,320,,34,38,72,9
321,321,,29,51,80,94
322,322,,24,43,67,6
323,323,,54,27,81,9
324,324,,29,39,68,18
325,325,,45,32,77,9
326,326,,44,31,75,18
327,327,,39,37,76,18
328,328,,25,38,63,5
329,329,,34,46,80,3
330,330,,19,52,71,18
331,331,,41,42,83,18
332,332,,15,63,78,5
333,333,,36,35,71,9
334,334,,18,44,62,1
335,335,,53,20,73,33
336,336,,52,27,79,1
337,337,,19,31,50,2
338,338,,22,33,55,1
339,339,,45,23,68,7
340,340,,55,10,65,7
341,341,,22,41,63,18
342,342,,26,25,51,5
343,343,,34,34,68,6
344,344,,21,44,65,1
345,345,,35,38,73,8
346,346,,22,23,45,9
347,347,,29,36,65,5
348,348,,38,34,72,4
349,349,,25,50,75,27
350,350,,31,21,52,16
351,351,,18,57,75,19
352,352,,37,38,75,1
353,353,,45,18,63,3
354,354,,11,63,74,4
355,355,,40,19,59,5
356,356,,28,51,79,1
357,357,,13,50,63,5
358,358,,21,42,63,3
359,359,,18,52,70,18
360,360,,43,20,63,14
361,361,,28,48,76,4
362,362,,14,56,70,27
363,363,,35,31,66,8
364,364,,45,18,63,7
365,365,,61,6,67,3
366,366,,33,44,77,3
367,367,,33,33,66,3
368,368,,38,32,70,9
369,369,,21,44,65,3
370,370,,28,43,71,105
371,371,,27,40,67,3
372,372,,38,22,60,3
373,373,,19,46,65,8
374,374,,7,53,60,0
375,375,,21,25,46,4
376,376,,29,31,60,22
377,377,,28,34,62,4
378,378,,40,31,71,1
379,379,,8,58,66,14
380,380,,24,33,57,24
381,381,,30,39,69,4
382,382,,45,20,65,4
383,383,,26,36,62,77
384,384,,22,37,59,3
385,385,,18,39,57,7
386,386,,33,36,69,5
387,387,,19,44,63,27
388,388,,26,33,59,3
389,389,,20,47,67,16
390,390,,27,39,66,32
391,391,,27,33,60,16
392,392,,61,8,69,4
393,393,,26,44,70,3
394,394,,32,28,60,16
395,395,,22,30,52,5
396,396,,30,35,65,4
397,397,,24,29,53,77
398,398,,9,47,56,14
399,399,,40,18,58,8
400,400,,31,26,57,4
401,401,,38,10,48,22
402,402,,10,22,32,78
403,403,,24,38,62,94
404,404,,25,27,52,77
405,405,,28,24,52,33
406,406,,41,27,68,14
407,407,,8,54,62,24
408,408,,21,33,54,1
409,409,,47,8,55,105
410,410,,20,32,52,4
411,411,,36,24,60,1
412,412,,2,58,60,4
413,413,,12,47,59,18
414,414,,13,31,44,4
415,415,,25,27,52,105
416,416,,9,42,51,4
417,417,,8,49,57,7
418,418,,17,37,54,8
419,419,,18,34,52,4
420,420,,15,36,51,18
421,421,,12,42,54,22
422,422,,26,29,55,94
423,423,,22,32,54,5
424,424,,44,18,62,94
425,425,,21,36,57,105
426,426,,35,20,55,18
427,427,,30,34,64,8
428,428,,20,35,55,7
429,429,,16,27,43,4
430,430,,13,44,57,3
431,431,,24,18,42,9
432,432,,8,30,38,3
433,433,,34,5,39,5
434,434,,21,34,55,18
435,435,,21,34,55,3
436,436,,33,24,57,1
437,437,,35,20,55,3
438,438,,35,18,53,16
439,439,,13,24,37,4
440,440,,24,34,58,22
441,441,,38,15,53,3
442,442,,18,36,54,4
443,443,,16,27,43,77
444,444,,13,42,55,27
445,445,,16,29,45,7
446,446,,24,34,58,6
447,447,,29,27,56,4
448,448,,32,14,46,5
449,449,,22,41,63,4
450,450,,39,16,55,57
451,451,,14,44,58,3
452,452,,20,40,60,14
453,453,,11,42,53,33
454,454,,27,31,58,3
455,455,,23,29,52,4
456,456,,6,52,58,14
457,457,,31,26,57,34
458,458,,37,22,59,5
459,459,,35,18,53,94
460,460,,20,17,37,22
461,461,,18,33,51,5
462,462,,18,36,54,3
463,463,,33,17,50,3
464,464,,23,36,59,1
465,465,,27,26,53,3
466,466,,15,27,42,27
467,467,,34,18,52,18
468,468,,16,32,48,82
469,469,,20,30,50,5
470,470,,41,11,52,5
471,471,,33,20,53,19
472,472,,23,20,43,3
473,473,,30,23,53,18
474,474,,14,38,52,3
475,475,,24,33,57,14
476,476,,23,24,47,18
477,477,,15,26,41,4
478,478,,11,36,47,1
479,479,,5,43,48,9
480,480,,39,11,50,14
481,481,,27,11,38,94
482,482,,36,16,52,5
483,483,,18,37,55,5
484,484,,20,36,56,4
485,485,,23,28,51,3
486,486,,9,33,42,78
487,487,,23,26,49,5
488,488,,3,46,49,3
489,489,,8,32,40,9
490,490,,9,41,50,4
491,491,,26,18,44,8
492,492,,21,13,34,22
493,493,,10,37,47,10
494,494,,22,24,46,5
495,495,,17,29,46,105
496,496,,14,29,43,4
497,497,,24,16,40,3
498,498,,15,27,42,18
499,499,,16,28,44,5
500,500,,18,20,38,3
501,501,,27,17,44,27
502,502,,22,25,47,8
503,503,,12,25,37,3
504,504,,14,24,38,27
505,505,,16,36,52,3
506,506,,23,30,53,5
507,507,,14,37,51,8
508,508,,30,14,44,94
509,509,,14,31,45,3
510,510,,16,32,48,4
511,511,,35,5,40,32
512,512,,24,17,41,7
513,513,,9,24,33,94
514,514,,14,27,41,77
515,515,,21,20,41,5
516,516,,19,25,44,22
517,517,,19,29,48,3
518,518,,26,19,45,19
519,519,,10,34,44,4
520,520,,17,22,39,4
521,521,,13,15,28,9
522,522,,21,25,46,1
523,523,,29,23,52,4
524,524,,17,17,34,9
525,525,,33,18,51,1
526,526,,22,28,50,7
527,527,,19,28,47,0
528,528,,13,22,35,4
529,529,,20,29,49,16
530,530,,25,26,51,32
531,531,,19,28,47,9
532,532,,21,30,51,3
533,533,,24,22,46,14
534,534,,35,11,46,1
535,535,,22,25,47,6
536,536,,41,7,48,14
537,537,,11,35,46,3
538,538,,9,36,45,3
539,539,,13,26,39,77
540,540,,12,36,48,105
541,541,,5,32,37,32
542,542,,30,19,49,14
543,543,,16,18,34,4
544,544,,27,13,40,8
545,545,,9,32,41,77
546,546,,30,13,43,3
547,547,,24,15,39,3
548,548,,20,17,37,5
549,549,,9,35,44,34
550,550,,2,32,34,4
551,551,,18,27,45,3
552,552,,10,33,43,14
553,553,,15,21,36,8
554,554,,14,25,39,9
555,555,,12,8,20,105
556,556,,12,31,43,22
557,557,,11,27,38,7
558,558,,20,18,38,77
559,559,,31,9,40,78
560,560,,11,26,37,3
561,561,,26,11,37,24
562,562,,23,11,34,78
563,563,,24,20,44,24
564,564,,15,25,40,4
565,565,,22,24,46,16
566,566,,15,20,35,6
567,567,,18,16,34,4
568,568,,23,17,40,18
569,569,,14,30,44,4
570,570,,16,22,38,3
571,571,,9,37,46,1
572,572,,13,25,38,9
573,573,,22,19,41,22
574,574,,11,25,36,4
575,575,,18,26,44,33
576,576,,8,31,39,5
577,577,,5,29,34,3
578,578,,26,17,43,14
579,579,,17,26,43,16
580,580,,19,21,40,5
581,581,,22,16,38,7
582,582,,34,6,40,8
583,583,,25,14,39,105
584,584,,9,31,40,18
585,585,,15,17,32,3
586,586,,35,5,40,27
587,587,,19,21,40,3
588,588,,9,5,14,27
589,589,,33,4,37,1
590,590,,17,19,36,16
591,591,,9,27,36,18
592,592,,18,22,40,22
593,593,,10,23,33,77
594,594,,19,21,40,32
595,595,,16,26,42,5
596,596,,7,7,14,3
597,597,,17,22,39,1
598,598,,19,24,43,4
599,599,,19,18,37,94
600,600,,10,33,43,4
601,601,,18,25,43,105
602,602,,21,12,33,22
603,603,,21,11,32,5
604,604,,16,21,37,105
605,605,,12,27,39,57
606,606,,19,17,36,18
607,607,,28,12,40,3
608,608,,10,12,22,22
609,609,,6,31,37,7
610,610,,18,18,36,3
611,611,,6,23,29,18
612,612,,14,20,34,3
613,613,,32,4,36,4
614,614,,20,21,41,5
615,615,,20,16,36,5
616,616,,20,16,36,9
617,617,,26,8,34,94
618,618,,2,34,36,18
619,619,,12,18,30,8
620,620,,10,27,37,3
621,621,,24,17,41,4
622,622,,16,18,34,18
623,623,,28,11,39,16
624,624,,18,19,37,3
625,625,,28,7,35,5
626,626,,10,16,26,4
627,627,,10,25,35,7
628,628,,31,4,35,105
629,629,,21,16,37,24
630,630,,18,14,32,3
631,631,,11,22,33,105
632,632,,11,27,38,94
633,633,,12,13,25,16
634,634,,22,17,39,5
635,635,,5,33,38,18
636,636,,14,20,34,4
637,637,,15,20,35,5
638,638,,10,17,27,18
639,639,,9,19,28,1
640,640,,7,31,38,5
641,641,,13,19,32,16
642,642,,18,7,25,3
643,643,,23,16,39,22
644,644,,23,13,36,19
645,645,,18,18,36,5
646,646,,22,17,39,105
647,647,,19,18,37,3
648,648,,14,18,32,24
649,649,,7,23,30,22
650,650,,12,18,30,5
651,651,,14,18,32,4
652,652,,21,15,36,6
653,653,,17,16,33,3
654,654,,7,27,34,14
655,655,,9,27,36,4
656,656,,12,21,33,3
657,657,,8,21,29,4
658,658,,0,32,32,9
659,659,,15,22,37,3
660,660,,9,19,28,18
661,661,,11,18,29,1
662,662,,14,10,24,1
663,663,,12,18,30,8
664,664,,8,23,31,33
665,665,,6,11,17,10
666,666,,0,34,34,9
667,667,,15,13,28,3
668,668,,4,26,30,32
669,669,,27,5,32,14
670,670,,17,12,29,8
671,671,,13,14,27,5
672,672,,18,20,38,3
673,673,,3,26,29,9
674,674,,20,10,30,7
675,675,,8,19,27,3
676,676,,19,16,35,9
677,677,,10,18,28,18
678,678,,14,19,33,5
679,679,,10,26,36,33
680,680,,8,27,35,18
681,681,,10,13,23,3
682,682,,17,20,37,3
683,683,,8,21,29,18
684,684,,8,19,27,3
685,685,,16,19,35,16
686,686,,11,17,28,94
687,687,,13,9,22,10
688,688,,21,10,31,22
689,689,,4,24,28,6
690,690,,14,7,21,7
691,691,,20,15,35,3
692,692,,12,19,31,94
693,693,,15,16,31,78
694,694,,9,13,22,5
695,695,,15,18,33,105
696,696,,24,5,29,32
697,697,,10,18,28,3
698,698,,12,18,30,3
699,699,,20,13,33,9
700,700,,8,9,17,2
701,701,,14,16,30,4
702,702,,6,26,32,18
703,703,,12,8,20,18
704,704,,8,26,34,5
705,705,,19,12,31,0
706,706,,14,21,35,3
707,707,,2,30,32,18
708,708,,3,23,26,18
709,709,,13,20,33,3
710,710,,17,18,35,16
711,711,,16,15,31,4
712,712,,14,19,33,1
713,713,,28,2,30,94
714,714,,2,27,29,5
715,715,,11,19,30,9
716,716,,17,16,33,4
717,717,,23,10,33,7
718,718,,20,8,28,4
719,719,,13,21,34,105
720,720,,21,12,33,1
721,721,,7,19,26,4
722,722,,18,10,28,5
723,723,,25,9,34,33
724,724,,15,15,30,1
725,725,,9,23,32,3
726,726,,10,19,29,1
727,727,,7,26,33,77
728,728,,12,22,34,3
729,729,,7,11,18,5
730,730,,15,15,30,94
731,731,,14,13,27,32
732,732,,10,18,28,3
733,733,,19,9,28,24
734,734,,11,19,30,3
735,735,,8,23,31,7
736,736,,15,14,29,4
737,737,,10,20,30,94
738,738,,11,12,23,5
739,739,,13,20,33,33
740,740,,16,15,31,1
741,741,,23,8,31,3
742,742,,12,15,27,9
743,743,,22,11,33,4
744,744,,7,21,28,14
745,745,,9,20,29,14
746,746,,12,12,24,18
747,747,,6,25,31,1
748,748,,17,15,32,7
749,749,,1,25,26,4
750,750,,17,11,28,33
751,751,,23,3,26,32
752,752,,3,25,28,3
753,753,,10,15,25,4
754,754,,5,24,29,3
755,755,,25,3,28,10
756,756,,6,11,17,78
757,757,,8,14,22,94
758,758,,13,19,32,18
759,759,,10,21,31,4
760,760,,5,12,17,33
761,761,,15,16,31,5
762,762,,1,28,29,3
763,763,,12,16,28,8
764,764,,9,15,24,14
765,765,,14,11,25,77
766,766,,10,17,27,39
767,767,,15,15,30,4
768,768,,12,19,31,18
769,769,,22,9,31,5
770,770,,8,7,15,14
771,771,,11,18,29,9
772,772,,12,14,26,18
773,773,,9,17,26,7
774,774,,11,20,31,5
775,775,,9,20,29,3
776,776,,13,15,28,4
777,777,,14,6,20,27
778,778,,9,19,28,6
779,779,,5,23,28,16
780,780,,10,19,29,3
781,781,,7,20,27,94
782,782,,9,20,29,77
783,783,,7,20,27,7
784,784,,14,10,24,1
785,785,,5,12,17,4
786,786,,4,20,24,7
787,787,,14,15,29,1
788,788,,23,6,29,8
789,789,,13,14,27,18
790,790,,7,9,16,78
791,791,,7,14,21,16
792,792,,1,12,13,22
793,793,,1,1,2,22
794,794,,9,16,25,9
795,795,,4,20,24,4
796,796,,18,10,28,6
797,797,,12,14,26,18
798,798,,18,7,25,82
799,799,,8,20,28,18
800,800,,5,22,27,18
801,801,,10,18,28,5
802,802,,15,8,23,7
803,803,,17,7,24,22
804,804,,19,7,26,16
805,805,,8,17,25,18
806,806,,15,14,29,7
807,807,,7,18,25,18
808,808,,16,10,26,4
809,809,,4,15,19,4
810,810,,17,8,25,18
811,811,,19,4,23,3
812,812,,5,12,17,105
813,813,,4,21,25,0
814,814,,16,13,29,105
815,815,,8,18,26,5
816,816,,9,3,12,22
817,817,,9,16,25,16
818,818,,11,11,22,22
819,819,,10,19,29,4
820,820,,6,15,21,105
821,821,,22,6,28,77
822,822,,16,11,27,74
823,823,,17,8,25,32
824,824,,19,9,28,4
825,825,,9,8,17,27
826,826,,10,17,27,9
827,827,,11,11,22,4
828,828,,3,0,3,8
829,829,,19,2,21,1
830,830,,9,19,28,1
831,831,,13,10,23,8
832,832,,14,14,28,14
833,833,,3,22,25,4
834,834,,6,7,13,7
835,835,,11,13,24,18
836,836,,13,15,28,4
837,837,,9,11,20,4
838,838,,4,21,25,7
839,839,,8,13,21,3
840,840,,10,13,23,105
841,841,,5,21,26,105
842,842,,11,11,22,9
843,843,,18,6,24,22
844,844,,12,9,21,22
845,845,,9,16,25,27
846,846,,8,16,24,3
847,847,,4,7,11,105
848,848,,17,9,26,5
849,849,,12,15,27,3
850,850,,12,10,22,4
851,851,,6,20,26,32
852,852,,11,12,23,4
853,853,,7,11,18,105
854,854,,8,13,21,105
855,855,,7,15,22,5
856,856,,15,8,23,7
857,857,,8,15,23,5
858,858,,19,6,25,3
859,859,,5,17,22,8
860,860,,13,12,25,24
861,861,,7,19,26,18
862,862,,6,20,26,105
863,863,,19,6,25,33
864,864,,10,6,16,4
865,865,,1,8,9,9
866,866,,8,10,18,9
867,867,,1,25,26,4
868,868,,12,7,19,8
869,869,,3,5,8,4
870,870,,9,11,20,4
871,871,,14,12,26,3
872,872,,0,21,21,9
873,873,,3,19,22,6
874,874,,19,7,26,5
875,875,,0,18,18,18
876,876,,16,7,23,3
877,877,,7,7,14,33
878,878,,14,8,22,19
879,879,,17,9,26,3
880,880,,18,8,26,77
881,881,,7,13,20,3
882,882,,12,10,22,3
883,883,,10,15,25,22
884,884,,3,20,23,6
885,885,,2,19,21,78
886,886,,0,0,0,11
887,887,,16,5,21,0
888,888,,8,10,18,3
889,889,,9,10,19,77
890,890,,7,13,20,5
891,891,,14,12,26,105
892,892,,11,13,24,3
893,893,,11,12,23,94
894,894,,5,11,16,3
895,895,,6,15,21,22
896,896,,18,6,24,5
897,897,,10,13,23,0
898,898,,11,14,25,78
899,899,,12,13,25,94
900,900,,18,8,26,1
901,901,,13,12,25,105
902,902,,13,9,22,33
903,903,,17,5,22,4
904,904,,19,7,26,8
905,905,,0,23,23,1
906,906,,11,15,26,1
907,907,,0,24,24,5
908,908,,11,14,25,16
909,909,,1,16,17,18
910,910,,15,8,23,9
911,911,,4,11,15,4
912,912,,13,5,18,4
913,913,,5,10,15,22
914,914,,10,4,14,39
915,915,,3,22,25,4
916,916,,10,4,14,27
917,917,,10,10,20,5
918,918,,17,5,22,1
919,919,,16,3,19,4
920,920,,8,10,18,94
921,921,,13,10,23,33
922,922,,13,11,24,105
923,923,,13,6,19,22
924,924,,11,9,20,7
925,925,,10,12,22,3
926,926,,8,13,21,22
927,927,,12,11,23,18
928,928,,15,6,21,22
929,929,,2,16,18,18
930,930,,12,13,25,4
931,931,,3,21,24,3
932,932,,16,5,21,4
933,933,,8,14,22,4
934,934,,16,9,25,14
935,935,,8,11,19,3
936,936,,7,12,19,3
937,937,,15,8,23,16
938,938,,8,11,19,4
939,939,,8,13,21,5
940,940,,10,12,22,3
941,941,,4,15,19,33
942,942,,10,11,21,4
943,943,,14,6,20,78
944,944,,9,15,24,77
945,945,,14,5,19,22
946,946,,10,9,19,14
947,947,,9,5,14,105
948,948,,12,8,20,33
949,949,,6,16,22,3
950,950,,7,17,24,14
951,951,,13,11,24,19
952,952,,9,15,24,4
953,953,,7,6,13,2
954,954,,9,14,23,14
955,955,,13,8,21,10
956,956,,1,18,19,94
957,957,,5,12,17,4
958,958,,1,14,15,4
959,959,,8,15,23,18
960,960,,10,8,18,4
961,961,,7,13,20,8
962,962,,11,11,22,94
963,963,,13,7,20,9
964,964,,4,12,16,18
965,965,,7,8,15,22
966,966,,12,11,23,94
967,967,,8,15,23,14
968,968,,9,11,20,3
969,969,,13,11,24,3
970,970,,12,12,24,27
971,971,,7,17,24,3
972,972,,6,2,8,6
973,973,,6,11,17,19
974,974,,5,14,19,7
975,975,,9,11,20,3
976,976,,8,9,17,2
977,977,,5,11,16,9
978,978,,11,5,16,1
979,979,,5,15,20,33
980,980,,9,12,21,105
981,981,,1,14,15,78
982,982,,14,9,23,5
983,983,,9,12,21,22
984,984,,8,10,18,22
985,985,,13,8,21,32
986,986,,10,8,18,105
987,987,,10,13,23,5
988,988,,4,17,21,22
989,989,,10,10,20,34
990,990,,10,13,23,5
991,991,,8,11,19,9
992,992,,9,14,23,27
993,993,,14,9,23,0
994,994,,10,13,23,3
995,995,,9,10,19,0
996,996,,6,15,21,4
997,997,,9,13,22,22
998,998,,13,10,23,78
999,999,,9,13,22,3
1000,1000,,14,8,22,4
1001,1001,,15,4,19,82
1002,1002,,12,9,21,4
1003,1003,,5,12,17,22
1004,1004,,8,8,16,4
1005,1005,,13,10,23,1
1006,1006,,12,5,17,18
1007,1007,,3,20,23,3
1008,1008,,0,2,2,94
1009,1009,,9,14,23,3
1010,1010,,12,8,20,19
1011,1011,,10,13,23,1
1012,1012,,8,12,20,7
1013,1013,,6,12,18,3
1014,1014,,12,9,21,4
1015,1015,,8,6,14,3
1016,1016,,13,6,19,22
1017,1017,,16,5,21,33
1018,1018,,7,15,22,14
1019,1019,,13,5,18,5
1020,1020,,8,14,22,3
1021,1021,,8,11,19,9
1022,1022,,15,3,18,27
1023,1023,,6,11,17,105
1024,1024,,9,11,20,4
1025,1025,,6,13,19,1
1026,1026,,13,5,18,3
1027,1027,,11,8,19,33
1028,1028,,5,9,14,94
1029,1029,,15,5,20,3
1030,1030,,9,8,17,8
1031,1031,,9,12,21,22
1032,1032,,7,15,22,22
1033,1033,,6,10,16,32
1034,1034,,4,14,18,9
1035,1035,,16,5,21,3
1036,1036,,2,18,20,3
1037,1037,,2,16,18,3
1038,1038,,10,10,20,18
1039,1039,,10,10,20,3
1040,1040,,14,4,18,1
1041,1041,,10,11,21,3
1042,1042,,6,15,21,24
1043,1043,,5,8,13,22
1044,1044,,14,6,20,32
1045,1045,,9,9,18,0
1046,1046,,8,9,17,33
1047,1047,,10,5,15,4
1048,1048,,5,11,16,3
1049,1049,,9,11,20,3
1050,1050,,4,15,19,6
1051,1051,,12,8,20,4
1052,1052,,3,9,12,4
1053,1053,,5,13,18,18
1054,1054,,14,7,21,33
1055,1055,,6,12,18,14
1056,1056,,5,8,13,9
1057,1057,,1,8,9,18
1058,1058,,2,11,13,7
1059,1059,,8,11,19,77
1060,1060,,9,10,19,3
1061,1061,,9,7,16,3
1062,1062,,1,12,13,9
1063,1063,,7,14,21,105
1064,1064,,6,12,18,14
1065,1065,,4,14,18,7
1066,1066,,6,10,16,27
1067,1067,,7,13,20,14
1068,1068,,16,4,20,18
1069,1069,,12,9,21,4
1070,1070,,12,9,21,0
1071,1071,,3,4,7,4
1072,1072,,11,8,19,5
1073,1073,,7,10,17,19
1074,1074,,8,13,21,74
1075,1075,,6,8,14,9
1076,1076,,4,14,18,3
1077,1077,,4,4,8,4
1078,1078,,5,15,20,5
1079,1079,,8,12,20,3
1080,1080,,7,8,15,3
1081,1081,,6,10,16,94
1082,1082,,7,8,15,3
1083,1083,,15,3,18,8
1084,1084,,9,4,13,5
1085,1085,,11,9,20,18
1086,1086,,10,8,18,3
1087,1087,,14,0,14,3
1088,1088,,11,8,19,22
1089,1089,,4,13,17,27
1090,1090,,4,4,8,14
1091,1091,,11,8,19,22
1092,1092,,12,3,15,3
1093,1093,,10,10,20,22
1094,1094,,6,13,19,3
1095,1095,,7,3,10,94
1096,1096,,6,12,18,19
1097,1097,,8,7,15,19
1098,1098,,5,9,14,32
1099,1099,,12,7,19,4
1100,1100,,10,2,12,9
1101,1101,,8,12,20,105
1102,1102,,0,14,14,5
1103,1103,,8,9,17,105
1104,1104,,7,11,18,77
1105,1105,,7,9,16,16
1106,1106,,8,6,14,7
1107,1107,,4,12,16,33
1108,1108,,2,11,13,105
1109,1109,,8,9,17,3
1110,1110,,11,9,20,14
1111,1111,,9,8,17,3
1112,1112,,0,0,0,12
1113,1113,,5,14,19,33
1114,1114,,2,14,16,6
1115,1115,,4,13,17,105
1116,1116,,9,8,17,1
1117,1117,,4,4,8,1
1118,1118,,0,19,19,4
1119,1119,,8,8,16,33
1120,1120,,5,9,14,18
1121,1121,,0,16,16,3
1122,1122,,14,4,18,3
1123,1123,,9,9,18,4
1124,1124,,2,8,10,22
1125,1125,,14,1,15,77
1126,1126,,7,11,18,4
1127,1127,,4,10,14,7
1128,1128,,11,8,19,105
1129,1129,,0,9,9,32
1130,1130,,8,3,11,3
1131,1131,,12,6,18,3
1132,1132,,4,8,12,57
1133,1133,,8,11,19,16
1134,1134,,1,15,16,18
1135,1135,,17,1,18,94
1136,1136,,7,7,14,3
1137,1137,,14,2,16,7
1138,1138,,12,5,17,16
1139,1139,,8,9,17,1
1140,1140,,7,12,19,3
1141,1141,,4,13,17,8
1142,1142,,1,2,3,1
1143,1143,,5,11,16,33
1144,1144,,0,3,3,2
1145,1145,,11,7,18,19
1146,1146,,11,7,18,7
1147,1147,,6,9,15,32
1148,1148,,10,6,16,3
1149,1149,,3,14,17,18
1150,1150,,7,12,19,8
1151,1151,,8,8,16,3
1152,1152,,9,9,18,4
1153,1153,,6,10,16,7
1154,1154,,1,13,14,5
1155,1155,,2,10,12,7
1156,1156,,10,8,18,8
1157,1157,,11,6,17,22
1158,1158,,4,7,11,3
1159,1159,,14,5,19,18
1160,1160,,5,13,18,33
1161,1161,,11,8,19,5
1162,1162,,9,8,17,9
1163,1163,,5,6,11,3
1164,1164,,15,3,18,3
1165,1165,,3,15,18,3
1166,1166,,0,0,0,13
1167,1167,,7,2,9,4
1168,1168,,7,6,13,18
1169,1169,,3,11,14,4
1170,1170,,1,7,8,24
1171,1171,,4,11,15,9
1172,1172,,1,12,13,8
1173,1173,,7,8,15,22
1174,1174,,3,12,15,1
1175,1175,,14,2,16,7
1176,1176,,9,8,17,5
1177,1177,,12,6,18,5
1178,1178,,6,8,14,9
1179,1179,,7,11,18,3
1180,1180,,7,11,18,3
1181,1181,,3,5,8,4
1182,1182,,2,9,11,22
1183,1183,,6,9,15,8
1184,1184,,5,4,9,4
1185,1185,,4,7,11,1
1186,1186,,5,7,12,77
1187,1187,,10,7,17,94
1188,1188,,3,2,5,18
1189,1189,,0,15,15,9
1190,1190,,7,7,14,3
1191,1191,,10,7,17,4
1192,1192,,6,11,17,18
1193,1193,,7,11,18,33
1194,1194,,3,13,16,24
1195,1195,,7,8,15,4
1196,1196,,1,9,10,34
1197,1197,,4,5,9,32
1198,1198,,11,6,17,94
1199,1199,,5,5,10,4
1200,1200,,7,7,14,22
1201,1201,,7,6,13,18
1202,1202,,8,6,14,94
1203,1203,,8,8,16,94
1204,1204,,10,8,18,16
1205,1205,,3,13,16,9
1206,1206,,2,12,14,18
1207,1207,,8,5,13,94
1208,1208,,6,0,6,78
1209,1209,,4,14,18,4
1210,1210,,7,10,17,5
1211,1211,,5,13,18,5
1212,1212,,2,13,15,18
1213,1213,,5,11,16,22
1214,1214,,10,7,17,5
1215,1215,,2,16,18,9
1216,1216,,0,1,1,5
1217,1217,,4,12,16,77
1218,1218,,12,1,13,33
1219,1219,,9,8,17,19
1220,1220,,4,7,11,4
1221,1221,,0,13,13,18
1222,1222,,10,7,17,9
1223,1223,,5,7,12,77
1224,1224,,11,4,15,7
1225,1225,,10,4,14,14
1226,1226,,8,7,15,94
1227,1227,,8,4,12,34
1228,1228,,14,1,15,4
1229,1229,,8,6,14,0
1230,1230,,7,10,17,5
1231,1231,,4,10,14,5
1232,1232,,6,4,10,1
1233,1233,,6,5,11,22
1234,1234,,1,7,8,22
1235,1235,,3,10,13,7
1236,1236,,8,6,14,22
1237,1237,,10,5,15,4
1238,1238,,8,4,12,8
1239,1239,,4,10,14,8
1240,1240,,5,12,17,5
1241,1241,,7,9,16,5
1242,1242,,5,11,16,8
1243,1243,,6,11,17,22
1244,1244,,2,2,4,22
1245,1245,,0,11,11,39
1246,1246,,6,8,14,1
1247,1247,,4,8,12,16
1248,1248,,7,10,17,9
1249,1249,,5,4,9,9
1250,1250,,6,11,17,4
1251,1251,,8,8,16,14
1252,1252,,12,3,15,3
1253,1253,,5,4,9,4
1254,1254,,0,9,9,22
1255,1255,,11,6,17,27
1256,1256,,5,8,13,105
1257,1257,,9,6,15,4
1258,1258,,5,10,15,4
1259,1259,,4,7,11,19
1260,1260,,5,7,12,34
1261,1261,,4,10,14,8
1262,1262,,3,11,14,18
1263,1263,,0,0,0,15
1264,1264,,4,9,13,27
1265,1265,,6,11,17,3
1266,1266,,9,4,13,3
1267,1267,,12,3,15,14
1268,1268,,5,8,13,0
1269,1269,,10,1,11,5
1270,1270,,2,13,15,18
1271,1271,,5,10,15,5
1272,1272,,6,6,12,18
1273,1273,,7,9,16,8
1274,1274,,2,6,8,14
1275,1275,,3,8,11,8
1276,1276,,6,6,12,0
1277,1277,,12,4,16,24
1278,1278,,8,8,16,18
1279,1279,,12,2,14,8
1280,1280,,14,1,15,4
1281,1281,,10,1,11,25
1282,1282,,7,7,14,3
1283,1283,,5,7,12,0
1284,1284,,10,6,16,5
1285,1285,,7,9,16,3
1286,1286,,13,0,13,1
1287,1287,,10,4,14,33
1288,1288,,10,6,16,4
1289,1289,,5,9,14,105
1290,1290,,6,10,16,18
1291,1291,,3,7,10,5
1292,1292,,10,5,15,4
1293,1293,,3,2,5,10
1294,1294,,7,4,11,0
1295,1295,,4,8,12,3
1296,1296,,4,11,15,8
1297,1297,,6,10,16,5
1298,1298,,6,8,14,18
1299,1299,,10,3,13,78
1300,1300,,6,7,13,0
1301,1301,,8,2,10,32
1302,1302,,4,10,14,3
1303,1303,,5,0,5,6
1304,1304,,5,3,8,4
1305,1305,,7,9,16,7
1306,1306,,8,6,14,3
1307,1307,,7,6,13,33
1308,1308,,10,6,16,33
1309,1309,,8,5,13,8
1310,1310,,5,11,16,33
1311,1311,,0,11,11,3
1312,1312,,7,9,16,0
1313,1313,,7,9,16,5
1314,1314,,5,7,12,5
1315,1315,,2,11,13,33
1316,1316,,2,10,12,4
1317,1317,,1,15,16,3
1318,1318,,1,6,7,4
1319,1319,,0,3,3,27
1320,1320,,12,4,16,32
1321,1321,,4,11,15,18
1322,1322,,6,10,16,1
1323,1323,,8,5,13,3
1324,1324,,5,9,14,4
1325,1325,,5,7,12,3
1326,1326,,8,6,14,9
1327,1327,,1,11,12,4
1328,1328,,3,10,13,94
1329,1329,,5,10,15,32
1330,1330,,7,1,8,33
1331,1331,,5,11,16,3
1332,1332,,8,8,16,1
1333,1333,,9,1,10,5
1334,1334,,7,7,14,22
1335,1335,,4,7,11,14
1336,1336,,6,9,15,5
1337,1337,,5,10,15,1
1338,1338,,6,8,14,8
1339,1339,,8,8,16,3
1340,1340,,7,9,16,18
1341,1341,,8,6,14,7
1342,1342,,9,0,9,94
1343,1343,,8,6,14,3
1344,1344,,5,6,11,16
1345,1345,,2,13,15,18
1346,1346,,3,3,6,4
1347,1347,,4,7,11,94
1348,1348,,3,11,14,33
1349,1349,,10,5,15,32
1350,1350,,9,5,14,32
1351,1351,,8,7,15,7
1352,1352,,8,5,13,22
1353,1353,,6,7,13,105
1354,1354,,7,8,15,14
1355,1355,,1,10,11,32
1356,1356,,6,4,10,105
1357,1357,,4,3,7,7
1358,1358,,6,9,15,16
1359,1359,,6,7,13,3
1360,1360,,2,9,11,4
1361,1361,,7,8,15,33
1362,1362,,5,6,11,33
1363,1363,,5,7,12,1
1364,1364,,3,2,5,4
1365,1365,,3,12,15,4
1366,1366,,6,5,11,94
1367,1367,,4,10,14,1
1368,1368,,4,8,12,3
1369,1369,,2,5,7,3
1370,1370,,3,12,15,77
1371,1371,,1,7,8,18
1372,1372,,11,4,15,105
1373,1373,,5,4,9,8
1374,1374,,9,6,15,9
1375,1375,,1,8,9,7
1376,1376,,5,8,13,22
1377,1377,,1,14,15,9
1378,1378,,10,3,13,7
1379,1379,,7,7,14,24
1380,1380,,1,14,15,7
1381,1381,,5,10,15,32
1382,1382,,6,9,15,4
1383,1383,,0,2,2,9
1384,1384,,11,2,13,32
1385,1385,,5,8,13,6
1386,1386,,5,8,13,24
1387,1387,,13,2,15,19
1388,1388,,7,7,14,78
1389,1389,,10,5,15,9
1390,1390,,6,6,12,1
1391,1391,,1,4,5,1
1392,1392,,15,0,15,3
1393,1393,,9,6,15,3
1394,1394,,14,1,15,6
1395,1395,,8,4,12,94
1396,1396,,10,5,15,7
1397,1397,,2,10,12,3
1398,1398,,5,10,15,4
1399,1399,,0,15,15,4
1400,1400,,8,3,11,9
1401,1401,,8,7,15,16
1402,1402,,8,6,14,22
1403,1403,,3,11,14,94
1404,1404,,11,2,13,3
1405,1405,,6,8,14,9
1406,1406,,4,6,10,9
1407,1407,,6,8,14,22
1408,1408,,5,9,14,3
1409,1409,,7,5,12,27
1410,1410,,10,1,11,2
1411,1411,,4,8,12,1
1412,1412,,2,12,14,22
1413,1413,,3,9,12,19
1414,1414,,6,8,14,5
1415,1415,,4,3,7,3
1416,1416,,9,5,14,4
1417,1417,,4,7,11,6
1418,1418,,13,1,14,18
1419,1419,,8,0,8,3
1420,1420,,9,3,12,32
1421,1421,,1,10,11,9
1422,1422,,2,9,11,105
1423,1423,,5,8,13,94
1424,1424,,5,9,14,9
1425,1425,,7,6,13,4
1426,1426,,3,9,12,33
1427,1427,,6,6,12,14
1428,1428,,4,6,10,9
1429,1429,,10,4,14,3
1430,1430,,1,6,7,18
1431,1431,,8,0,8,9
1432,1432,,3,8,11,4
1433,1433,,5,7,12,5
1434,1434,,11,1,12,0
1435,1435,,6,8,14,3
1436,1436,,4,9,13,5
1437,1437,,6,4,10,3
1438,1438,,5,7,12,32
1439,1439,,4,4,8,22
1440,1440,,1,8,9,4
1441,1441,,2,7,9,18
1442,1442,,5,7,12,4
1443,1443,,1,12,13,14
1444,1444,,5,9,14,94
1445,1445,,2,3,5,5
1446,1446,,8,6,14,16
1447,1447,,6,6,12,0
1448,1448,,3,8,11,3
1449,1449,,2,9,11,94
1450,1450,,0,9,9,1
1451,1451,,4,10,14,33
1452,1452,,5,6,11,19
1453,1453,,10,1,11,10
1454,1454,,8,6,14,3
1455,1455,,8,4,12,32
1456,1456,,6,6,12,4
1457,1457,,3,9,12,18
1458,1458,,8,6,14,94
1459,1459,,5,6,11,9
1460,1460,,6,7,13,14
1461,1461,,10,3,13,77
1462,1462,,10,1,11,33
1463,1463,,10,1,11,9
1464,1464,,1,13,14,14
1465,1465,,3,7,10,5
1466,1466,,5,6,11,22
1467,1467,,0,11,11,8
1468,1468,,7,7,14,9
1469,1469,,5,9,14,27
1470,1470,,7,6,13,9
1471,1471,,3,6,9,78
1472,1472,,12,1,13,3
1473,1473,,9,4,13,14
1474,1474,,8,0,8,32
1475,1475,,9,2,11,32
1476,1476,,0,12,12,1
1477,1477,,10,3,13,8
1478,1478,,2,8,10,1
1479,1479,,7,6,13,9
1480,1480,,6,5,11,0
1481,1481,,4,9,13,19
1482,1482,,3,5,8,105
1483,1483,,2,11,13,4
1484,1484,,5,3,8,4
1485,1485,,5,6,11,3
1486,1486,,4,6,10,16
1487,1487,,3,5,8,3
1488,1488,,0,0,0,17
1489,1489,,9,3,12,94
1490,1490,,5,6,11,5
1491,1491,,7,6,13,94
1492,1492,,6,2,8,3
1493,1493,,2,8,10,7
1494,1494,,8,5,13,5
1495,1495,,12,1,13,4
1496,1496,,2,9,11,94
1497,1497,,5,6,11,4
1498,1498,,6,7,13,16
1499,1499,,5,7,12,105
1500,1500,,4,8,12,4
1501,1501,,2,11,13,4
1502,1502,,4,6,10,94
1503,1503,,7,5,12,3
1504,1504,,4,4,8,94
1505,1505,,4,6,10,22
1506,1506,,5,8,13,1
1507,1507,,3,8,11,4
1508,1508,,1,11,12,4
1509,1509,,7,6,13,3
1510,1510,,4,6,10,5
1511,1511,,6,6,12,4
1512,1512,,1,6,7,7
1513,1513,,3,6,9,4
1514,1514,,2,8,10,78
1515,1515,,9,4,13,3
1516,1516,,4,5,9,3
1517,1517,,9,4,13,3
1518,1518,,3,9,12,105
1519,1519,,9,2,11,14
1520,1520,,5,5,10,27
1521,1521,,6,4,10,105
1522,1522,,6,7,13,18
1523,1523,,5,6,11,8
1524,1524,,8,5,13,4
1525,1525,,5,8,13,94
1526,1526,,4,5,9,5
1527,1527,,2,9,11,4
1528,1528,,6,4,10,7
1529,1529,,12,1,13,1
1530,1530,,3,3,6,9
1531,1531,,6,7,13,77
1532,1532,,7,6,13,78
1533,1533,,0,11,11,5
1534,1534,,6,7,13,18
1535,1535,,5,6,11,7
1536,1536,,6,3,9,19
1537,1537,,5,6,11,78
1538,1538,,10,3,13,1
1539,1539,,2,3,5,94
1540,1540,,8,4,12,4
1541,1541,,0,13,13,3
1542,1542,,5,8,13,1
1543,1543,,4,2,6,78
1544,1544,,5,8,13,14
1545,1545,,7,6,13,19
1546,1546,,3,7,10,1
1547,1547,,6,7,13,5
1548,1548,,2,2,4,33
1549,1549,,3,5,8,3
1550,1550,,6,6,12,5
1551,1551,,6,6,12,78
1552,1552,,9,2,11,1
1553,1553,,3,4,7,77
1554,1554,,1,6,7,18
1555,1555,,7,5,12,24
1556,1556,,3,7,10,32
1557,1557,,4,3,7,105
1558,1558,,7,2,9,7
1559,1559,,3,9,12,78
1560,1560,,6,5,11,19
1561,1561,,2,7,9,7
1562,1562,,6,4,10,4
1563,1563,,9,1,10,18
1564,1564,,10,1,11,105
1565,1565,,5,5,10,94
1566,1566,,1,9,10,3
1567,1567,,6,4,10,78
1568,1568,,5,2,7,10
1569,1569,,9,2,11,8
1570,1570,,7,4,11,78
1571,1571,,2,8,10,3
1572,1572,,2,9,11,3
1573,1573,,3,3,6,77
1574,1574,,4,7,11,105
1575,1575,,7,5,12,7
1576,1576,,5,6,11,9
1577,1577,,7,3,10,4
1578,1578,,6,5,11,5
1579,1579,,0,6,6,14
1580,1580,,3,9,12,9
1581,1581,,2,10,12,33
1582,1582,,8,2,10,8
1583,1583,,4,4,8,5
1584,1584,,4,6,10,3
1585,1585,,4,4,8,5
1586,1586,,1,7,8,3
1587,1587,,6,6,12,77
1588,1588,,4,8,12,33
1589,1589,,0,10,10,18
1590,1590,,1,10,11,4
1591,1591,,5,5,10,9
1592,1592,,5,5,10,22
1593,1593,,7,4,11,5
1594,1594,,1,11,12,105
1595,1595,,0,8,8,8
1596,1596,,5,2,7,32
1597,1597,,2,6,8,5
1598,1598,,5,4,9,94
1599,1599,,4,2,6,8
1600,1600,,0,0,0,20
1601,1601,,2,10,12,14
1602,1602,,2,10,12,7
1603,1603,,1,10,11,18
1604,1604,,3,4,7,3
1605,1605,,4,8,12,105
1606,1606,,3,7,10,5
1607,1607,,7,4,11,33
1608,1608,,8,2,10,6
1609,1609,,4,4,8,22
1610,1610,,3,9,12,9
1611,1611,,7,5,12,33
1612,1612,,4,6,10,0
1613,1613,,6,6,12,57
1614,1614,,1,8,9,9
1615,1615,,5,6,11,4
1616,1616,,4,8,12,4
1617,1617,,7,3,10,18
1618,1618,,6,6,12,4
1619,1619,,1,11,12,22
1620,1620,,6,6,12,1
1621,1621,,4,8,12,8
1622,1622,,6,6,12,2
1623,1623,,2,10,12,1
1624,1624,,2,2,4,3
1625,1625,,7,5,12,18
1626,1626,,8,4,12,33
1627,1627,,6,6,12,34
1628,1628,,2,8,10,14
1629,1629,,10,1,11,9
1630,1630,,6,6,12,3
1631,1631,,10,2,12,5
1632,1632,,5,4,9,33
1633,1633,,4,6,10,94
1634,1634,,7,4,11,4
1635,1635,,0,8,8,1
1636,1636,,2,7,9,18
1637,1637,,11,0,11,5
1638,1638,,3,8,11,94
1639,1639,,2,9,11,18
1640,1640,,2,6,8,16
1641,1641,,4,6,10,1
1642,1642,,5,2,7,24
1643,1643,,6,5,11,5
1644,1644,,1,7,8,22
1645,1645,,6,5,11,18
1646,1646,,8,2,10,33
1647,1647,,4,3,7,3
1648,1648,,5,5,10,5
1649,1649,,1,8,9,3
1650,1650,,8,1,9,5
1651,1651,,0,3,3,3
1652,1652,,1,4,5,9
1653,1653,,3,5,8,105
1654,1654,,3,5,8,16
1655,1655,,6,3,9,3
1656,1656,,5,4,9,1
1657,1657,,6,4,10,5
1658,1658,,5,5,10,16
1659,1659,,3,5,8,27
1660,1660,,8,3,11,8
1661,1661,,7,2,9,19
1662,1662,,7,4,11,3
1663,1663,,2,3,5,18
1664,1664,,1,3,4,5
1665,1665,,8,0,8,77
1666,1666,,8,3,11,105
1667,1667,,3,6,9,33
1668,1668,,4,7,11,94
1669,1669,,2,6,8,5
1670,1670,,0,11,11,3
1671,1671,,11,0,11,8
1672,1672,,6,3,9,5
1673,1673,,2,9,11,94
1674,1674,,7,2,9,34
1675,1675,,4,7,11,3
1676,1676,,7,2,9,18
1677,1677,,4,7,11,4
1678,1678,,5,6,11,10
1679,1679,,4,4,8,94
1680,1680,,9,2,11,3
1681,1681,,3,6,9,0
1682,1682,,5,6,11,5
1683,1683,,1,8,9,3
1684,1684,,1,9,10,33
1685,1685,,9,2,11,7
1686,1686,,3,8,11,105
1687,1687,,5,4,9,3
1688,1688,,3,2,5,8
1689,1689,,2,9,11,19
1690,1690,,2,8,10,8
1691,1691,,2,6,8,14
1692,1692,,6,5,11,22
1693,1693,,6,3,9,14
1694,1694,,3,3,6,3
1695,1695,,3,8,11,7
1696,1696,,4,6,10,21
1697,1697,,8,1,9,5
1698,1698,,4,7,11,33
1699,1699,,3,8,11,4
1700,1700,,4,6,10,0
1701,1701,,7,4,11,16
1702,1702,,7,3,10,33
1703,1703,,8,0,8,8
1704,1704,,7,4,11,22
1705,1705,,1,10,11,3
1706,1706,,5,6,11,82
1707,1707,,0,11,11,78
1708,1708,,2,9,11,4
1709,1709,,5,3,8,3
1710,1710,,3,5,8,9
1711,1711,,1,4,5,3
1712,1712,,2,7,9,16
1713,1713,,10,1,11,22
1714,1714,,0,11,11,16
1715,1715,,7,2,9,14
1716,1716,,1,4,5,19
1717,1717,,4,6,10,19
1718,1718,,3,8,11,3
1719,1719,,5,3,8,40
1720,1720,,3,4,7,9
1721,1721,,1,8,9,22
1722,1722,,9,2,11,33
1723,1723,,1,8,9,18
1724,1724,,7,2,9,7
1725,1725,,5,3,8,22
1726,1726,,5,5,10,3
1727,1727,,4,6,10,14
1728,1728,,4,4,8,105
1729,1729,,4,7,11,5
1730,1730,,5,1,6,5
1731,1731,,2,1,3,9
1732,1732,,1,4,5,7
1733,1733,,0,7,7,33
1734,1734,,2,9,11,94
1735,1735,,6,5,11,19
1736,1736,,2,9,11,22
1737,1737,,8,0,8,6
1738,1738,,2,7,9,5
1739,1739,,6,4,10,0
1740,1740,,3,5,8,40
1741,1741,,5,5,10,5
1742,1742,,2,6,8,9
1743,1743,,4,5,9,1
1744,1744,,7,2,9,3
1745,1745,,3,6,9,94
1746,1746,,2,6,8,1
1747,1747,,4,7,11,4
1748,1748,,4,4,8,1
1749,1749,,5,6,11,4
1750,1750,,3,8,11,78
1751,1751,,0,6,6,0
1752,1752,,1,8,9,3
1753,1753,,1,3,4,9
1754,1754,,7,4,11,5
1755,1755,,4,5,9,32
1756,1756,,3,3,6,8
1757,1757,,10,1,11,8
1758,1758,,4,7,11,5
1759,1759,,4,3,7,9
1760,1760,,6,0,6,5
1761,1761,,6,5,11,1
1762,1762,,6,4,10,22
1763,1763,,0,5,5,4
1764,1764,,0,7,7,32
1765,1765,,6,3,9,9
1766,1766,,0,5,5,4
1767,1767,,2,8,10,22
1768,1768,,0,8,8,4
1769,1769,,0,3,3,8
1770,1770,,0,10,10,18
1771,1771,,3,3,6,24
1772,1772,,4,5,9,5
1773,1773,,6,2,8,8
1774,1774,,3,4,7,3
1775,1775,,8,1,9,94
1776,1776,,4,3,7,10
1777,1777,,5,2,7,33
1778,1778,,3,5,8,7
1779,1779,,7,2,9,14
1780,1780,,3,7,10,3
1781,1781,,5,3,8,105
1782,1782,,3,2,5,9
1783,1783,,3,5,8,77
1784,1784,,1,6,7,4
1785,1785,,6,4,10,0
1786,1786,,5,5,10,4
1787,1787,,1,5,6,5
1788,1788,,4,5,9,9
1789,1789,,6,4,10,5
1790,1790,,3,2,5,18
1791,1791,,4,6,10,0
1792,1792,,5,1,6,3
1793,1793,,4,2,6,19
1794,1794,,6,4,10,5
1795,1795,,1,3,4,8
1796,1796,,9,0,9,8
1797,1797,,7,0,7,1
1798,1798,,3,2,5,9
1799,1799,,6,3,9,0
1800,1800,,2,7,9,6
1801,1801,,6,3,9,34
1802,1802,,3,7,10,19
1803,1803,,3,4,7,4
1804,1804,,3,2,5,9
1805,1805,,4,2,6,9
1806,1806,,1,8,9,94
1807,1807,,5,5,10,1
1808,1808,,3,7,10,3
1809,1809,,3,7,10,3
1810,1810,,5,5,10,32
1811,1811,,5,3,8,94
1812,1812,,3,2,5,3
1813,1813,,6,4,10,34
1814,1814,,5,5,10,4
1815,1815,,3,7,10,9
1816,1816,,2,4,6,32
1817,1817,,3,5,8,22
1818,1818,,0,6,6,1
1819,1819,,4,6,10,4
1820,1820,,5,4,9,8
1821,1821,,1,8,9,4
1822,1822,,4,6,10,5
1823,1823,,3,3,6,1
1824,1824,,6,2,8,94
1825,1825,,6,4,10,1
1826,1826,,6,2,8,24
1827,1827,,8,2,10,39
1828,1828,,3,5,8,4
1829,1829,,7,3,10,24
1830,1830,,1,2,3,8
1831,1831,,3,7,10,18
1832,1832,,6,4,10,16
1833,1833,,4,6,10,39
1834,1834,,3,5,8,16
1835,1835,,4,2,6,18
1836,1836,,5,3,8,9
1837,1837,,2,1,3,6
1838,1838,,9,1,10,9
1839,1839,,4,6,10,18
1840,1840,,2,5,7,94
1841,1841,,3,5,8,3
1842,1842,,3,0,3,78
1843,1843,,2,8,10,18
1844,1844,,3,1,4,18
1845,1845,,1,8,9,1
1846,1846,,4,4,8,8
1847,1847,,1,8,9,3
1848,1848,,0,5,5,4
1849,1849,,6,4,10,32
1850,1850,,0,10,10,3
1851,1851,,6,4,10,0
1852,1852,,2,6,8,1
1853,1853,,6,3,9,3
1854,1854,,2,8,10,4
1855,1855,,5,5,10,4
1856,1856,,5,5,10,3
1857,1857,,0,8,8,5
1858,1858,,5,5,10,19
1859,1859,,5,3,8,78
1860,1860,,3,3,6,9
1861,1861,,4,1,5,4
1862,1862,,6,4,10,4
1863,1863,,2,4,6,5
1864,1864,,4,2,6,1
1865,1865,,3,7,10,1
1866,1866,,5,5,10,1
1867,1867,,1,1,2,22
1868,1868,,5,3,8,33
1869,1869,,4,5,9,3
1870,1870,,10,0,10,1
1871,1871,,3,7,10,3
1872,1872,,2,7,9,78
1873,1873,,2,7,9,18
1874,1874,,3,2,5,4
1875,1875,,2,6,8,3
1876,1876,,1,3,4,3
1877,1877,,1,7,8,18
1878,1878,,3,6,9,4
1879,1879,,6,2,8,3
1880,1880,,3,4,7,94
1881,1881,,0,1,1,5
1882,1882,,3,6,9,3
1883,1883,,0,8,8,82
1884,1884,,4,5,9,3
1885,1885,,3,2,5,34
1886,1886,,6,2,8,8
1887,1887,,4,4,8,82
1888,1888,,3,4,7,3
1889,1889,,4,3,7,78
1890,1890,,4,4,8,9
1891,1891,,0,0,0,23
1892,1892,,1,8,9,3
1893,1893,,9,0,9,5
1894,1894,,1,7,8,0
1895,1895,,4,2,6,78
1896,1896,,5,4,9,4
1897,1897,,3,3,6,16
1898,1898,,3,6,9,4
1899,1899,,4,5,9,5
1900,1900,,2,6,8,4
1901,1901,,1,7,8,78
1902,1902,,4,4,8,22
1903,1903,,5,4,9,5
1904,1904,,3,2,5,8
1905,1905,,4,3,7,33
1906,1906,,2,7,9,94
1907,1907,,4,5,9,3
1908,1908,,3,6,9,32
1909,1909,,6,3,9,1
1910,1910,,4,5,9,0
1911,1911,,6,3,9,18
1912,1912,,2,6,8,5
1913,1913,,8,1,9,18
1914,1914,,3,4,7,77
1915,1915,,4,5,9,5
1916,1916,,5,4,9,19
1917,1917,,6,3,9,77
1918,1918,,3,5,8,4
1919,1919,,5,3,8,3
1920,1920,,6,3,9,0
1921,1921,,4,5,9,3
1922,1922,,3,4,7,4
1923,1923,,5,4,9,32
1924,1924,,4,4,8,27
1925,1925,,3,6,9,22
1926,1926,,5,4,9,4
1927,1927,,4,3,7,78
1928,1928,,0,7,7,24
1929,1929,,5,4,9,4
1930,1930,,0,1,1,3
1931,1931,,7,1,8,3
1932,1932,,4,5,9,4
1933,1933,,3,1,4,4
1934,1934,,4,4,8,4
1935,1935,,4,4,8,105
1936,1936,,8,1,9,105
1937,1937,,2,7,9,6
1938,1938,,4,5,9,4
1939,1939,,3,6,9,22
1940,1940,,3,4,7,1
1941,1941,,2,6,8,19
1942,1942,,2,1,3,10
1943,1943,,3,3,6,78
1944,1944,,4,3,7,22
1945,1945,,4,5,9,33
1946,1946,,2,6,8,105
1947,1947,,2,5,7,18
1948,1948,,9,0,9,105
1949,1949,,7,2,9,78
1950,1950,,1,7,8,3
1951,1951,,2,6,8,4
1952,1952,,3,6,9,22
1953,1953,,2,6,8,1
1954,1954,,1,2,3,0
1955,1955,,2,3,5,33
1956,1956,,2,6,8,27
1957,1957,,2,5,7,7
1958,1958,,1,4,5,3
1959,1959,,3,3,6,78
1960,1960,,2,7,9,32
1961,1961,,1,6,7,4
1962,1962,,2,4,6,94
1963,1963,,3,5,8,77
1964,1964,,4,5,9,33
1965,1965,,0,7,7,82
1966,1966,,1,7,8,16
1967,1967,,3,4,7,22
1968,1968,,6,1,7,6
1969,1969,,6,2,8,4
1970,1970,,1,7,8,16
1971,1971,,3,6,9,94
1972,1972,,6,1,7,3
1973,1973,,5,4,9,3
1974,1974,,2,7,9,4
1975,1975,,5,4,9,78
1976,1976,,7,2,9,5
1977,1977,,0,9,9,3
1978,1978,,6,3,9,3
1979,1979,,4,3,7,4
1980,1980,,1,7,8,7
1981,1981,,2,5,7,5
1982,1982,,2,7,9,5
1983,1983,,4,2,6,18
1984,1984,,6,2,8,19
1985,1985,,5,4,9,3
1986,1986,,2,5,7,10
1987,1987,,4,4,8,1
1988,1988,,5,3,8,105
1989,1989,,7,2,9,78
1990,1990,,1,1,2,9
1991,1991,,0,9,9,4
1992,1992,,5,2,7,105
1993,1993,,5,2,7,105
1994,1994,,1,8,9,25
1995,1995,,7,2,9,3
1996,1996,,3,5,8,9
1997,1997,,4,5,9,4
1998,1998,,3,5,8,16
1999,1999,,5,4,9,1
2000,2000,,2,6,8,9
2001,2001,,1,8,9,34
2002,2002,,2,5,7,94
2003,2003,,1,5,6,3
2004,2004,,2,6,8,9
2005,2005,,3,6,9,3
2006,2006,,4,1,5,10
2007,2007,,0,7,7,18
2008,2008,,4,5,9,4
2009,2009,,1,6,7,14
2010,2010,,1,8,9,33
2011,2011,,0,7,7,4
2012,2012,,6,3,9,0
2013,2013,,5,4,9,3
2014,2014,,2,6,8,22
2015,2015,,0,0,0,26
2016,2016,,4,4,8,33
2017,2017,,3,4,7,3
2018,2018,,2,7,9,3
2019,2019,,3,6,9,33
2020,2020,,3,4,7,5
2021,2021,,0,3,3,4
2022,2022,,0,7,7,14
2023,2023,,6,1,7,6
2024,2024,,9,0,9,105
2025,2025,,2,5,7,105
2026,2026,,6,2,8,14
2027,2027,,4,4,8,3
2028,2028,,6,2,8,94
2029,2029,,2,3,5,3
2030,2030,,1,5,6,8
2031,2031,,1,7,8,18
2032,2032,,3,5,8,3
2033,2033,,0,1,1,5
2034,2034,,5,2,7,9
2035,2035,,0,8,8,3
2036,2036,,2,5,7,4
2037,2037,,2,6,8,33
2038,2038,,0,6,6,9
2039,2039,,3,4,7,18
2040,2040,,2,6,8,4
2041,2041,,2,6,8,5
2042,2042,,4,4,8,4
2043,2043,,0,7,7,32
2044,2044,,5,3,8,4
2045,2045,,3,3,6,94
2046,2046,,4,4,8,77
2047,2047,,5,2,7,3
2048,2048,,2,2,4,4
2049,2049,,6,2,8,4
2050,2050,,2,6,8,0
2051,2051,,2,6,8,14
2052,2052,,1,7,8,4
2053,2053,,1,4,5,10
2054,2054,,4,1,5,82
2055,2055,,4,4,8,4
2056,2056,,5,0,5,94
2057,2057,,5,3,8,14
2058,2058,,5,3,8,22
2059,2059,,3,5,8,3
2060,2060,,0,5,5,3
2061,2061,,5,3,8,22
2062,2062,,2,2,4,16
2063,2063,,5,3,8,5
2064,2064,,0,1,1,306
2065,2065,,7,0,7,22
2066,2066,,4,4,8,27
2067,2067,,4,2,6,3
2068,2068,,2,5,7,5
2069,2069,,3,5,8,94
2070,2070,,3,1,4,5
2071,2071,,0,7,7,3
2072,2072,,5,2,7,8
2073,2073,,2,6,8,10
2074,2074,,1,7,8,1
2075,2075,,7,0,7,24
2076,2076,,5,1,6,5
2077,2077,,0,7,7,3
2078,2078,,0,8,8,32
2079,2079,,2,3,5,24
2080,2080,,2,5,7,105
2081,2081,,2,5,7,18
2082,2082,,0,7,7,3
2083,2083,,4,2,6,78
2084,2084,,7,0,7,0
2085,2085,,4,0,4,5
2086,2086,,3,5,8,1
2087,2087,,3,3,6,3
2088,2088,,5,3,8,16
2089,2089,,6,1,7,4
2090,2090,,1,2,3,33
2091,2091,,3,3,6,1
2092,2092,,3,5,8,19
2093,2093,,1,2,3,3
2094,2094,,1,4,5,5
2095,2095,,0,6,6,1
2096,2096,,3,5,8,33
2097,2097,,2,4,6,7
2098,2098,,1,4,5,3
2099,2099,,2,5,7,32
2100,2100,,4,3,7,19
2101,2101,,5,3,8,4
2102,2102,,0,8,8,4
2103,2103,,6,2,8,8
2104,2104,,1,7,8,105
2105,2105,,2,6,8,94
2106,2106,,6,2,8,4
2107,2107,,2,6,8,18
2108,2108,,0,7,7,0
2109,2109,,1,4,5,94
2110,2110,,3,5,8,105
2111,2111,,1,4,5,7
2112,2112,,3,4,7,105
2113,2113,,2,6,8,0
2114,2114,,4,2,6,27
2115,2115,,1,6,7,94
2116,2116,,1,4,5,7
2117,2117,,4,3,7,32
2118,2118,,8,0,8,3
2119,2119,,0,6,6,3
2120,2120,,3,5,8,7
2121,2121,,0,8,8,5
2122,2122,,2,5,7,4
2123,2123,,3,2,5,5
2124,2124,,4,4,8,94
2125,2125,,1,5,6,9
2126,2126,,5,2,7,27
2127,2127,,3,5,8,4
2128,2128,,1,2,3,16
2129,2129,,4,3,7,14
2130,2130,,3,5,8,27
2131,2131,,2,6,8,7
2132,2132,,1,2,3,18
2133,2133,,3,2,5,33
2134,2134,,4,2,6,78
2135,2135,,7,0,7,45
2136,2136,,4,4,8,8
2137,2137,,2,2,4,1
2138,2138,,4,4,8,0
2139,2139,,4,4,8,4
2140,2140,,0,0,0,28
2141,2141,,1,6,7,4
2142,2142,,3,5,8,18
2143,2143,,1,5,6,3
2144,2144,,7,0,7,32
2145,2145,,0,4,4,10
2146,2146,,6,2,8,18
2147,2147,,1,4,5,19
2148,2148,,6,0,6,9
2149,2149,,2,6,8,1
2150,2150,,1,6,7,14
2151,2151,,5,3,8,5
2152,2152,,2,6,8,1
2153,2153,,3,5,8,7
2154,2154,,2,6,8,1
2155,2155,,1,7,8,34
2156,2156,,4,3,7,82
2157,2157,,2,3,5,3
2158,2158,,3,5,8,105
2159,2159,,2,3,5,4
2160,2160,,2,6,8,1
2161,2161,,1,7,8,19
2162,2162,,4,4,8,29
2163,2163,,1,6,7,45
2164,2164,,3,5,8,40
2165,2165,,3,4,7,19
2166,2166,,7,1,8,22
2167,2167,,2,6,8,4
2168,2168,,2,6,8,3
2169,2169,,4,4,8,5
2170,2170,,1,3,4,8
2171,2171,,2,5,7,27
2172,2172,,2,6,8,5
2173,2173,,5,3,8,94
2174,2174,,4,3,7,5
2175,2175,,0,0,0,30
2176,2176,,1,7,8,3
2177,2177,,4,3,7,3
2178,2178,,3,4,7,7
2179,2179,,6,1,7,77
2180,2180,,2,6,8,9
2181,2181,,3,5,8,1
2182,2182,,2,4,6,5
2183,2183,,2,3,5,78
2184,2184,,4,2,6,6
2185,2185,,3,3,6,14
2186,2186,,2,6,8,57
2187,2187,,0,6,6,4
2188,2188,,3,4,7,4
2189,2189,,1,4,5,18
2190,2190,,4,2,6,3
2191,2191,,2,5,7,22
2192,2192,,8,0,8,3
2193,2193,,7,1,8,9
2194,2194,,7,1,8,9
2195,2195,,6,1,7,94
2196,2196,,3,5,8,3
2197,2197,,3,0,3,5
2198,2198,,2,5,7,3
2199,2199,,1,6,7,3
2200,2200,,1,5,6,9
2201,2201,,3,4,7,5
2202,2202,,2,5,7,32
2203,2203,,4,1,5,9
2204,2204,,1,6,7,4
2205,2205,,0,4,4,18
2206,2206,,2,3,5,33
2207,2207,,0,6,6,16
2208,2208,,1,6,7,94
2209,2209,,1,4,5,1
2210,2210,,0,6,6,18
2211,2211,,3,4,7,4
2212,2212,,2,5,7,7
2213,2213,,4,3,7,4
2214,2214,,5,1,6,9
2215,2215,,3,4,7,5
2216,2216,,5,1,6,8
2217,2217,,2,5,7,32
2218,2218,,3,2,5,94
2219,2219,,1,5,6,105
2220,2220,,2,0,2,14
2221,2221,,0,7,7,4
2222,2222,,3,4,7,4
2223,2223,,1,6,7,8
2224,2224,,4,3,7,33
2225,2225,,4,0,4,8
2226,2226,,1,3,4,33
2227,2227,,0,7,7,8
2228,2228,,3,3,6,0
2229,2229,,3,2,5,78
2230,2230,,5,2,7,4
2231,2231,,4,3,7,3
2232,2232,,2,3,5,32
2233,2233,,0,7,7,5
2234,2234,,0,4,4,77
2235,2235,,4,3,7,27
2236,2236,,5,2,7,3
2237,2237,,0,7,7,14
2238,2238,,4,3,7,22
2239,2239,,5,2,7,4
2240,2240,,1,6,7,3
2241,2241,,0,5,5,9
2242,2242,,2,3,5,3
2243,2243,,1,3,4,18
2244,2244,,2,3,5,7
2245,2245,,3,4,7,8
2246,2246,,2,4,6,22
2247,2247,,2,2,4,39
2248,2248,,3,4,7,1
2249,2249,,1,3,4,1
2250,2250,,3,1,4,5
2251,2251,,1,0,1,8
2252,2252,,0,7,7,18
2253,2253,,4,3,7,22
2254,2254,,0,2,2,3
2255,2255,,4,1,5,22
2256,2256,,5,1,6,18
2257,2257,,7,0,7,4
2258,2258,,3,4,7,4
2259,2259,,3,3,6,78
2260,2260,,1,3,4,3
2261,2261,,3,1,4,6
2262,2262,,2,4,6,8
2263,2263,,1,6,7,7
2264,2264,,0,7,7,6
2265,2265,,5,2,7,8
2266,2266,,4,3,7,7
2267,2267,,2,5,7,4
2268,2268,,1,6,7,19
2269,2269,,1,6,7,5
2270,2270,,0,7,7,77
2271,2271,,4,3,7,3
2272,2272,,1,1,2,105
2273,2273,,3,4,7,77
2274,2274,,5,2,7,77
2275,2275,,4,3,7,105
2276,2276,,2,2,4,18
2277,2277,,2,4,6,14
2278,2278,,1,0,1,16
2279,2279,,1,6,7,5
2280,2280,,1,4,5,105
2281,2281,,5,2,7,78
2282,2282,,3,1,4,105
2283,2283,,7,0,7,32
2284,2284,,4,3,7,32
2285,2285,,2,5,7,8
2286,2286,,2,2,4,0
2287,2287,,4,3,7,5
2288,2288,,5,1,6,105
2289,2289,,4,3,7,22
2290,2290,,3,4,7,5
2291,2291,,2,3,5,8
2292,2292,,2,5,7,4
2293,2293,,0,5,5,3
2294,2294,,5,1,6,1
2295,2295,,3,4,7,3
2296,2296,,0,7,7,105
2297,2297,,3,2,5,27
2298,2298,,1,5,6,77
2299,2299,,0,0,0,31
2300,2300,,4,3,7,3
2301,2301,,1,6,7,8
2302,2302,,5,2,7,94
2303,2303,,0,4,4,18
2304,2304,,7,0,7,1
2305,2305,,4,3,7,14
2306,2306,,3,4,7,9
2307,2307,,1,4,5,18
2308,2308,,1,2,3,105
2309,2309,,4,2,6,10
2310,2310,,1,6,7,82
2311,2311,,4,3,7,3
2312,2312,,2,5,7,33
2313,2313,,2,4,6,16
2314,2314,,2,0,2,9
2315,2315,,6,1,7,105
2316,2316,,2,4,6,4
2317,2317,,1,4,5,78
2318,2318,,1,5,6,4
2319,2319,,4,0,4,33
2320,2320,,2,3,5,1
2321,2321,,0,4,4,1
2322,2322,,3,2,5,3
2323,2323,,1,0,1,24
2324,2324,,6,1,7,105
2325,2325,,3,4,7,94
2326,2326,,0,3,3,33
2327,2327,,1,4,5,32
2328,2328,,3,2,5,77
2329,2329,,3,2,5,34
2330,2330,,5,1,6,57
2331,2331,,4,3,7,94
2332,2332,,3,3,6,33
2333,2333,,3,2,5,7
2334,2334,,2,4,6,18
2335,2335,,4,3,7,7
2336,2336,,1,2,3,33
2337,2337,,4,3,7,1
2338,2338,,6,1,7,8
2339,2339,,5,2,7,5
2340,2340,,6,1,7,33
2341,2341,,6,1,7,5
2342,2342,,0,5,5,0
2343,2343,,5,0,5,18
2344,2344,,1,5,6,33
2345,2345,,5,0,5,4
2346,2346,,3,3,6,19
2347,2347,,5,2,7,94
2348,2348,,4,3,7,1
2349,2349,,1,4,5,0
2350,2350,,2,5,7,8
2351,2351,,2,2,4,18
2352,2352,,0,7,7,33
2353,2353,,1,4,5,5
2354,2354,,6,1,7,78
2355,2355,,5,2,7,9
2356,2356,,5,2,7,0
2357,2357,,2,5,7,22
2358,2358,,1,2,3,3
2359,2359,,3,1,4,19
2360,2360,,1,5,6,4
2361,2361,,2,4,6,1
2362,2362,,5,1,6,4
2363,2363,,2,2,4,1
2364,2364,,0,3,3,7
2365,2365,,2,4,6,3
2366,2366,,3,2,5,8
2367,2367,,1,2,3,22
2368,2368,,3,4,7,10
2369,2369,,3,4,7,5
2370,2370,,5,0,5,4
2371,2371,,3,4,7,7
2372,2372,,1,5,6,3
2373,2373,,1,4,5,3
2374,2374,,3,4,7,22
2375,2375,,5,1,6,105
2376,2376,,1,6,7,22
2377,2377,,4,3,7,1
2378,2378,,3,4,7,0
2379,2379,,2,2,4,21
2380,2380,,2,1,3,4
2381,2381,,0,7,7,6
2382,2382,,2,4,6,22
2383,2383,,2,4,6,18
2384,2384,,3,4,7,4
2385,2385,,3,3,6,27
2386,2386,,3,4,7,5
2387,2387,,3,4,7,5
2388,2388,,1,5,6,33
2389,2389,,4,2,6,1
2390,2390,,5,2,7,39
2391,2391,,3,3,6,1
2392,2392,,5,2,7,32
2393,2393,,3,4,7,1
2394,2394,,1,5,6,18
2395,2395,,3,2,5,4
2396,2396,,3,2,5,6
2397,2397,,1,2,3,3
2398,2398,,2,5,7,33
2399,2399,,1,3,4,3
2400,2400,,3,2,5,6
2401,2401,,2,3,5,5
2402,2402,,3,3,6,5
2403,2403,,0,5,5,9
2404,2404,,1,5,6,5
2405,2405,,4,2,6,3
2406,2406,,2,3,5,5
2407,2407,,3,3,6,4
2408,2408,,2,2,4,5
2409,2409,,4,2,6,5
2410,2410,,1,0,1,39
2411,2411,,2,3,5,1
2412,2412,,0,4,4,5
2413,2413,,1,2,3,4
2414,2414,,1,2,3,24
2415,2415,,6,0,6,34
2416,2416,,3,3,6,3
2417,2417,,4,2,6,3
2418,2418,,1,4,5,77
2419,2419,,1,4,5,7
2420,2420,,2,3,5,5
2421,2421,,0,6,6,14
2422,2422,,2,0,2,8
2423,2423,,5,1,6,27
2424,2424,,0,5,5,78
2425,2425,,0,1,1,8
2426,2426,,2,4,6,105
2427,2427,,1,5,6,3
2428,2428,,2,3,5,94
2429,2429,,4,1,5,0
2430,2430,,1,5,6,4
2431,2431,,0,0,0,35
2432,2432,,1,4,5,9
2433,2433,,1,5,6,16
2434,2434,,2,2,4,22
2435,2435,,3,0,3,4
2436,2436,,3,3,6,19
2437,2437,,1,1,2,3
2438,2438,,4,2,6,105
2439,2439,,2,3,5,8
2440,2440,,1,2,3,3
2441,2441,,1,4,5,9
2442,2442,,0,0,0,36
2443,2443,,2,4,6,3
2444,2444,,5,0,5,8
2445,2445,,5,0,5,1
2446,2446,,0,6,6,3
2447,2447,,0,0,0,37
2448,2448,,0,3,3,22
2449,2449,,2,4,6,4
2450,2450,,3,2,5,3
2451,2451,,2,4,6,22
2452,2452,,2,4,6,5
2453,2453,,1,3,4,78
2454,2454,,2,2,4,6
2455,2455,,3,2,5,27
2456,2456,,1,5,6,39
2457,2457,,2,3,5,33
2458,2458,,3,2,5,32
2459,2459,,3,1,4,14
2460,2460,,4,1,5,105
2461,2461,,5,1,6,105
2462,2462,,3,3,6,1
2463,2463,,2,4,6,24
2464,2464,,5,0,5,3
2465,2465,,0,6,6,3
2466,2466,,1,5,6,5
2467,2467,,0,6,6,14
2468,2468,,5,1,6,3
2469,2469,,2,4,6,4
2470,2470,,1,5,6,22
2471,2471,,2,3,5,105
2472,2472,,2,3,5,4
2473,2473,,3,3,6,74
2474,2474,,3,0,3,2
2475,2475,,4,0,4,5
2476,2476,,4,1,5,4
2477,2477,,6,0,6,1
2478,2478,,1,1,2,4
2479,2479,,5,1,6,24
2480,2480,,3,1,4,3
2481,2481,,1,1,2,19
2482,2482,,2,4,6,5
2483,2483,,2,2,4,10
2484,2484,,4,1,5,9
2485,2485,,5,1,6,33
2486,2486,,3,1,4,105
2487,2487,,2,3,5,3
2488,2488,,3,3,6,94
2489,2489,,5,0,5,1
2490,2490,,0,5,5,18
2491,2491,,3,3,6,94
2492,2492,,2,4,6,5
2493,2493,,2,4,6,3
2494,2494,,3,3,6,4
2495,2495,,3,3,6,1
2496,2496,,0,4,4,32
2497,2497,,4,2,6,105
2498,2498,,3,2,5,5
2499,2499,,2,4,6,3
2500,2500,,3,3,6,3
2501,2501,,5,1,6,105
2502,2502,,1,4,5,105
2503,2503,,0,6,6,3
2504,2504,,2,3,5,16
2505,2505,,6,0,6,3
2506,2506,,4,0,4,7
2507,2507,,2,3,5,5
2508,2508,,2,0,2,3
2509,2509,,4,2,6,3
2510,2510,,2,2,4,3
2511,2511,,1,2,3,94
2512,2512,,1,3,4,9
2513,2513,,3,3,6,6
2514,2514,,2,2,4,18
2515,2515,,2,4,6,19
2516,2516,,2,4,6,4
2517,2517,,4,0,4,9
2518,2518,,2,4,6,9
2519,2519,,3,3,6,5
2520,2520,,0,6,6,3
2521,2521,,2,2,4,78
2522,2522,,2,4,6,105
2523,2523,,3,3,6,77
2524,2524,,5,1,6,1
2525,2525,,3,3,6,4
2526,2526,,0,6,6,24
2527,2527,,2,2,4,9
2528,2528,,2,4,6,33
2529,2529,,3,2,5,5
2530,2530,,3,3,6,24
2531,2531,,2,1,3,3
2532,2532,,1,4,5,3
2533,2533,,4,2,6,9
2534,2534,,1,2,3,4
2535,2535,,0,0,0,38
2536,2536,,4,2,6,3
2537,2537,,3,3,6,14
2538,2538,,2,4,6,9
2539,2539,,2,4,6,16
2540,2540,,0,3,3,14
2541,2541,,0,1,1,105
2542,2542,,1,5,6,7
2543,2543,,3,3,6,105
2544,2544,,3,2,5,24
2545,2545,,2,3,5,5
2546,2546,,1,1,2,22
2547,2547,,1,4,5,33
2548,2548,,2,3,5,3
2549,2549,,6,0,6,8
2550,2550,,3,2,5,77
2551,2551,,2,4,6,4
2552,2552,,2,3,5,4
2553,2553,,3,3,6,4
2554,2554,,2,4,6,32
2555,2555,,4,0,4,33
2556,2556,,3,3,6,22
2557,2557,,2,4,6,105
2558,2558,,5,0,5,8
2559,2559,,4,2,6,77
2560,2560,,4,2,6,22
2561,2561,,4,2,6,4
2562,2562,,2,0,2,1
2563,2563,,1,3,4,94
2564,2564,,2,4,6,22
2565,2565,,3,1,4,5
2566,2566,,1,1,2,16
2567,2567,,3,3,6,3
2568,2568,,3,3,6,5
2569,2569,,1,4,5,94
2570,2570,,0,5,5,32
2571,2571,,2,3,5,94
2572,2572,,1,5,6,22
2573,2573,,5,0,5,4
2574,2574,,4,0,4,39
2575,2575,,5,0,5,78
2576,2576,,2,4,6,105
2577,2577,,4,2,6,94
2578,2578,,3,2,5,34
2579,2579,,4,1,5,105
2580,2580,,2,4,6,105
2581,2581,,1,3,4,3
2582,2582,,3,3,6,105
2583,2583,,2,3,5,78
2584,2584,,4,2,6,34
2585,2585,,1,5,6,18
2586,2586,,3,3,6,22
2587,2587,,1,5,6,4
2588,2588,,2,2,4,4
2589,2589,,4,2,6,8
2590,2590,,4,2,6,19
2591,2591,,1,5,6,4
2592,2592,,1,5,6,4
2593,2593,,3,3,6,40
2594,2594,,2,2,4,18
2595,2595,,0,4,4,7
2596,2596,,5,1,6,5
2597,2597,,0,6,6,5
2598,2598,,2,2,4,5
2599,2599,,1,3,4,27
2600,2600,,1,3,4,14
2601,2601,,2,2,4,6
2602,2602,,2,3,5,16
2603,2603,,2,1,3,3
2604,2604,,2,4,6,22
2605,2605,,4,2,6,19
2606,2606,,3,0,3,4
2607,2607,,1,2,3,4
2608,2608,,3,2,5,32
2609,2609,,6,0,6,39
2610,2610,,2,3,5,9
2611,2611,,6,0,6,4
2612,2612,,5,1,6,22
2613,2613,,1,5,6,5
2614,2614,,1,3,4,4
2615,2615,,2,4,6,4
2616,2616,,2,3,5,14
2617,2617,,2,2,4,7
2618,2618,,2,4,6,32
2619,2619,,3,3,6,3
2620,2620,,2,4,6,22
2621,2621,,2,3,5,22
2622,2622,,1,3,4,9
2623,2623,,2,2,4,9
2624,2624,,4,2,6,4
2625,2625,,2,2,4,40
2626,2626,,4,1,5,3
2627,2627,,0,5,5,4
2628,2628,,0,6,6,3
2629,2629,,1,3,4,0
2630,2630,,2,4,6,54
2631,2631,,2,4,6,27
2632,2632,,3,3,6,77
2633,2633,,2,2,4,3
2634,2634,,2,4,6,3
2635,2635,,0,3,3,10
2636,2636,,2,1,3,94
2637,2637,,2,2,4,1
2638,2638,,2,2,4,27
2639,2639,,2,3,5,5
2640,2640,,5,1,6,39
2641,2641,,3,3,6,40
2642,2642,,3,3,6,22
2643,2643,,0,0,0,41
2644,2644,,3,2,5,4
2645,2645,,3,3,6,4
2646,2646,,5,1,6,27
2647,2647,,6,0,6,9
2648,2648,,6,0,6,1
2649,2649,,5,1,6,8
2650,2650,,2,4,6,4
2651,2651,,0,2,2,5
2652,2652,,2,2,4,4
2653,2653,,3,3,6,3
2654,2654,,2,4,6,3
2655,2655,,3,3,6,1
2656,2656,,4,2,6,3
2657,2657,,4,2,6,3
2658,2658,,3,0,3,1
2659,2659,,2,4,6,33
2660,2660,,3,3,6,5
2661,2661,,5,0,5,9
2662,2662,,1,5,6,4
2663,2663,,0,5,5,8
2664,2664,,2,3,5,9
2665,2665,,2,3,5,5
2666,2666,,1,3,4,78
2667,2667,,0,3,3,3
2668,2668,,2,2,4,4
2669,2669,,4,1,5,94
2670,2670,,1,1,2,4
2671,2671,,3,0,3,4
2672,2672,,2,3,5,1
2673,2673,,2,3,5,3
2674,2674,,1,4,5,4
2675,2675,,2,3,5,18
2676,2676,,1,4,5,22
2677,2677,,3,1,4,16
2678,2678,,1,1,2,94
2679,2679,,0,2,2,4
2680,2680,,1,3,4,22
2681,2681,,0,4,4,3
2682,2682,,2,1,3,5
2683,2683,,3,2,5,22
2684,2684,,0,5,5,105
2685,2685,,1,2,3,7
2686,2686,,3,2,5,4
2687,2687,,1,4,5,39
2688,2688,,1,2,3,5
2689,2689,,1,2,3,1
2690,2690,,1,4,5,22
2691,2691,,3,2,5,0
2692,2692,,2,1,3,7
2693,2693,,2,3,5,4
2694,2694,,2,3,5,94
2695,2695,,2,3,5,8
2696,2696,,0,5,5,16
2697,2697,,2,1,3,9
2698,2698,,1,3,4,18
2699,2699,,4,0,4,4
2700,2700,,2,3,5,4
2701,2701,,3,2,5,105
2702,2702,,5,0,5,16
2703,2703,,0,3,3,0
2704,2704,,4,1,5,3
2705,2705,,3,0,3,78
2706,2706,,1,4,5,22
2707,2707,,2,3,5,5
2708,2708,,0,3,3,8
2709,2709,,1,4,5,105
2710,2710,,2,1,3,22
2711,2711,,2,3,5,14
2712,2712,,1,2,3,1
2713,2713,,1,3,4,7
2714,2714,,3,1,4,6
2715,2715,,1,2,3,18
2716,2716,,3,2,5,22
2717,2717,,2,2,4,8
2718,2718,,2,2,4,77
2719,2719,,1,2,3,77
2720,2720,,2,1,3,0
2721,2721,,0,0,0,42
2722,2722,,3,2,5,4
2723,2723,,1,3,4,5
2724,2724,,2,3,5,16
2725,2725,,3,2,5,3
2726,2726,,2,2,4,105
2727,2727,,1,3,4,14
2728,2728,,0,4,4,1
2729,2729,,3,1,4,44
2730,2730,,4,1,5,14
2731,2731,,2,3,5,19
2732,2732,,1,2,3,8
2733,2733,,3,1,4,57
2734,2734,,2,2,4,5
2735,2735,,2,2,4,94
2736,2736,,4,1,5,33
2737,2737,,1,3,4,94
2738,2738,,2,2,4,19
2739,2739,,3,2,5,18
2740,2740,,2,3,5,94
2741,2741,,1,4,5,33
2742,2742,,1,3,4,10
2743,2743,,0,4,4,14
2744,2744,,1,1,2,1
2745,2745,,2,3,5,4
2746,2746,,2,3,5,1
2747,2747,,2,3,5,1
2748,2748,,2,2,4,40
2749,2749,,1,3,4,105
2750,2750,,1,2,3,19
2751,2751,,0,5,5,78
2752,2752,,3,2,5,5
2753,2753,,2,2,4,77
2754,2754,,3,1,4,5
2755,2755,,1,2,3,5
2756,2756,,1,0,1,3
2757,2757,,0,4,4,4
2758,2758,,1,4,5,32
2759,2759,,2,1,3,19
2760,2760,,5,0,5,7
2761,2761,,3,1,4,8
2762,2762,,2,3,5,3
2763,2763,,3,1,4,3
2764,2764,,2,3,5,94
2765,2765,,1,3,4,94
2766,2766,,2,2,4,33
2767,2767,,4,1,5,16
2768,2768,,0,1,1,4
2769,2769,,2,3,5,8
2770,2770,,0,4,4,94
2771,2771,,1,4,5,3
2772,2772,,1,4,5,78
2773,2773,,4,1,5,27
2774,2774,,2,3,5,4
2775,2775,,2,3,5,5
2776,2776,,3,2,5,7
2777,2777,,2,3,5,105
2778,2778,,1,4,5,3
2779,2779,,5,0,5,63
2780,2780,,4,1,5,3
2781,2781,,4,1,5,9
2782,2782,,5,0,5,3
2783,2783,,2,3,5,14
2784,2784,,4,1,5,32
2785,2785,,0,5,5,94
2786,2786,,2,2,4,77
2787,2787,,3,1,4,8
2788,2788,,0,5,5,18
2789,2789,,0,0,0,43
2790,2790,,0,5,5,77
2791,2791,,3,2,5,22
2792,2792,,0,1,1,1
2793,2793,,3,2,5,77
2794,2794,,1,2,3,3
2795,2795,,1,3,4,78
2796,2796,,1,2,3,22
2797,2797,,1,2,3,22
2798,2798,,1,4,5,19
2799,2799,,1,3,4,5
2800,2800,,0,5,5,4
2801,2801,,4,1,5,32
2802,2802,,4,1,5,4
2803,2803,,3,0,3,7
2804,2804,,0,5,5,5
2805,2805,,0,5,5,3
2806,2806,,3,2,5,22
2807,2807,,1,1,2,3
2808,2808,,3,2,5,1
2809,2809,,4,1,5,14
2810,2810,,3,1,4,33
2811,2811,,2,3,5,22
2812,2812,,1,0,1,27
2813,2813,,1,4,5,6
2814,2814,,2,3,5,4
2815,2815,,3,2,5,6
2816,2816,,2,2,4,0
2817,2817,,1,4,5,0
2818,2818,,1,3,4,3
2819,2819,,2,1,3,3
2820,2820,,0,5,5,4
2821,2821,,4,1,5,105
2822,2822,,3,2,5,8
2823,2823,,1,4,5,3
2824,2824,,1,1,2,18
2825,2825,,1,4,5,4
2826,2826,,0,5,5,18
2827,2827,,3,2,5,34
2828,2828,,2,1,3,22
2829,2829,,1,4,5,16
2830,2830,,3,2,5,1
2831,2831,,0,5,5,18
2832,2832,,1,0,1,9
2833,2833,,5,0,5,105
2834,2834,,4,1,5,105
2835,2835,,2,3,5,1
2836,2836,,2,2,4,4
2837,2837,,3,2,5,33
2838,2838,,3,1,4,94
2839,2839,,1,4,5,44
2840,2840,,3,2,5,4
2841,2841,,4,1,5,5
2842,2842,,0,5,5,33
2843,2843,,0,2,2,3
2844,2844,,1,3,4,3
2845,2845,,2,3,5,3
2846,2846,,4,1,5,3
2847,2847,,2,1,3,4
2848,2848,,2,0,2,19
2849,2849,,3,2,5,16
2850,2850,,1,1,2,8
2851,2851,,1,4,5,0
2852,2852,,1,4,5,5
2853,2853,,5,0,5,78
2854,2854,,3,2,5,5
2855,2855,,2,3,5,4
2856,2856,,1,4,5,16
2857,2857,,3,2,5,1
2858,2858,,0,5,5,4
2859,2859,,1,4,5,4
2860,2860,,1,1,2,4
2861,2861,,2,3,5,24
2862,2862,,3,1,4,0
2863,2863,,4,1,5,8
2864,2864,,1,4,5,105
2865,2865,,3,2,5,4
2866,2866,,1,2,3,78
2867,2867,,2,3,5,82
2868,2868,,3,2,5,1
2869,2869,,1,4,5,34
2870,2870,,4,1,5,77
2871,2871,,3,2,5,2
2872,2872,,3,2,5,16
2873,2873,,2,3,5,5
2874,2874,,2,2,4,45
2875,2875,,2,3,5,105
2876,2876,,3,2,5,19
2877,2877,,4,1,5,6
2878,2878,,1,2,3,16
2879,2879,,1,2,3,74
2880,2880,,1,2,3,4
2881,2881,,2,0,2,4
2882,2882,,0,0,0,46
2883,2883,,2,3,5,33
2884,2884,,1,4,5,1
2885,2885,,5,0,5,3
2886,2886,,1,3,4,19
2887,2887,,1,4,5,4
2888,2888,,3,2,5,1
2889,2889,,3,1,4,4
2890,2890,,1,4,5,1
2891,2891,,3,1,4,8
2892,2892,,3,2,5,78
2893,2893,,3,2,5,3
2894,2894,,0,3,3,7
2895,2895,,3,1,4,22
2896,2896,,0,2,2,9
2897,2897,,4,1,5,3
2898,2898,,4,1,5,22
2899,2899,,2,2,4,94
2900,2900,,1,2,3,5
2901,2901,,1,3,4,3
2902,2902,,0,0,0,47
2903,2903,,2,3,5,94
2904,2904,,1,4,5,3
2905,2905,,4,1,5,5
2906,2906,,2,2,4,19
2907,2907,,2,1,3,7
2908,2908,,0,1,1,3
2909,2909,,1,4,5,57
2910,2910,,0,1,1,18
2911,2911,,3,0,3,105
2912,2912,,4,0,4,34
2913,2913,,4,1,5,77
2914,2914,,1,4,5,57
2915,2915,,1,3,4,19
2916,2916,,4,1,5,4
2917,2917,,5,0,5,8
2918,2918,,2,3,5,1
2919,2919,,2,1,3,3
2920,2920,,0,5,5,3
2921,2921,,3,2,5,4
2922,2922,,1,4,5,19
2923,2923,,2,3,5,4
2924,2924,,4,1,5,14
2925,2925,,4,1,5,4
2926,2926,,2,2,4,78
2927,2927,,0,5,5,4
2928,2928,,5,0,5,8
2929,2929,,2,2,4,2
2930,2930,,2,3,5,7
2931,2931,,0,4,4,22
2932,2932,,2,0,2,9
2933,2933,,3,2,5,77
2934,2934,,2,3,5,19
2935,2935,,3,1,4,9
2936,2936,,0,5,5,3
2937,2937,,0,2,2,27
2938,2938,,2,2,4,105
2939,2939,,0,4,4,9
2940,2940,,2,3,5,14
2941,2941,,3,2,5,4
2942,2942,,1,1,2,3
2943,2943,,4,1,5,57
2944,2944,,1,2,3,9
2945,2945,,3,1,4,4
2946,2946,,0,1,1,8
2947,2947,,1,1,2,8
2948,2948,,3,2,5,3
2949,2949,,1,2,3,4
2950,2950,,3,2,5,3
2951,2951,,1,1,2,3
2952,2952,,1,3,4,3
2953,2953,,1,3,4,78
2954,2954,,1,2,3,5
2955,2955,,0,5,5,18
2956,2956,,0,4,4,5
2957,2957,,2,2,4,5
2958,2958,,3,2,5,4
2959,2959,,3,2,5,3
2960,2960,,2,1,3,5
2961,2961,,4,1,5,1
2962,2962,,1,2,3,3
2963,2963,,1,1,2,1
2964,2964,,3,2,5,3
2965,2965,,4,1,5,3
2966,2966,,1,2,3,22
2967,2967,,1,4,5,3
2968,2968,,1,3,4,5
2969,2969,,1,2,3,9
2970,2970,,4,0,4,22
2971,2971,,5,0,5,50
2972,2972,,2,3,5,94
2973,2973,,1,3,4,4
2974,2974,,2,3,5,34
2975,2975,,2,3,5,5
2976,2976,,2,3,5,3
2977,2977,,2,3,5,24
2978,2978,,1,2,3,4
2979,2979,,2,3,5,94
2980,2980,,2,3,5,8
2981,2981,,1,0,1,1
2982,2982,,2,3,5,3
2983,2983,,1,4,5,0
2984,2984,,1,4,5,4
2985,2985,,2,3,5,94
2986,2986,,2,2,4,4
2987,2987,,4,0,4,32
2988,2988,,0,0,0,48
2989,2989,,3,2,5,22
2990,2990,,1,4,5,18
2991,2991,,0,3,3,4
2992,2992,,0,3,3,8
2993,2993,,2,3,5,5
2994,2994,,3,2,5,4
2995,2995,,1,4,5,1
2996,2996,,3,0,3,1
2997,2997,,3,2,5,4
2998,2998,,3,2,5,14
2999,2999,,3,2,5,18
3000,3000,,2,2,4,78
3001,3001,,5,0,5,22
3002,3002,,0,0,0,49
3003,3003,,2,3,5,3
3004,3004,,2,1,3,8
3005,3005,,0,1,1,5
3006,3006,,2,2,4,3
3007,3007,,0,4,4,78
3008,3008,,1,2,3,5
3009,3009,,5,0,5,4
3010,3010,,3,2,5,9
3011,3011,,0,3,3,3
3012,3012,,1,4,5,5
3013,3013,,1,3,4,78
3014,3014,,0,5,5,50
3015,3015,,2,2,4,5
3016,3016,,0,0,0,51
3017,3017,,1,3,4,4
3018,3018,,3,0,3,1
3019,3019,,3,0,3,19
3020,3020,,4,0,4,4
3021,3021,,0,2,2,78
3022,3022,,2,2,4,105
3023,3023,,2,2,4,3
3024,3024,,0,0,0,52
3025,3025,,1,1,2,1
3026,3026,,2,2,4,33
3027,3027,,2,2,4,5
3028,3028,,2,2,4,3
3029,3029,,1,3,4,5
3030,3030,,2,2,4,3
3031,3031,,1,3,4,5
3032,3032,,3,1,4,3
3033,3033,,1,3,4,5
3034,3034,,1,3,4,8
3035,3035,,1,3,4,94
3036,3036,,3,1,4,4
3037,3037,,2,1,3,4
3038,3038,,2,2,4,4
3039,3039,,1,3,4,77
3040,3040,,0,4,4,1
3041,3041,,0,4,4,9
3042,3042,,2,2,4,105
3043,3043,,2,2,4,4
3044,3044,,3,1,4,3
3045,3045,,0,3,3,6
3046,3046,,2,2,4,105
3047,3047,,2,2,4,77
3048,3048,,2,2,4,19
3049,3049,,2,2,4,40
3050,3050,,0,3,3,4
3051,3051,,3,1,4,5
3052,3052,,3,1,4,14
3053,3053,,2,2,4,6
3054,3054,,4,0,4,8
3055,3055,,1,3,4,4
3056,3056,,2,2,4,78
3057,3057,,3,1,4,9
3058,3058,,2,2,4,16
3059,3059,,0,4,4,5
3060,3060,,2,2,4,78
3061,3061,,4,0,4,7
3062,3062,,4,0,4,4
3063,3063,,0,3,3,4
3064,3064,,1,3,4,33
3065,3065,,2,2,4,94
3066,3066,,2,0,2,6
3067,3067,,2,2,4,94
3068,3068,,1,0,1,9
3069,3069,,4,0,4,5
3070,3070,,2,0,2,14
3071,3071,,0,4,4,9
3072,3072,,1,3,4,94
3073,3073,,3,1,4,5
3074,3074,,0,4,4,5
3075,3075,,0,4,4,5
3076,3076,,1,3,4,105
3077,3077,,2,1,3,1
3078,3078,,2,2,4,94
3079,3079,,2,2,4,22
3080,3080,,1,2,3,78
3081,3081,,0,3,3,16
3082,3082,,4,0,4,22
3083,3083,,1,1,2,4
3084,3084,,1,0,1,94
3085,3085,,2,0,2,14
3086,3086,,0,4,4,5
3087,3087,,2,1,3,5
3088,3088,,1,3,4,3
3089,3089,,1,3,4,33
3090,3090,,1,1,2,18
3091,3091,,2,2,4,1
3092,3092,,0,2,2,6
3093,3093,,2,0,2,18
3094,3094,,0,2,2,33
3095,3095,,3,1,4,94
3096,3096,,1,3,4,19
3097,3097,,0,3,3,7
3098,3098,,0,4,4,4
3099,3099,,1,1,2,4
3100,3100,,1,1,2,185
3101,3101,,4,0,4,78
3102,3102,,3,1,4,78
3103,3103,,2,0,2,3
3104,3104,,0,3,3,18
3105,3105,,2,1,3,5
3106,3106,,1,3,4,16
3107,3107,,0,1,1,8
3108,3108,,1,0,1,288
3109,3109,,0,4,4,3
3110,3110,,3,1,4,22
3111,3111,,2,1,3,78
3112,3112,,0,3,3,18
3113,3113,,0,3,3,5
3114,3114,,2,1,3,94
3115,3115,,2,2,4,3
3116,3116,,3,0,3,22
3117,3117,,2,1,3,94
3118,3118,,2,0,2,4
3119,3119,,4,0,4,4
3120,3120,,4,0,4,22
3121,3121,,2,2,4,94
3122,3122,,0,4,4,4
3123,3123,,1,3,4,39
3124,3124,,1,3,4,24
3125,3125,,2,2,4,32
3126,3126,,1,2,3,32
3127,3127,,2,2,4,258
3128,3128,,1,2,3,4
3129,3129,,3,1,4,22
3130,3130,,2,1,3,22
3131,3131,,2,2,4,7
3132,3132,,2,1,3,5
3133,3133,,1,0,1,8
3134,3134,,0,3,3,18
3135,3135,,2,1,3,3
3136,3136,,1,2,3,5
3137,3137,,0,4,4,78
3138,3138,,0,4,4,78
3139,3139,,2,2,4,33
3140,3140,,2,2,4,105
3141,3141,,2,2,4,9
3142,3142,,0,1,1,33
3143,3143,,0,4,4,3
3144,3144,,2,0,2,22
3145,3145,,1,2,3,3
3146,3146,,1,3,4,3
3147,3147,,1,1,2,22
3148,3148,,3,1,4,3
3149,3149,,3,1,4,16
3150,3150,,1,3,4,3
3151,3151,,1,3,4,94
3152,3152,,3,1,4,19
3153,3153,,3,1,4,105
3154,3154,,2,2,4,94
3155,3155,,3,1,4,4
3156,3156,,3,1,4,3
3157,3157,,2,2,4,5
3158,3158,,2,2,4,16
3159,3159,,3,0,3,9
3160,3160,,2,1,3,5
3161,3161,,0,2,2,8
3162,3162,,2,2,4,4
3163,3163,,3,1,4,78
3164,3164,,3,1,4,33
3165,3165,,0,3,3,18
3166,3166,,1,1,2,3
3167,3167,,0,2,2,34
3168,3168,,0,1,1,18
3169,3169,,2,2,4,16
3170,3170,,0,4,4,4
3171,3171,,3,1,4,3
3172,3172,,2,2,4,3
3173,3173,,0,4,4,94
3174,3174,,2,2,4,1
3175,3175,,0,2,2,5
3176,3176,,2,2,4,27
3177,3177,,1,2,3,1
3178,3178,,1,1,2,105
3179,3179,,0,2,2,16
3180,3180,,2,2,4,0
3181,3181,,1,1,2,105
3182,3182,,3,1,4,70
3183,3183,,2,2,4,5
3184,3184,,2,2,4,1
3185,3185,,0,0,0,53
3186,3186,,2,2,4,77
3187,3187,,2,2,4,94
3188,3188,,2,2,4,3
3189,3189,,2,0,2,77
3190,3190,,0,2,2,94
3191,3191,,2,2,4,9
3192,3192,,3,1,4,94
3193,3193,,3,1,4,8
3194,3194,,1,3,4,78
3195,3195,,2,2,4,105
3196,3196,,1,3,4,3
3197,3197,,2,2,4,1
3198,3198,,4,0,4,19
3199,3199,,4,0,4,4
3200,3200,,0,2,2,3
3201,3201,,0,3,3,32
3202,3202,,2,2,4,54
3203,3203,,1,3,4,33
3204,3204,,1,3,4,32
3205,3205,,1,3,4,5
3206,3206,,1,0,1,105
3207,3207,,3,0,3,3
3208,3208,,0,2,2,0
3209,3209,,2,2,4,105
3210,3210,,0,3,3,3
3211,3211,,1,3,4,18
3212,3212,,1,2,3,5
3213,3213,,1,3,4,3
3214,3214,,1,2,3,3
3215,3215,,2,0,2,24
3216,3216,,3,1,4,33
3217,3217,,1,3,4,5
3218,3218,,1,1,2,105
3219,3219,,3,0,3,33
3220,3220,,3,1,4,78
3221,3221,,3,0,3,77
3222,3222,,3,1,4,3
3223,3223,,0,2,2,14
3224,3224,,2,1,3,32
3225,3225,,3,0,3,1
3226,3226,,3,1,4,18
3227,3227,,2,2,4,3
3228,3228,,3,1,4,3
3229,3229,,1,1,2,5
3230,3230,,0,4,4,22
3231,3231,,1,3,4,3
3232,3232,,1,3,4,18
3233,3233,,1,2,3,4
3234,3234,,2,2,4,3
3235,3235,,2,1,3,5
3236,3236,,0,3,3,9
3237,3237,,1,2,3,0
3238,3238,,2,2,4,94
3239,3239,,1,3,4,10
3240,3240,,1,3,4,0
3241,3241,,0,3,3,33
3242,3242,,1,3,4,94
3243,3243,,1,3,4,0
3244,3244,,1,2,3,77
3245,3245,,3,1,4,105
3246,3246,,0,3,3,94
3247,3247,,2,2,4,22
3248,3248,,1,3,4,14
3249,3249,,2,2,4,3
3250,3250,,2,1,3,7
3251,3251,,1,3,4,7
3252,3252,,0,0,0,55
3253,3253,,1,3,4,9
3254,3254,,0,4,4,3
3255,3255,,1,1,2,3
3256,3256,,3,1,4,3
3257,3257,,0,4,4,5
3258,3258,,1,2,3,4
3259,3259,,2,1,3,3
3260,3260,,1,1,2,3
3261,3261,,2,1,3,10
3262,3262,,3,1,4,77
3263,3263,,2,2,4,5
3264,3264,,2,1,3,105
3265,3265,,3,0,3,10
3266,3266,,1,3,4,18
3267,3267,,1,1,2,76
3268,3268,,1,3,4,8
3269,3269,,1,3,4,0
3270,3270,,2,2,4,22
3271,3271,,1,1,2,3
3272,3272,,1,3,4,5
3273,3273,,4,0,4,3
3274,3274,,1,3,4,32
3275,3275,,0,0,0,56
3276,3276,,3,1,4,8
3277,3277,,0,4,4,33
3278,3278,,0,1,1,7
3279,3279,,3,1,4,3
3280,3280,,1,2,3,16
3281,3281,,2,1,3,27
3282,3282,,0,4,4,3
3283,3283,,0,4,4,94
3284,3284,,4,0,4,105
3285,3285,,2,2,4,8
3286,3286,,3,1,4,32
3287,3287,,3,0,3,105
3288,3288,,0,4,4,4
3289,3289,,2,1,3,4
3290,3290,,2,2,4,3
3291,3291,,2,2,4,33
3292,3292,,0,4,4,57
3293,3293,,2,0,2,94
3294,3294,,4,0,4,0
3295,3295,,4,0,4,3
3296,3296,,0,4,4,5
3297,3297,,2,2,4,5
3298,3298,,2,2,4,33
3299,3299,,0,2,2,6
3300,3300,,4,0,4,3
3301,3301,,3,1,4,22
3302,3302,,3,1,4,5
3303,3303,,2,1,3,14
3304,3304,,0,0,0,58
3305,3305,,0,4,4,19
3306,3306,,1,2,3,6
3307,3307,,1,3,4,3
3308,3308,,0,0,0,59
3309,3309,,0,4,4,3
3310,3310,,2,2,4,9
3311,3311,,1,3,4,14
3312,3312,,0,2,2,5
3313,3313,,1,3,4,22
3314,3314,,0,4,4,18
3315,3315,,2,1,3,4
3316,3316,,2,2,4,19
3317,3317,,3,1,4,4
3318,3318,,3,1,4,9
3319,3319,,1,1,2,3
3320,3320,,0,4,4,94
3321,3321,,1,3,4,1
3322,3322,,0,4,4,8
3323,3323,,2,2,4,3
3324,3324,,0,3,3,1
3325,3325,,2,2,4,19
3326,3326,,3,1,4,9
3327,3327,,1,1,2,5
3328,3328,,2,2,4,22
3329,3329,,1,2,3,18
3330,3330,,0,0,0,60
3331,3331,,4,0,4,1
3332,3332,,2,2,4,3
3333,3333,,1,3,4,78
3334,3334,,0,4,4,10
3335,3335,,3,1,4,3
3336,3336,,1,3,4,94
3337,3337,,2,1,3,5
3338,3338,,1,1,2,14
3339,3339,,1,2,3,78
3340,3340,,1,3,4,1
3341,3341,,1,3,4,3
3342,3342,,2,2,4,5
3343,3343,,1,2,3,32
3344,3344,,3,1,4,9
3345,3345,,2,2,4,94
3346,3346,,2,2,4,18
3347,3347,,0,0,0,61
3348,3348,,3,1,4,8
3349,3349,,1,0,1,10
3350,3350,,3,1,4,3
3351,3351,,0,1,1,16
3352,3352,,0,2,2,27
3353,3353,,2,0,2,4
3354,3354,,1,3,4,34
3355,3355,,0,4,4,105
3356,3356,,3,1,4,105
3357,3357,,3,1,4,94
3358,3358,,4,0,4,7
3359,3359,,2,2,4,105
3360,3360,,2,1,3,22
3361,3361,,2,2,4,4
3362,3362,,2,2,4,3
3363,3363,,3,0,3,4
3364,3364,,2,2,4,105
3365,3365,,0,1,1,105
3366,3366,,2,2,4,18
3367,3367,,1,2,3,18
3368,3368,,2,2,4,22
3369,3369,,2,1,3,1
3370,3370,,3,1,4,1
3371,3371,,1,2,3,22
3372,3372,,0,1,1,0
3373,3373,,3,1,4,105
3374,3374,,0,4,4,14
3375,3375,,1,3,4,32
3376,3376,,2,2,4,78
3377,3377,,3,1,4,16
3378,3378,,0,0,0,62
3379,3379,,4,0,4,4
3380,3380,,1,3,4,63
3381,3381,,2,1,3,64
3382,3382,,2,0,2,9
3383,3383,,0,0,0,65
3384,3384,,0,0,0,66
3385,3385,,2,2,4,77
3386,3386,,3,1,4,94
3387,3387,,2,0,2,7
3388,3388,,2,2,4,3
3389,3389,,0,0,0,67
3390,3390,,0,2,2,33
3391,3391,,0,4,4,8
3392,3392,,3,0,3,4
3393,3393,,2,2,4,29
3394,3394,,0,4,4,39
3395,3395,,0,0,0,68
3396,3396,,2,2,4,9
3397,3397,,1,0,1,1
3398,3398,,1,1,2,3
3399,3399,,2,2,4,5
3400,3400,,1,1,2,16
3401,3401,,0,0,0,69
3402,3402,,4,0,4,4
3403,3403,,0,2,2,4
3404,3404,,2,2,4,24
3405,3405,,2,0,2,3
3406,3406,,1,1,2,1
3407,3407,,2,2,4,16
3408,3408,,2,2,4,19
3409,3409,,2,2,4,4
3410,3410,,2,2,4,4
3411,3411,,2,2,4,3
3412,3412,,2,2,4,77
3413,3413,,1,3,4,0
3414,3414,,0,4,4,3
3415,3415,,0,4,4,33
3416,3416,,1,3,4,78
3417,3417,,0,4,4,4
3418,3418,,2,2,4,8
3419,3419,,2,2,4,33
3420,3420,,1,1,2,3
3421,3421,,1,3,4,5
3422,3422,,3,1,4,33
3423,3423,,2,2,4,77
3424,3424,,4,0,4,78
3425,3425,,1,1,2,3
3426,3426,,1,3,4,94
3427,3427,,1,3,4,3
3428,3428,,1,3,4,9
3429,3429,,3,1,4,24
3430,3430,,2,1,3,1
3431,3431,,1,2,3,18
3432,3432,,3,1,4,105
3433,3433,,1,2,3,14
3434,3434,,0,3,3,7
3435,3435,,2,2,4,4
3436,3436,,0,2,2,33
3437,3437,,2,1,3,33
3438,3438,,1,3,4,5
3439,3439,,2,2,4,9
3440,3440,,2,2,4,18
3441,3441,,2,2,4,8
3442,3442,,4,0,4,4
3443,3443,,0,2,2,4
3444,3444,,2,2,4,16
3445,3445,,3,1,4,22
3446,3446,,1,2,3,82
3447,3447,,3,1,4,5
3448,3448,,4,0,4,78
3449,3449,,3,0,3,8
3450,3450,,4,0,4,8
3451,3451,,2,1,3,5
3452,3452,,0,4,4,34
3453,3453,,0,2,2,18
3454,3454,,2,2,4,94
3455,3455,,2,2,4,77
3456,3456,,2,2,4,7
3457,3457,,3,1,4,94
3458,3458,,2,2,4,6
3459,3459,,1,0,1,16
3460,3460,,3,1,4,33
3461,3461,,3,1,4,1
3462,3462,,1,3,4,10
3463,3463,,1,3,4,14
3464,3464,,1,3,4,77
3465,3465,,1,3,4,33
3466,3466,,0,4,4,3
3467,3467,,1,3,4,70
3468,3468,,1,2,3,7
3469,3469,,2,2,4,0
3470,3470,,3,1,4,7
3471,3471,,0,4,4,32
3472,3472,,2,2,4,3
3473,3473,,0,2,2,18
3474,3474,,3,1,4,7
3475,3475,,1,2,3,4
3476,3476,,1,1,2,27
3477,3477,,1,2,3,105
3478,3478,,0,0,0,71
3479,3479,,1,3,4,1
3480,3480,,2,2,4,3
3481,3481,,2,2,4,81
3482,3482,,0,4,4,3
3483,3483,,1,3,4,5
3484,3484,,4,0,4,27
3485,3485,,0,4,4,9
3486,3486,,0,1,1,16
3487,3487,,0,4,4,33
3488,3488,,2,1,3,22
3489,3489,,2,2,4,21
3490,3490,,2,2,4,22
3491,3491,,0,4,4,3
3492,3492,,0,4,4,8
3493,3493,,3,0,3,4
3494,3494,,2,0,2,34
3495,3495,,2,1,3,14
3496,3496,,1,2,3,72
3497,3497,,1,2,3,9
3498,3498,,1,1,2,105
3499,3499,,0,3,3,9
3500,3500,,3,0,3,34
3501,3501,,1,2,3,9
3502,3502,,1,2,3,22
3503,3503,,1,2,3,3
3504,3504,,1,2,3,3
3505,3505,,2,1,3,72
3506,3506,,2,1,3,3
3507,3507,,3,0,3,78
3508,3508,,0,2,2,4
3509,3509,,2,1,3,57
3510,3510,,0,3,3,4
3511,3511,,2,1,3,10
3512,3512,,3,0,3,4
3513,3513,,0,2,2,18
3514,3514,,0,2,2,77
3515,3515,,1,2,3,3
3516,3516,,1,2,3,4
3517,3517,,2,1,3,1
3518,3518,,0,3,3,3
3519,3519,,0,3,3,9
3520,3520,,1,1,2,27
3521,3521,,0,1,1,18
3522,3522,,0,3,3,7
3523,3523,,0,3,3,4
3524,3524,,0,3,3,16
3525,3525,,0,3,3,9
3526,3526,,2,0,2,4
3527,3527,,0,3,3,3
3528,3528,,1,0,1,27
3529,3529,,1,2,3,8
3530,3530,,0,0,0,73
3531,3531,,3,0,3,22
3532,3532,,2,1,3,4
3533,3533,,0,2,2,105
3534,3534,,1,2,3,18
3535,3535,,0,2,2,3
3536,3536,,1,2,3,5
3537,3537,,1,1,2,8
3538,3538,,1,1,2,4
3539,3539,,2,0,2,33
3540,3540,,2,1,3,22
3541,3541,,3,0,3,8
3542,3542,,1,1,2,105
3543,3543,,3,0,3,33
3544,3544,,2,1,3,5
3545,3545,,1,2,3,5
3546,3546,,0,1,1,3
3547,3547,,0,2,2,9
3548,3548,,1,2,3,9
3549,3549,,1,2,3,1
3550,3550,,2,1,3,33
3551,3551,,2,1,3,4
3552,3552,,1,1,2,9
3553,3553,,2,1,3,74
3554,3554,,1,2,3,75
3555,3555,,1,2,3,76
3556,3556,,2,1,3,8
3557,3557,,1,2,3,39
3558,3558,,2,1,3,3
3559,3559,,2,0,2,27
3560,3560,,1,2,3,78
3561,3561,,2,1,3,14
3562,3562,,2,1,3,1
3563,3563,,3,0,3,3
3564,3564,,0,2,2,77
3565,3565,,1,1,2,5
3566,3566,,1,0,1,24
3567,3567,,0,3,3,14
3568,3568,,0,1,1,78
3569,3569,,1,0,1,33
3570,3570,,1,2,3,29
3571,3571,,2,1,3,82
3572,3572,,0,3,3,18
3573,3573,,3,0,3,78
3574,3574,,2,1,3,19
3575,3575,,2,1,3,5
3576,3576,,0,3,3,94
3577,3577,,2,1,3,94
3578,3578,,0,3,3,94
3579,3579,,1,2,3,8
3580,3580,,3,0,3,3
3581,3581,,3,0,3,33
3582,3582,,2,0,2,77
3583,3583,,0,3,3,32
3584,3584,,1,2,3,5
3585,3585,,1,2,3,4
3586,3586,,1,2,3,19
3587,3587,,1,2,3,3
3588,3588,,1,1,2,4
3589,3589,,1,1,2,139
3590,3590,,2,1,3,3
3591,3591,,1,2,3,1
3592,3592,,1,2,3,3
3593,3593,,2,1,3,4
3594,3594,,1,2,3,4
3595,3595,,2,1,3,3
3596,3596,,0,1,1,18
3597,3597,,1,1,2,4
3598,3598,,1,2,3,33
3599,3599,,0,2,2,78
3600,3600,,0,2,2,4
3601,3601,,0,3,3,18
3602,3602,,1,2,3,22
3603,3603,,2,0,2,6
3604,3604,,1,2,3,5
3605,3605,,2,1,3,6
3606,3606,,2,0,2,94
3607,3607,,3,0,3,0
3608,3608,,1,1,2,16
3609,3609,,1,2,3,14
3610,3610,,0,0,0,79
3611,3611,,2,0,2,94
3612,3612,,2,0,2,82
3613,3613,,2,1,3,19
3614,3614,,0,3,3,3
3615,3615,,1,2,3,22
3616,3616,,0,3,3,22
3617,3617,,1,2,3,5
3618,3618,,1,1,2,8
3619,3619,,1,2,3,0
3620,3620,,0,3,3,33
3621,3621,,1,1,2,169
3622,3622,,1,1,2,94
3623,3623,,1,2,3,3
3624,3624,,1,2,3,4
3625,3625,,2,1,3,1
3626,3626,,3,0,3,4
3627,3627,,2,1,3,105
3628,3628,,1,2,3,18
3629,3629,,0,0,0,80
3630,3630,,1,1,2,9
3631,3631,,2,1,3,4
3632,3632,,1,1,2,81
3633,3633,,0,3,3,3
3634,3634,,1,1,2,78
3635,3635,,1,2,3,27
3636,3636,,1,1,2,8
3637,3637,,0,3,3,39
3638,3638,,1,2,3,5
3639,3639,,0,3,3,5
3640,3640,,0,3,3,18
3641,3641,,2,1,3,3
3642,3642,,2,1,3,33
3643,3643,,3,0,3,22
3644,3644,,1,2,3,24
3645,3645,,2,1,3,82
3646,3646,,1,0,1,132
3647,3647,,2,1,3,94
3648,3648,,0,3,3,34
3649,3649,,0,0,0,83
3650,3650,,2,1,3,105
3651,3651,,0,1,1,10
3652,3652,,1,0,1,4
3653,3653,,1,1,2,3
3654,3654,,3,0,3,1
3655,3655,,2,1,3,8
3656,3656,,1,1,2,105
3657,3657,,2,1,3,32
3658,3658,,0,2,2,94
3659,3659,,2,1,3,78
3660,3660,,2,1,3,10
3661,3661,,2,0,2,24
3662,3662,,1,2,3,3
3663,3663,,0,1,1,3
3664,3664,,1,0,1,4
3665,3665,,3,0,3,32
3666,3666,,3,0,3,1
3667,3667,,1,2,3,5
3668,3668,,1,2,3,33
3669,3669,,1,2,3,94
3670,3670,,2,1,3,14
3671,3671,,1,0,1,16
3672,3672,,0,2,2,1
3673,3673,,2,1,3,57
3674,3674,,2,1,3,1
3675,3675,,1,2,3,8
3676,3676,,3,0,3,3
3677,3677,,2,1,3,14
3678,3678,,0,3,3,4
3679,3679,,1,1,2,18
3680,3680,,1,2,3,8
3681,3681,,1,2,3,19
3682,3682,,2,1,3,105
3683,3683,,0,2,2,4
3684,3684,,1,2,3,27
3685,3685,,0,0,0,84
3686,3686,,2,1,3,33
3687,3687,,2,1,3,3
3688,3688,,1,1,2,94
3689,3689,,0,3,3,16
3690,3690,,1,2,3,4
3691,3691,,1,2,3,14
3692,3692,,0,3,3,78
3693,3693,,1,2,3,22
3694,3694,,2,1,3,1
3695,3695,,0,0,0,85
3696,3696,,1,2,3,14
3697,3697,,0,3,3,16
3698,3698,,1,0,1,22
3699,3699,,2,0,2,8
3700,3700,,2,1,3,4
3701,3701,,2,1,3,16
3702,3702,,1,1,2,105
3703,3703,,1,2,3,33
3704,3704,,0,2,2,22
3705,3705,,0,2,2,33
3706,3706,,2,0,2,3
3707,3707,,1,1,2,8
3708,3708,,3,0,3,3
3709,3709,,0,2,2,4
3710,3710,,2,1,3,5
3711,3711,,0,3,3,5
3712,3712,,1,2,3,33
3713,3713,,1,0,1,4
3714,3714,,0,1,1,8
3715,3715,,1,2,3,33
3716,3716,,2,1,3,22
3717,3717,,0,0,0,86
3718,3718,,1,2,3,33
3719,3719,,1,2,3,78
3720,3720,,1,2,3,82
3721,3721,,0,1,1,204
3722,3722,,2,1,3,18
3723,3723,,1,2,3,19
3724,3724,,0,1,1,34
3725,3725,,0,3,3,10
3726,3726,,0,0,0,87
3727,3727,,1,2,3,105
3728,3728,,3,0,3,1
3729,3729,,3,0,3,22
3730,3730,,0,1,1,8
3731,3731,,2,1,3,78
3732,3732,,0,1,1,8
3733,3733,,2,1,3,14
3734,3734,,1,2,3,14
3735,3735,,0,3,3,27
3736,3736,,0,2,2,33
3737,3737,,1,1,2,1
3738,3738,,3,0,3,5
3739,3739,,2,1,3,105
3740,3740,,3,0,3,24
3741,3741,,0,2,2,6
3742,3742,,1,2,3,3
3743,3743,,2,1,3,105
3744,3744,,3,0,3,5
3745,3745,,0,2,2,10
3746,3746,,0,3,3,3
3747,3747,,1,2,3,4
3748,3748,,1,0,1,3
3749,3749,,2,1,3,3
3750,3750,,1,1,2,18
3751,3751,,1,2,3,94
3752,3752,,0,3,3,4
3753,3753,,3,0,3,3
3754,3754,,1,2,3,22
3755,3755,,3,0,3,24
3756,3756,,2,1,3,3
3757,3757,,1,1,2,7
3758,3758,,1,0,1,3
3759,3759,,1,2,3,4
3760,3760,,1,2,3,18
3761,3761,,3,0,3,5
3762,3762,,2,1,3,8
3763,3763,,1,2,3,4
3764,3764,,0,2,2,7
3765,3765,,2,1,3,4
3766,3766,,1,2,3,5
3767,3767,,0,2,2,3
3768,3768,,2,1,3,3
3769,3769,,2,1,3,9
3770,3770,,1,2,3,4
3771,3771,,2,1,3,8
3772,3772,,2,1,3,14
3773,3773,,1,2,3,22
3774,3774,,2,1,3,5
3775,3775,,1,1,2,16
3776,3776,,1,2,3,77
3777,3777,,3,0,3,77
3778,3778,,3,0,3,16
3779,3779,,0,3,3,1
3780,3780,,0,0,0,88
3781,3781,,0,3,3,78
3782,3782,,1,2,3,8
3783,3783,,0,1,1,5
3784,3784,,2,1,3,105
3785,3785,,2,1,3,77
3786,3786,,3,0,3,8
3787,3787,,0,1,1,22
3788,3788,,0,3,3,22
3789,3789,,2,1,3,94
3790,3790,,1,2,3,94
3791,3791,,2,1,3,3
3792,3792,,0,3,3,8
3793,3793,,0,1,1,94
3794,3794,,0,2,2,18
3795,3795,,1,2,3,18
3796,3796,,0,3,3,22
3797,3797,,1,2,3,14
3798,3798,,1,2,3,7
3799,3799,,1,2,3,3
3800,3800,,2,1,3,1
3801,3801,,1,2,3,3
3802,3802,,1,2,3,78
3803,3803,,2,1,3,4
3804,3804,,2,1,3,89
3805,3805,,1,2,3,89
3806,3806,,0,0,0,90
3807,3807,,0,0,0,91
3808,3808,,1,2,3,105
3809,3809,,2,0,2,78
3810,3810,,2,1,3,22
3811,3811,,0,3,3,4
3812,3812,,1,1,2,77
3813,3813,,1,0,1,92
3814,3814,,1,0,1,22
3815,3815,,3,0,3,4
3816,3816,,2,1,3,77
3817,3817,,1,0,1,3
3818,3818,,1,0,1,94
3819,3819,,2,1,3,1
3820,3820,,1,0,1,1
3821,3821,,1,2,3,22
3822,3822,,1,0,1,77
3823,3823,,1,1,2,94
3824,3824,,2,1,3,94
3825,3825,,0,1,1,8
3826,3826,,0,2,2,93
3827,3827,,3,0,3,4
3828,3828,,1,2,3,22
3829,3829,,1,2,3,33
3830,3830,,1,2,3,77
3831,3831,,0,2,2,105
3832,3832,,1,1,2,4
3833,3833,,0,3,3,10
3834,3834,,0,3,3,9
3835,3835,,2,1,3,1
3836,3836,,0,3,3,94
3837,3837,,2,1,3,16
3838,3838,,1,0,1,39
3839,3839,,3,0,3,22
3840,3840,,1,1,2,4
3841,3841,,2,0,2,105
3842,3842,,1,2,3,4
3843,3843,,1,1,2,22
3844,3844,,1,2,3,22
3845,3845,,3,0,3,22
3846,3846,,3,0,3,105
3847,3847,,1,2,3,22
3848,3848,,0,2,2,10
3849,3849,,2,1,3,19
3850,3850,,1,1,2,1
3851,3851,,3,0,3,3
3852,3852,,2,1,3,5
3853,3853,,1,2,3,9
3854,3854,,0,3,3,4
3855,3855,,0,3,3,4
3856,3856,,0,2,2,22
3857,3857,,0,3,3,8
3858,3858,,2,1,3,3
3859,3859,,1,2,3,1
3860,3860,,0,3,3,94
3861,3861,,0,3,3,8
3862,3862,,0,3,3,141
3863,3863,,0,3,3,3
3864,3864,,2,0,2,3
3865,3865,,2,1,3,32
3866,3866,,0,0,0,95
3867,3867,,1,2,3,9
3868,3868,,0,0,0,96
3869,3869,,2,1,3,8
3870,3870,,1,1,2,32
3871,3871,,1,2,3,3
3872,3872,,0,3,3,3
3873,3873,,1,1,2,32
3874,3874,,2,1,3,4
3875,3875,,1,1,2,14
3876,3876,,1,2,3,22
3877,3877,,3,0,3,22
3878,3878,,3,0,3,19
3879,3879,,1,2,3,9
3880,3880,,1,1,2,105
3881,3881,,2,1,3,5
3882,3882,,1,0,1,94
3883,3883,,1,2,3,4
3884,3884,,1,2,3,94
3885,3885,,0,1,1,369
3886,3886,,0,2,2,1
3887,3887,,2,1,3,94
3888,3888,,2,1,3,9
3889,3889,,2,1,3,4
3890,3890,,1,2,3,105
3891,3891,,1,1,2,4
3892,3892,,1,2,3,3
3893,3893,,1,1,2,3
3894,3894,,1,1,2,33
3895,3895,,0,0,0,97
3896,3896,,2,1,3,22
3897,3897,,1,2,3,3
3898,3898,,1,2,3,5
3899,3899,,0,3,3,5
3900,3900,,0,2,2,5
3901,3901,,2,0,2,5
3902,3902,,1,1,2,4
3903,3903,,2,1,3,33
3904,3904,,1,2,3,94
3905,3905,,1,1,2,4
3906,3906,,3,0,3,7
3907,3907,,1,0,1,32
3908,3908,,0,2,2,32
3909,3909,,0,1,1,33
3910,3910,,3,0,3,9
3911,3911,,0,3,3,18
3912,3912,,1,2,3,5
3913,3913,,1,2,3,5
3914,3914,,0,2,2,10
3915,3915,,3,0,3,27
3916,3916,,3,0,3,2
3917,3917,,2,1,3,8
3918,3918,,1,2,3,4
3919,3919,,0,0,0,98
3920,3920,,2,0,2,33
3921,3921,,1,0,1,1
3922,3922,,1,2,3,77
3923,3923,,1,1,2,32
3924,3924,,1,0,1,3
3925,3925,,1,2,3,94
3926,3926,,3,0,3,5
3927,3927,,1,2,3,32
3928,3928,,0,1,1,1
3929,3929,,1,2,3,33
3930,3930,,0,2,2,3
3931,3931,,1,2,3,4
3932,3932,,0,1,1,105
3933,3933,,0,3,3,18
3934,3934,,0,0,0,99
3935,3935,,0,3,3,18
3936,3936,,3,0,3,0
3937,3937,,1,2,3,9
3938,3938,,1,2,3,14
3939,3939,,1,1,2,105
3940,3940,,2,1,3,4
3941,3941,,0,3,3,3
3942,3942,,2,0,2,82
3943,3943,,0,0,0,100
3944,3944,,0,3,3,5
3945,3945,,2,1,3,33
3946,3946,,2,0,2,22
3947,3947,,1,2,3,9
3948,3948,,1,1,2,105
3949,3949,,1,2,3,3
3950,3950,,0,0,0,101
3951,3951,,3,0,3,94
3952,3952,,2,0,2,18
3953,3953,,2,1,3,18
3954,3954,,0,0,0,102
3955,3955,,2,1,3,3
3956,3956,,2,1,3,5
3957,3957,,1,2,3,105
3958,3958,,3,0,3,8
3959,3959,,0,3,3,78
3960,3960,,1,0,1,18
3961,3961,,3,0,3,8
3962,3962,,2,0,2,22
3963,3963,,2,1,3,33
3964,3964,,1,1,2,4
3965,3965,,1,2,3,78
3966,3966,,2,1,3,78
3967,3967,,1,2,3,3
3968,3968,,0,2,2,94
3969,3969,,1,1,2,27
3970,3970,,1,2,3,5
3971,3971,,1,2,3,3
3972,3972,,1,1,2,9
3973,3973,,1,2,3,8
3974,3974,,0,3,3,27
3975,3975,,0,1,1,9
3976,3976,,0,2,2,22
3977,3977,,1,2,3,34
3978,3978,,1,2,3,32
3979,3979,,2,1,3,1
3980,3980,,0,3,3,1
3981,3981,,0,3,3,6
3982,3982,,3,0,3,5
3983,3983,,2,1,3,32
3984,3984,,2,0,2,3
3985,3985,,0,3,3,105
3986,3986,,3,0,3,3
3987,3987,,0,3,3,32
3988,3988,,0,3,3,3
3989,3989,,1,2,3,4
3990,3990,,2,1,3,4
3991,3991,,1,2,3,24
3992,3992,,0,1,1,78
3993,3993,,1,1,2,78
3994,3994,,1,2,3,19
3995,3995,,0,0,0,103
3996,3996,,1,2,3,57
3997,3997,,0,2,2,1
3998,3998,,1,2,3,3
3999,3999,,1,1,2,8
4000,4000,,0,2,2,32
4001,4001,,1,2,3,9
4002,4002,,3,0,3,3
4003,4003,,0,3,3,14
4004,4004,,1,2,3,4
4005,4005,,1,2,3,5
4006,4006,,0,2,2,4
4007,4007,,2,1,3,14
4008,4008,,2,1,3,8
4009,4009,,2,1,3,22
4010,4010,,0,3,3,3
4011,4011,,1,1,2,22
4012,4012,,2,1,3,1
4013,4013,,2,1,3,33
4014,4014,,1,1,2,4
4015,4015,,1,0,1,4
4016,4016,,0,3,3,5
4017,4017,,0,3,3,9
4018,4018,,0,3,3,3
4019,4019,,0,0,0,104
4020,4020,,0,3,3,4
4021,4021,,1,2,3,14
4022,4022,,2,1,3,27
4023,4023,,1,2,3,3
4024,4024,,1,2,3,7
4025,4025,,1,2,3,7
4026,4026,,2,0,2,18
4027,4027,,1,2,3,3
4028,4028,,0,3,3,3
4029,4029,,2,1,3,33
4030,4030,,1,1,2,3
4031,4031,,2,1,3,105
4032,4032,,1,2,3,105
4033,4033,,0,0,0,106
4034,4034,,1,2,3,1
4035,4035,,1,1,2,6
4036,4036,,2,1,3,1
4037,4037,,2,0,2,9
4038,4038,,2,0,2,22
4039,4039,,2,1,3,3
4040,4040,,1,0,1,3
4041,4041,,1,2,3,4
4042,4042,,1,1,2,27
4043,4043,,0,0,0,107
4044,4044,,1,2,3,94
4045,4045,,2,1,3,8
4046,4046,,0,0,0,108
4047,4047,,0,3,3,9
4048,4048,,1,2,3,3
4049,4049,,0,2,2,33
4050,4050,,1,2,3,4
4051,4051,,1,0,1,5
4052,4052,,0,0,0,109
4053,4053,,1,1,2,3
4054,4054,,1,2,3,105
4055,4055,,3,0,3,94
4056,4056,,1,2,3,3
4057,4057,,0,1,1,110
4058,4058,,0,0,0,111
4059,4059,,1,1,2,16
4060,4060,,2,1,3,4
4061,4061,,2,1,3,4
4062,4062,,0,0,0,112
4063,4063,,2,0,2,24
4064,4064,,1,2,3,5
4065,4065,,1,2,3,33
4066,4066,,3,0,3,7
4067,4067,,2,0,2,18
4068,4068,,2,1,3,32
4069,4069,,1,2,3,22
4070,4070,,0,2,2,32
4071,4071,,3,0,3,24
4072,4072,,3,0,3,0
4073,4073,,1,1,2,8
4074,4074,,2,1,3,6
4075,4075,,2,1,3,22
4076,4076,,3,0,3,39
4077,4077,,1,2,3,16
4078,4078,,1,2,3,10
4079,4079,,2,1,3,1
4080,4080,,2,1,3,1
4081,4081,,1,2,3,4
4082,4082,,2,1,3,4
4083,4083,,2,1,3,19
4084,4084,,1,2,3,19
4085,4085,,1,2,3,3
4086,4086,,2,1,3,9
4087,4087,,1,2,3,113
4088,4088,,2,1,3,1
4089,4089,,0,3,3,9
4090,4090,,0,2,2,124
4091,4091,,1,2,3,3
4092,4092,,2,0,2,14
4093,4093,,1,2,3,8
4094,4094,,2,1,3,18
4095,4095,,1,0,1,39
4096,4096,,0,3,3,1
4097,4097,,3,0,3,8
4098,4098,,2,1,3,33
4099,4099,,1,0,1,14
4100,4100,,0,1,1,1
4101,4101,,3,0,3,94
4102,4102,,1,0,1,5
4103,4103,,1,2,3,22
4104,4104,,2,1,3,94
4105,4105,,1,1,2,19
4106,4106,,1,0,1,5
4107,4107,,0,1,1,78
4108,4108,,1,2,3,4
4109,4109,,0,3,3,1
4110,4110,,1,1,2,9
4111,4111,,1,1,2,4
4112,4112,,2,0,2,4
4113,4113,,1,1,2,78
4114,4114,,2,0,2,5
4115,4115,,1,0,1,4
4116,4116,,0,2,2,18
4117,4117,,0,2,2,9
4118,4118,,0,2,2,1
4119,4119,,1,1,2,4
4120,4120,,1,1,2,4
4121,4121,,0,2,2,1
4122,4122,,1,1,2,8
4123,4123,,1,1,2,5
4124,4124,,2,0,2,1
4125,4125,,0,1,1,5
4126,4126,,1,0,1,9
4127,4127,,1,0,1,3
4128,4128,,1,1,2,1
4129,4129,,0,2,2,19
4130,4130,,1,1,2,5
4131,4131,,1,1,2,5
4132,4132,,1,1,2,3
4133,4133,,1,1,2,5
4134,4134,,0,1,1,22
4135,4135,,1,1,2,4
4136,4136,,0,0,0,114
4137,4137,,2,0,2,5
4138,4138,,1,1,2,4
4139,4139,,1,1,2,3
4140,4140,,0,2,2,82
4141,4141,,2,0,2,3
4142,4142,,0,0,0,115
4143,4143,,1,1,2,22
4144,4144,,1,1,2,8
4145,4145,,1,1,2,156
4146,4146,,2,0,2,33
4147,4147,,0,1,1,77
4148,4148,,1,1,2,105
4149,4149,,1,1,2,22
4150,4150,,1,1,2,8
4151,4151,,1,1,2,1
4152,4152,,0,2,2,77
4153,4153,,0,2,2,9
4154,4154,,0,0,0,116
4155,4155,,1,1,2,94
4156,4156,,0,0,0,117
4157,4157,,1,1,2,19
4158,4158,,0,2,2,34
4159,4159,,1,1,2,32
4160,4160,,1,1,2,9
4161,4161,,0,2,2,14
4162,4162,,1,1,2,1
4163,4163,,1,1,2,22
4164,4164,,2,0,2,5
4165,4165,,0,2,2,5
4166,4166,,0,2,2,18
4167,4167,,0,2,2,7
4168,4168,,0,2,2,4
4169,4169,,1,0,1,8
4170,4170,,1,0,1,3
4171,4171,,1,1,2,33
4172,4172,,0,0,0,118
4173,4173,,1,1,2,94
4174,4174,,1,1,2,3
4175,4175,,0,0,0,119
4176,4176,,0,0,0,120
4177,4177,,1,1,2,4
4178,4178,,1,1,2,18
4179,4179,,0,2,2,9
4180,4180,,0,2,2,24
4181,4181,,1,1,2,94
4182,4182,,1,1,2,6
4183,4183,,0,2,2,7
4184,4184,,0,2,2,33
4185,4185,,2,0,2,27
4186,4186,,1,1,2,3
4187,4187,,1,1,2,8
4188,4188,,2,0,2,3
4189,4189,,0,0,0,121
4190,4190,,0,2,2,105
4191,4191,,0,2,2,3
4192,4192,,1,1,2,3
4193,4193,,2,0,2,24
4194,4194,,0,0,0,122
4195,4195,,0,2,2,94
4196,4196,,1,1,2,33
4197,4197,,1,1,2,4
4198,4198,,0,2,2,8
4199,4199,,1,1,2,267
4200,4200,,1,0,1,105
4201,4201,,0,2,2,4
4202,4202,,2,0,2,3
4203,4203,,2,0,2,32
4204,4204,,2,0,2,5
4205,4205,,0,2,2,33
4206,4206,,0,1,1,6
4207,4207,,1,1,2,1
4208,4208,,1,1,2,14
4209,4209,,1,1,2,22
4210,4210,,1,1,2,8
4211,4211,,0,2,2,4
4212,4212,,0,2,2,5
4213,4213,,0,0,0,123
4214,4214,,2,0,2,124
4215,4215,,1,1,2,19
4216,4216,,1,1,2,18
4217,4217,,1,0,1,8
4218,4218,,2,0,2,9
4219,4219,,0,0,0,125
4220,4220,,0,2,2,14
4221,4221,,1,1,2,126
4222,4222,,2,0,2,8
4223,4223,,2,0,2,10
4224,4224,,1,0,1,22
4225,4225,,0,2,2,94
4226,4226,,2,0,2,22
4227,4227,,1,0,1,6
4228,4228,,1,0,1,78
4229,4229,,1,1,2,7
4230,4230,,0,2,2,5
4231,4231,,2,0,2,3
4232,4232,,1,1,2,7
4233,4233,,0,0,0,127
4234,4234,,1,1,2,9
4235,4235,,1,1,2,3
4236,4236,,0,1,1,9
4237,4237,,0,0,0,128
4238,4238,,2,0,2,8
4239,4239,,1,1,2,0
4240,4240,,1,1,2,5
4241,4241,,0,2,2,7
4242,4242,,0,2,2,8
4243,4243,,1,1,2,3
4244,4244,,1,1,2,18
4245,4245,,0,1,1,4
4246,4246,,1,1,2,9
4247,4247,,1,1,2,1
4248,4248,,2,0,2,16
4249,4249,,1,0,1,3
4250,4250,,1,1,2,105
4251,4251,,1,1,2,9
4252,4252,,0,0,0,129
4253,4253,,0,2,2,14
4254,4254,,2,0,2,3
4255,4255,,1,0,1,32
4256,4256,,2,0,2,94
4257,4257,,1,0,1,39
4258,4258,,0,2,2,7
4259,4259,,0,0,0,130
4260,4260,,0,2,2,18
4261,4261,,1,1,2,77
4262,4262,,1,1,2,105
4263,4263,,0,0,0,131
4264,4264,,1,1,2,77
4265,4265,,1,1,2,22
4266,4266,,1,1,2,8
4267,4267,,1,0,1,7
4268,4268,,1,1,2,295
4269,4269,,2,0,2,94
4270,4270,,0,1,1,18
4271,4271,,1,1,2,132
4272,4272,,1,1,2,4
4273,4273,,0,0,0,133
4274,4274,,0,2,2,105
4275,4275,,1,1,2,4
4276,4276,,1,1,2,19
4277,4277,,0,1,1,3
4278,4278,,0,2,2,10
4279,4279,,2,0,2,3
4280,4280,,0,0,0,134
4281,4281,,0,1,1,18
4282,4282,,0,2,2,78
4283,4283,,0,0,0,135
4284,4284,,0,0,0,136
4285,4285,,2,0,2,9
4286,4286,,0,1,1,0
4287,4287,,2,0,2,8
4288,4288,,0,0,0,137
4289,4289,,2,0,2,3
4290,4290,,2,0,2,4
4291,4291,,2,0,2,4
4292,4292,,0,2,2,19
4293,4293,,1,0,1,3
4294,4294,,1,1,2,19
4295,4295,,1,1,2,4
4296,4296,,0,0,0,138
4297,4297,,1,1,2,3
4298,4298,,1,1,2,57
4299,4299,,1,0,1,32
4300,4300,,1,1,2,228
4301,4301,,1,1,2,1
4302,4302,,1,1,2,4
4303,4303,,1,1,2,0
4304,4304,,1,1,2,5
4305,4305,,0,2,2,4
4306,4306,,1,1,2,139
4307,4307,,0,1,1,77
4308,4308,,1,1,2,22
4309,4309,,0,0,0,140
4310,4310,,0,1,1,9
4311,4311,,0,2,2,32
4312,4312,,2,0,2,9
4313,4313,,1,0,1,9
4314,4314,,2,0,2,33
4315,4315,,1,1,2,27
4316,4316,,1,1,2,4
4317,4317,,0,2,2,77
4318,4318,,1,1,2,4
4319,4319,,1,1,2,5
4320,4320,,1,0,1,6
4321,4321,,1,1,2,14
4322,4322,,2,0,2,1
4323,4323,,1,1,2,24
4324,4324,,2,0,2,7
4325,4325,,0,2,2,4
4326,4326,,1,1,2,18
4327,4327,,0,1,1,3
4328,4328,,2,0,2,22
4329,4329,,2,0,2,141
4330,4330,,0,2,2,4
4331,4331,,0,1,1,5
4332,4332,,2,0,2,5
4333,4333,,1,1,2,5
4334,4334,,1,1,2,39
4335,4335,,1,0,1,22
4336,4336,,1,1,2,94
4337,4337,,0,2,2,16
4338,4338,,1,1,2,18
4339,4339,,1,1,2,14
4340,4340,,1,1,2,105
4341,4341,,0,2,2,22
4342,4342,,0,0,0,142
4343,4343,,2,0,2,22
4344,4344,,2,0,2,4
4345,4345,,2,0,2,1
4346,4346,,1,1,2,105
4347,4347,,0,1,1,143
4348,4348,,0,1,1,10
4349,4349,,0,0,0,144
4350,4350,,0,0,0,145
4351,4351,,0,2,2,33
4352,4352,,1,1,2,105
4353,4353,,0,0,0,146
4354,4354,,1,1,2,0
4355,4355,,2,0,2,33
4356,4356,,1,1,2,4
4357,4357,,1,0,1,147
4358,4358,,1,1,2,148
4359,4359,,1,0,1,3
4360,4360,,1,0,1,4
4361,4361,,2,0,2,32
4362,4362,,2,0,2,6
4363,4363,,0,2,2,32
4364,4364,,1,1,2,7
4365,4365,,1,1,2,33
4366,4366,,1,1,2,9
4367,4367,,0,2,2,5
4368,4368,,1,1,2,22
4369,4369,,1,0,1,8
4370,4370,,0,0,0,149
4371,4371,,1,1,2,5
4372,4372,,2,0,2,94
4373,4373,,0,2,2,1
4374,4374,,1,1,2,8
4375,4375,,1,1,2,1
4376,4376,,0,1,1,22
4377,4377,,0,0,0,150
4378,4378,,1,1,2,16
4379,4379,,1,1,2,77
4380,4380,,1,1,2,18
4381,4381,,0,2,2,3
4382,4382,,1,0,1,22
4383,4383,,0,2,2,9
4384,4384,,0,2,2,5
4385,4385,,2,0,2,19
4386,4386,,0,1,1,151
4387,4387,,0,2,2,8
4388,4388,,1,1,2,22
4389,4389,,0,0,0,152
4390,4390,,0,2,2,0
4391,4391,,0,2,2,14
4392,4392,,1,1,2,18
4393,4393,,0,2,2,32
4394,4394,,2,0,2,4
4395,4395,,0,1,1,8
4396,4396,,1,1,2,5
4397,4397,,0,0,0,153
4398,4398,,2,0,2,19
4399,4399,,1,1,2,4
4400,4400,,0,0,0,154
4401,4401,,0,0,0,155
4402,4402,,0,2,2,4
4403,4403,,1,1,2,156
4404,4404,,1,1,2,22
4405,4405,,1,1,2,5
4406,4406,,0,0,0,157
4407,4407,,0,2,2,82
4408,4408,,1,1,2,78
4409,4409,,2,0,2,32
4410,4410,,1,0,1,4
4411,4411,,2,0,2,8
4412,4412,,0,0,0,158
4413,4413,,1,1,2,18
4414,4414,,1,1,2,33
4415,4415,,1,1,2,81
4416,4416,,0,2,2,33
4417,4417,,0,2,2,94
4418,4418,,0,2,2,7
4419,4419,,2,0,2,1
4420,4420,,1,1,2,18
4421,4421,,0,1,1,105
4422,4422,,0,1,1,105
4423,4423,,1,0,1,3
4424,4424,,2,0,2,7
4425,4425,,1,1,2,3
4426,4426,,2,0,2,8
4427,4427,,1,1,2,8
4428,4428,,1,1,2,207
4429,4429,,1,1,2,32
4430,4430,,1,1,2,32
4431,4431,,0,0,0,159
4432,4432,,0,0,0,160
4433,4433,,1,1,2,1
4434,4434,,0,1,1,105
4435,4435,,0,2,2,1
4436,4436,,0,2,2,244
4437,4437,,0,0,0,161
4438,4438,,0,2,2,3
4439,4439,,0,0,0,162
4440,4440,,1,1,2,4
4441,4441,,0,1,1,10
4442,4442,,1,0,1,148
4443,4443,,0,0,0,163
4444,4444,,1,1,2,6
4445,4445,,1,1,2,32
4446,4446,,0,2,2,4
4447,4447,,1,1,2,3
4448,4448,,1,1,2,16
4449,4449,,1,1,2,3
4450,4450,,2,0,2,5
4451,4451,,0,0,0,164
4452,4452,,0,2,2,3
4453,4453,,0,2,2,32
4454,4454,,1,1,2,5
4455,4455,,1,1,2,8
4456,4456,,0,2,2,33
4457,4457,,1,1,2,7
4458,4458,,0,1,1,18
4459,4459,,0,2,2,1
4460,4460,,0,2,2,4
4461,4461,,1,1,2,4
4462,4462,,1,1,2,33
4463,4463,,0,0,0,165
4464,4464,,1,1,2,4
4465,4465,,1,1,2,5
4466,4466,,2,0,2,3
4467,4467,,1,1,2,3
4468,4468,,1,1,2,94
4469,4469,,0,1,1,7
4470,4470,,0,0,0,166
4471,4471,,0,0,0,167
4472,4472,,1,1,2,16
4473,4473,,1,1,2,4
4474,4474,,0,2,2,5
4475,4475,,1,1,2,33
4476,4476,,1,1,2,5
4477,4477,,0,2,2,3
4478,4478,,1,1,2,3
4479,4479,,0,1,1,8
4480,4480,,1,1,2,32
4481,4481,,1,0,1,22
4482,4482,,1,1,2,94
4483,4483,,1,1,2,4
4484,4484,,1,1,2,3
4485,4485,,0,0,0,168
4486,4486,,0,1,1,7
4487,4487,,1,1,2,169
4488,4488,,1,1,2,5
4489,4489,,1,1,2,1
4490,4490,,1,1,2,22
4491,4491,,1,1,2,8
4492,4492,,0,1,1,4
4493,4493,,0,1,1,4
4494,4494,,1,1,2,3
4495,4495,,1,1,2,5
4496,4496,,2,0,2,3
4497,4497,,1,0,1,3
4498,4498,,2,0,2,77
4499,4499,,2,0,2,33
4500,4500,,1,1,2,5
4501,4501,,0,1,1,3
4502,4502,,2,0,2,226
4503,4503,,1,1,2,197
4504,4504,,0,0,0,170
4505,4505,,1,0,1,171
4506,4506,,1,1,2,22
4507,4507,,1,1,2,105
4508,4508,,1,1,2,4
4509,4509,,0,0,0,172
4510,4510,,0,2,2,3
4511,4511,,1,1,2,33
4512,4512,,0,0,0,173
4513,4513,,2,0,2,94
4514,4514,,1,1,2,40
4515,4515,,0,0,0,174
4516,4516,,1,1,2,202
4517,4517,,1,0,1,5
4518,4518,,1,0,1,22
4519,4519,,1,1,2,4
4520,4520,,0,0,0,175
4521,4521,,0,0,0,176
4522,4522,,0,0,0,177
4523,4523,,2,0,2,3
4524,4524,,2,0,2,77
4525,4525,,2,0,2,3
4526,4526,,0,0,0,178
4527,4527,,1,0,1,3
4528,4528,,0,1,1,105
4529,4529,,1,1,2,4
4530,4530,,1,1,2,3
4531,4531,,0,2,2,6
4532,4532,,1,1,2,1
4533,4533,,1,1,2,8
4534,4534,,1,1,2,4
4535,4535,,1,1,2,18
4536,4536,,0,2,2,4
4537,4537,,1,1,2,33
4538,4538,,2,0,2,0
4539,4539,,1,1,2,4
4540,4540,,0,2,2,94
4541,4541,,2,0,2,19
4542,4542,,0,0,0,179
4543,4543,,1,1,2,19
4544,4544,,1,1,2,1
4545,4545,,1,1,2,222
4546,4546,,1,1,2,5
4547,4547,,0,0,0,180
4548,4548,,2,0,2,5
4549,4549,,0,2,2,22
4550,4550,,1,0,1,3
4551,4551,,1,1,2,57
4552,4552,,0,0,0,181
4553,4553,,0,0,0,182
4554,4554,,0,2,2,5
4555,4555,,1,0,1,3
4556,4556,,0,2,2,39
4557,4557,,0,1,1,78
4558,4558,,1,1,2,265
4559,4559,,1,1,2,82
4560,4560,,1,1,2,18
4561,4561,,0,2,2,9
4562,4562,,0,0,0,183
4563,4563,,1,1,2,18
4564,4564,,0,2,2,94
4565,4565,,2,0,2,8
4566,4566,,0,2,2,4
4567,4567,,1,1,2,269
4568,4568,,0,1,1,3
4569,4569,,0,2,2,34
4570,4570,,0,2,2,14
4571,4571,,0,2,2,105
4572,4572,,1,1,2,1
4573,4573,,1,1,2,77
4574,4574,,1,1,2,4
4575,4575,,1,0,1,3
4576,4576,,1,1,2,77
4577,4577,,1,1,2,18
4578,4578,,1,1,2,94
4579,4579,,2,0,2,22
4580,4580,,2,0,2,22
4581,4581,,2,0,2,7
4582,4582,,2,0,2,24
4583,4583,,1,1,2,8
4584,4584,,2,0,2,8
4585,4585,,1,1,2,19
4586,4586,,2,0,2,105
4587,4587,,0,0,0,184
4588,4588,,1,1,2,199
4589,4589,,2,0,2,5
4590,4590,,1,1,2,105
4591,4591,,1,0,1,6
4592,4592,,2,0,2,78
4593,4593,,1,1,2,33
4594,4594,,1,1,2,4
4595,4595,,2,0,2,4
4596,4596,,1,0,1,32
4597,4597,,2,0,2,14
4598,4598,,1,1,2,7
4599,4599,,0,2,2,3
4600,4600,,1,1,2,185
4601,4601,,1,1,2,0
4602,4602,,1,1,2,4
4603,4603,,0,1,1,3
4604,4604,,1,1,2,94
4605,4605,,1,1,2,16
4606,4606,,1,1,2,94
4607,4607,,0,2,2,4
4608,4608,,0,2,2,27
4609,4609,,0,0,0,186
4610,4610,,0,0,0,187
4611,4611,,0,2,2,24
4612,4612,,1,1,2,105
4613,4613,,0,1,1,78
4614,4614,,1,1,2,105
4615,4615,,1,1,2,4
4616,4616,,1,1,2,3
4617,4617,,0,2,2,14
4618,4618,,1,0,1,40
4619,4619,,1,1,2,105
4620,4620,,1,1,2,4
4621,4621,,0,0,0,188
4622,4622,,1,1,2,7
4623,4623,,1,1,2,6
4624,4624,,0,1,1,5
4625,4625,,0,2,2,3
4626,4626,,1,1,2,7
4627,4627,,0,0,0,189
4628,4628,,0,0,0,190
4629,4629,,0,1,1,3
4630,4630,,1,1,2,33
4631,4631,,0,0,0,191
4632,4632,,1,0,1,192
4633,4633,,2,0,2,6
4634,4634,,2,0,2,3
4635,4635,,1,1,2,7
4636,4636,,2,0,2,77
4637,4637,,1,1,2,4
4638,4638,,1,1,2,1
4639,4639,,0,2,2,94
4640,4640,,2,0,2,5
4641,4641,,0,0,0,193
4642,4642,,2,0,2,8
4643,4643,,0,0,0,194
4644,4644,,1,1,2,22
4645,4645,,0,0,0,195
4646,4646,,1,1,2,6
4647,4647,,1,1,2,105
4648,4648,,1,1,2,27
4649,4649,,1,1,2,4
4650,4650,,0,2,2,8
4651,4651,,1,0,1,9
4652,4652,,0,2,2,4
4653,4653,,1,1,2,4
4654,4654,,0,2,2,9
4655,4655,,0,2,2,3
4656,4656,,0,0,0,196
4657,4657,,0,1,1,3
4658,4658,,1,1,2,4
4659,4659,,0,2,2,8
4660,4660,,0,2,2,3
4661,4661,,1,1,2,5
4662,4662,,1,1,2,22
4663,4663,,0,1,1,8
4664,4664,,1,1,2,3
4665,4665,,1,1,2,4
4666,4666,,2,0,2,3
4667,4667,,1,1,2,1
4668,4668,,1,1,2,8
4669,4669,,1,1,2,9
4670,4670,,1,1,2,3
4671,4671,,1,0,1,8
4672,4672,,0,2,2,3
4673,4673,,1,1,2,197
4674,4674,,1,1,2,22
4675,4675,,0,2,2,77
4676,4676,,2,0,2,8
4677,4677,,0,2,2,105
4678,4678,,0,1,1,3
4679,4679,,1,1,2,8
4680,4680,,1,1,2,268
4681,4681,,0,0,0,198
4682,4682,,1,1,2,199
4683,4683,,1,1,2,33
4684,4684,,0,2,2,9
4685,4685,,0,1,1,3
4686,4686,,1,1,2,4
4687,4687,,1,1,2,4
4688,4688,,0,2,2,3
4689,4689,,1,1,2,8
4690,4690,,1,1,2,14
4691,4691,,0,1,1,22
4692,4692,,0,2,2,32
4693,4693,,1,1,2,3
4694,4694,,1,1,2,32
4695,4695,,1,1,2,3
4696,4696,,1,1,2,1
4697,4697,,1,1,2,1
4698,4698,,1,1,2,5
4699,4699,,0,0,0,200
4700,4700,,1,1,2,3
4701,4701,,0,2,2,4
4702,4702,,1,1,2,57
4703,4703,,0,0,0,201
4704,4704,,0,2,2,7
4705,4705,,1,1,2,22
4706,4706,,1,1,2,5
4707,4707,,1,1,2,258
4708,4708,,1,1,2,7
4709,4709,,1,1,2,202
4710,4710,,0,1,1,78
4711,4711,,1,1,2,77
4712,4712,,0,0,0,203
4713,4713,,2,0,2,5
4714,4714,,1,1,2,4
4715,4715,,1,0,1,204
4716,4716,,1,1,2,77
4717,4717,,0,2,2,105
4718,4718,,0,0,0,205
4719,4719,,1,0,1,94
4720,4720,,1,1,2,22
4721,4721,,1,0,1,206
4722,4722,,0,2,2,5
4723,4723,,0,2,2,4
4724,4724,,1,1,2,14
4725,4725,,1,1,2,3
4726,4726,,1,1,2,5
4727,4727,,0,2,2,6
4728,4728,,1,1,2,239
4729,4729,,1,1,2,207
4730,4730,,0,0,0,208
4731,4731,,0,0,0,209
4732,4732,,1,1,2,4
4733,4733,,2,0,2,54
4734,4734,,2,0,2,1
4735,4735,,0,2,2,1
4736,4736,,0,0,0,210
4737,4737,,1,1,2,63
4738,4738,,1,1,2,3
4739,4739,,2,0,2,78
4740,4740,,1,1,2,3
4741,4741,,0,2,2,1
4742,4742,,0,2,2,4
4743,4743,,0,0,0,211
4744,4744,,1,1,2,3
4745,4745,,2,0,2,22
4746,4746,,1,1,2,232
4747,4747,,1,1,2,4
4748,4748,,1,1,2,33
4749,4749,,0,2,2,1
4750,4750,,0,2,2,105
4751,4751,,0,0,0,212
4752,4752,,0,1,1,6
4753,4753,,0,2,2,94
4754,4754,,0,0,0,213
4755,4755,,0,0,0,214
4756,4756,,2,0,2,8
4757,4757,,0,2,2,16
4758,4758,,0,1,1,9
4759,4759,,0,2,2,3
4760,4760,,2,0,2,40
4761,4761,,1,1,2,3
4762,4762,,1,1,2,6
4763,4763,,0,0,0,215
4764,4764,,0,1,1,33
4765,4765,,2,0,2,3
4766,4766,,0,2,2,8
4767,4767,,1,1,2,22
4768,4768,,0,2,2,4
4769,4769,,0,2,2,7
4770,4770,,1,1,2,33
4771,4771,,0,2,2,1
4772,4772,,1,1,2,5
4773,4773,,0,0,0,216
4774,4774,,1,1,2,10
4775,4775,,1,1,2,77
4776,4776,,0,2,2,105
4777,4777,,0,2,2,105
4778,4778,,1,1,2,64
4779,4779,,0,2,2,33
4780,4780,,2,0,2,39
4781,4781,,1,1,2,19
4782,4782,,1,1,2,236
4783,4783,,1,1,2,3
4784,4784,,0,1,1,32
4785,4785,,2,0,2,3
4786,4786,,1,1,2,4
4787,4787,,1,0,1,4
4788,4788,,0,1,1,33
4789,4789,,1,1,2,1
4790,4790,,1,1,2,3
4791,4791,,1,1,2,4
4792,4792,,0,0,0,217
4793,4793,,1,1,2,105
4794,4794,,0,1,1,16
4795,4795,,1,0,1,32
4796,4796,,0,2,2,5
4797,4797,,1,1,2,22
4798,4798,,1,1,2,4
4799,4799,,1,1,2,57
4800,4800,,2,0,2,105
4801,4801,,0,1,1,24
4802,4802,,0,0,0,218
4803,4803,,1,0,1,219
4804,4804,,2,0,2,22
4805,4805,,2,0,2,3
4806,4806,,1,1,2,22
4807,4807,,0,2,2,6
4808,4808,,0,2,2,0
4809,4809,,1,1,2,5
4810,4810,,0,0,0,220
4811,4811,,1,1,2,19
4812,4812,,1,0,1,94
4813,4813,,2,0,2,105
4814,4814,,1,1,2,1
4815,4815,,0,2,2,0
4816,4816,,1,1,2,3
4817,4817,,0,0,0,221
4818,4818,,0,2,2,14
4819,4819,,1,1,2,14
4820,4820,,0,2,2,5
4821,4821,,0,2,2,3
4822,4822,,0,2,2,5
4823,4823,,0,2,2,18
4824,4824,,0,1,1,273
4825,4825,,1,1,2,222
4826,4826,,1,1,2,4
4827,4827,,2,0,2,105
4828,4828,,0,2,2,5
4829,4829,,0,2,2,4
4830,4830,,2,0,2,39
4831,4831,,1,1,2,223
4832,4832,,1,1,2,22
4833,4833,,1,1,2,19
4834,4834,,1,1,2,94
4835,4835,,0,0,0,224
4836,4836,,1,1,2,18
4837,4837,,1,1,2,6
4838,4838,,0,0,0,225
4839,4839,,1,1,2,14
4840,4840,,1,1,2,33
4841,4841,,2,0,2,3
4842,4842,,0,2,2,27
4843,4843,,0,1,1,8
4844,4844,,1,1,2,4
4845,4845,,0,2,2,226
4846,4846,,1,1,2,3
4847,4847,,1,1,2,19
4848,4848,,1,1,2,19
4849,4849,,1,1,2,75
4850,4850,,1,1,2,16
4851,4851,,1,1,2,3
4852,4852,,1,1,2,33
4853,4853,,1,1,2,3
4854,4854,,1,1,2,4
4855,4855,,1,1,2,7
4856,4856,,1,0,1,9
4857,4857,,1,0,1,5
4858,4858,,0,2,2,3
4859,4859,,1,1,2,14
4860,4860,,0,2,2,105
4861,4861,,0,2,2,82
4862,4862,,0,0,0,227
4863,4863,,1,1,2,5
4864,4864,,1,1,2,4
4865,4865,,1,1,2,18
4866,4866,,1,0,1,14
4867,4867,,1,1,2,3
4868,4868,,1,1,2,1
4869,4869,,2,0,2,5
4870,4870,,0,2,2,32
4871,4871,,0,2,2,32
4872,4872,,0,2,2,3
4873,4873,,1,1,2,77
4874,4874,,1,1,2,105
4875,4875,,0,2,2,4
4876,4876,,2,0,2,1
4877,4877,,2,0,2,3
4878,4878,,1,1,2,228
4879,4879,,2,0,2,8
4880,4880,,1,1,2,5
4881,4881,,2,0,2,3
4882,4882,,1,1,2,22
4883,4883,,1,1,2,19
4884,4884,,1,1,2,34
4885,4885,,1,1,2,3
4886,4886,,0,2,2,105
4887,4887,,0,2,2,1
4888,4888,,0,2,2,4
4889,4889,,0,2,2,4
4890,4890,,1,0,1,77
4891,4891,,1,1,2,27
4892,4892,,2,0,2,94
4893,4893,,0,2,2,5
4894,4894,,1,1,2,3
4895,4895,,2,0,2,7
4896,4896,,1,1,2,3
4897,4897,,1,1,2,22
4898,4898,,1,0,1,9
4899,4899,,1,1,2,9
4900,4900,,0,2,2,94
4901,4901,,0,2,2,27
4902,4902,,2,0,2,34
4903,4903,,1,1,2,74
4904,4904,,0,2,2,0
4905,4905,,1,1,2,94
4906,4906,,2,0,2,16
4907,4907,,1,1,2,94
4908,4908,,1,1,2,94
4909,4909,,0,2,2,3
4910,4910,,1,1,2,78
4911,4911,,1,1,2,22
4912,4912,,2,0,2,14
4913,4913,,0,2,2,5
4914,4914,,0,1,1,4
4915,4915,,0,2,2,94
4916,4916,,1,1,2,14
4917,4917,,1,1,2,18
4918,4918,,1,1,2,4
4919,4919,,1,1,2,3
4920,4920,,2,0,2,14
4921,4921,,1,1,2,34
4922,4922,,0,0,0,229
4923,4923,,2,0,2,19
4924,4924,,1,1,2,94
4925,4925,,0,0,0,230
4926,4926,,0,0,0,231
4927,4927,,0,2,2,7
4928,4928,,1,1,2,3
4929,4929,,1,1,2,232
4930,4930,,1,1,2,3
4931,4931,,1,1,2,105
4932,4932,,1,1,2,14
4933,4933,,1,1,2,16
4934,4934,,0,2,2,1
4935,4935,,0,2,2,94
4936,4936,,1,1,2,5
4937,4937,,0,0,0,233
4938,4938,,0,0,0,234
4939,4939,,2,0,2,3
4940,4940,,2,0,2,22
4941,4941,,0,1,1,8
4942,4942,,1,1,2,105
4943,4943,,2,0,2,4
4944,4944,,1,1,2,3
4945,4945,,1,1,2,77
4946,4946,,0,2,2,8
4947,4947,,1,1,2,5
4948,4948,,0,1,1,10
4949,4949,,1,0,1,235
4950,4950,,1,1,2,3
4951,4951,,1,1,2,16
4952,4952,,1,1,2,14
4953,4953,,2,0,2,3
4954,4954,,2,0,2,16
4955,4955,,1,1,2,5
4956,4956,,1,1,2,236
4957,4957,,1,1,2,3
4958,4958,,2,0,2,4
4959,4959,,2,0,2,7
4960,4960,,1,1,2,18
4961,4961,,0,0,0,237
4962,4962,,0,2,2,3
4963,4963,,1,1,2,3
4964,4964,,2,0,2,4
4965,4965,,1,1,2,22
4966,4966,,1,0,1,22
4967,4967,,1,1,2,3
4968,4968,,2,0,2,3
4969,4969,,0,2,2,63
4970,4970,,2,0,2,3
4971,4971,,2,0,2,22
4972,4972,,1,1,2,5
4973,4973,,0,1,1,238
4974,4974,,1,1,2,239
4975,4975,,2,0,2,44
4976,4976,,0,2,2,22
4977,4977,,0,2,2,3
4978,4978,,1,1,2,4
4979,4979,,2,0,2,10
4980,4980,,2,0,2,19
4981,4981,,1,1,2,5
4982,4982,,2,0,2,94
4983,4983,,1,1,2,105
4984,4984,,2,0,2,5
4985,4985,,0,2,2,16
4986,4986,,1,1,2,9
4987,4987,,0,2,2,14
4988,4988,,0,2,2,240
4989,4989,,1,1,2,4
4990,4990,,1,1,2,4
4991,4991,,0,0,0,241
4992,4992,,1,1,2,105
4993,4993,,1,1,2,40
4994,4994,,1,1,2,105
4995,4995,,0,2,2,5
4996,4996,,1,1,2,0
4997,4997,,0,0,0,242
4998,4998,,0,2,2,1
4999,4999,,1,1,2,6
5000,5000,,1,1,2,5
5001,5001,,0,0,0,243
5002,5002,,1,1,2,3
5003,5003,,0,1,1,18
5004,5004,,1,1,2,94
5005,5005,,2,0,2,5
5006,5006,,1,1,2,4
5007,5007,,2,0,2,1
5008,5008,,0,2,2,3
5009,5009,,0,2,2,3
5010,5010,,2,0,2,27
5011,5011,,2,0,2,244
5012,5012,,1,0,1,321
5013,5013,,0,1,1,5
5014,5014,,1,1,2,32
5015,5015,,1,0,1,82
5016,5016,,0,0,0,245
5017,5017,,0,0,0,246
5018,5018,,2,0,2,3
5019,5019,,1,1,2,4
5020,5020,,0,2,2,8
5021,5021,,0,1,1,8
5022,5022,,1,0,1,78
5023,5023,,0,2,2,105
5024,5024,,0,2,2,19
5025,5025,,0,2,2,14
5026,5026,,1,1,2,8
5027,5027,,0,0,0,247
5028,5028,,0,2,2,24
5029,5029,,0,2,2,18
5030,5030,,0,2,2,7
5031,5031,,0,0,0,248
5032,5032,,2,0,2,27
5033,5033,,0,1,1,9
5034,5034,,0,0,0,249
5035,5035,,0,0,0,250
5036,5036,,1,0,1,77
5037,5037,,1,1,2,94
5038,5038,,1,1,2,5
5039,5039,,0,2,2,5
5040,5040,,1,1,2,16
5041,5041,,1,1,2,5
5042,5042,,2,0,2,4
5043,5043,,2,0,2,4
5044,5044,,1,1,2,9
5045,5045,,1,1,2,5
5046,5046,,2,0,2,0
5047,5047,,2,0,2,14
5048,5048,,1,1,2,3
5049,5049,,1,1,2,3
5050,5050,,1,1,2,3
5051,5051,,1,1,2,94
5052,5052,,0,2,2,6
5053,5053,,0,0,0,251
5054,5054,,1,1,2,14
5055,5055,,0,0,0,252
5056,5056,,0,0,0,253
5057,5057,,1,1,2,3
5058,5058,,1,1,2,4
5059,5059,,0,2,2,7
5060,5060,,2,0,2,270
5061,5061,,1,1,2,4
5062,5062,,0,2,2,9
5063,5063,,0,2,2,5
5064,5064,,0,2,2,5
5065,5065,,1,1,2,9
5066,5066,,1,1,2,1
5067,5067,,0,0,0,254
5068,5068,,1,1,2,4
5069,5069,,0,2,2,1
5070,5070,,2,0,2,2
5071,5071,,0,2,2,4
5072,5072,,0,0,0,255
5073,5073,,0,2,2,5
5074,5074,,0,1,1,8
5075,5075,,1,1,2,3
5076,5076,,2,0,2,8
5077,5077,,1,1,2,105
5078,5078,,1,1,2,4
5079,5079,,1,0,1,39
5080,5080,,2,0,2,105
5081,5081,,1,1,2,105
5082,5082,,0,0,0,256
5083,5083,,0,0,0,257
5084,5084,,0,2,2,33
5085,5085,,1,1,2,8
5086,5086,,1,1,2,258
5087,5087,,1,1,2,6
5088,5088,,1,1,2,94
5089,5089,,1,0,1,22
5090,5090,,1,1,2,78
5091,5091,,0,2,2,9
5092,5092,,0,0,0,259
5093,5093,,2,0,2,3
5094,5094,,1,0,1,27
5095,5095,,0,0,0,260
5096,5096,,2,0,2,9
5097,5097,,0,0,0,261
5098,5098,,1,1,2,9
5099,5099,,1,1,2,34
5100,5100,,1,1,2,9
5101,5101,,1,1,2,22
5102,5102,,2,0,2,19
5103,5103,,0,2,2,33
5104,5104,,0,0,0,262
5105,5105,,0,1,1,19
5106,5106,,1,1,2,9
5107,5107,,0,1,1,9
5108,5108,,0,2,2,9
5109,5109,,1,1,2,263
5110,5110,,0,2,2,3
5111,5111,,1,1,2,4
5112,5112,,0,2,2,4
5113,5113,,1,0,1,3
5114,5114,,1,1,2,263
5115,5115,,1,1,2,82
5116,5116,,1,1,2,0
5117,5117,,0,2,2,264
5118,5118,,1,0,1,3
5119,5119,,0,1,1,27
5120,5120,,2,0,2,5
5121,5121,,0,2,2,77
5122,5122,,1,1,2,265
5123,5123,,1,1,2,9
5124,5124,,0,2,2,105
5125,5125,,2,0,2,5
5126,5126,,1,1,2,6
5127,5127,,1,1,2,19
5128,5128,,0,0,0,266
5129,5129,,1,1,2,1
5130,5130,,1,1,2,267
5131,5131,,1,1,2,268
5132,5132,,1,1,2,269
5133,5133,,1,1,2,3
5134,5134,,1,1,2,5
5135,5135,,1,1,2,3
5136,5136,,0,2,2,7
5137,5137,,0,1,1,3
5138,5138,,2,0,2,3
5139,5139,,0,1,1,5
5140,5140,,1,0,1,5
5141,5141,,2,0,2,1
5142,5142,,1,1,2,33
5143,5143,,1,1,2,8
5144,5144,,1,0,1,9
5145,5145,,1,1,2,16
5146,5146,,1,1,2,6
5147,5147,,2,0,2,5
5148,5148,,0,2,2,270
5149,5149,,2,0,2,105
5150,5150,,0,2,2,2
5151,5151,,1,1,2,113
5152,5152,,1,1,2,4
5153,5153,,2,0,2,16
5154,5154,,0,0,0,271
5155,5155,,0,0,0,272
5156,5156,,1,1,2,9
5157,5157,,0,1,1,5
5158,5158,,0,2,2,8
5159,5159,,1,1,2,1
5160,5160,,1,1,2,3
5161,5161,,1,1,2,3
5162,5162,,1,1,2,105
5163,5163,,1,1,2,33
5164,5164,,1,1,2,4
5165,5165,,2,0,2,16
5166,5166,,1,1,2,5
5167,5167,,1,1,2,4
5168,5168,,2,0,2,273
5169,5169,,1,0,1,4
5170,5170,,1,0,1,78
5171,5171,,1,1,2,0
5172,5172,,1,1,2,9
5173,5173,,0,2,2,22
5174,5174,,1,1,2,4
5175,5175,,2,0,2,7
5176,5176,,1,1,2,3
5177,5177,,0,2,2,9
5178,5178,,0,2,2,8
5179,5179,,1,1,2,4
5180,5180,,0,0,0,274
5181,5181,,1,1,2,9
5182,5182,,1,1,2,78
5183,5183,,2,0,2,78
5184,5184,,0,1,1,4
5185,5185,,0,0,0,275
5186,5186,,0,0,0,276
5187,5187,,2,0,2,0
5188,5188,,0,0,0,277
5189,5189,,2,0,2,14
5190,5190,,1,1,2,4
5191,5191,,0,2,2,5
5192,5192,,2,0,2,3
5193,5193,,2,0,2,5
5194,5194,,0,2,2,14
5195,5195,,1,1,2,0
5196,5196,,1,1,2,3
5197,5197,,2,0,2,3
5198,5198,,2,0,2,33
5199,5199,,1,1,2,33
5200,5200,,2,0,2,94
5201,5201,,0,0,0,278
5202,5202,,1,1,2,3
5203,5203,,1,1,2,3
5204,5204,,0,2,2,5
5205,5205,,1,1,2,3
5206,5206,,0,2,2,27
5207,5207,,1,1,2,3
5208,5208,,1,1,2,33
5209,5209,,1,1,2,105
5210,5210,,1,1,2,3
5211,5211,,1,1,2,7
5212,5212,,0,2,2,8
5213,5213,,1,1,2,4
5214,5214,,1,1,2,94
5215,5215,,0,2,2,4
5216,5216,,0,0,0,279
5217,5217,,1,1,2,3
5218,5218,,1,0,1,10
5219,5219,,1,0,1,5
5220,5220,,0,0,0,280
5221,5221,,1,1,2,22
5222,5222,,0,2,2,9
5223,5223,,0,0,0,281
5224,5224,,1,1,2,1
5225,5225,,1,1,2,3
5226,5226,,2,0,2,0
5227,5227,,1,1,2,3
5228,5228,,0,1,1,3
5229,5229,,0,0,0,282
5230,5230,,1,1,2,22
5231,5231,,1,1,2,8
5232,5232,,1,1,2,22
5233,5233,,1,1,2,16
5234,5234,,1,1,2,105
5235,5235,,1,1,2,18
5236,5236,,1,1,2,3
5237,5237,,0,2,2,27
5238,5238,,0,2,2,33
5239,5239,,2,0,2,3
5240,5240,,0,0,0,283
5241,5241,,2,0,2,1
5242,5242,,1,0,1,33
5243,5243,,0,2,2,94
5244,5244,,1,1,2,3
5245,5245,,0,0,0,284
5246,5246,,0,2,2,8
5247,5247,,1,1,2,2
5248,5248,,1,1,2,10
5249,5249,,0,2,2,4
5250,5250,,1,1,2,22
5251,5251,,0,0,0,285
5252,5252,,0,0,0,286
5253,5253,,0,0,0,287
5254,5254,,0,1,1,33
5255,5255,,0,1,1,288
5256,5256,,0,2,2,1
5257,5257,,0,2,2,94
5258,5258,,1,1,2,4
5259,5259,,0,1,1,5
5260,5260,,0,1,1,3
5261,5261,,0,0,0,289
5262,5262,,1,1,2,7
5263,5263,,0,0,0,290
5264,5264,,0,2,2,18
5265,5265,,1,0,1,336
5266,5266,,2,0,2,105
5267,5267,,2,0,2,8
5268,5268,,0,0,0,291
5269,5269,,1,1,2,292
5270,5270,,2,0,2,9
5271,5271,,1,1,2,9
5272,5272,,1,1,2,8
5273,5273,,0,0,0,293
5274,5274,,1,1,2,14
5275,5275,,1,1,2,3
5276,5276,,2,0,2,4
5277,5277,,0,0,0,294
5278,5278,,1,1,2,3
5279,5279,,2,0,2,3
5280,5280,,1,1,2,3
5281,5281,,1,1,2,295
5282,5282,,1,1,2,27
5283,5283,,1,1,2,5
5284,5284,,0,0,0,296
5285,5285,,1,1,2,78
5286,5286,,0,0,0,297
5287,5287,,1,1,2,33
5288,5288,,0,1,1,77
5289,5289,,0,1,1,3
5290,5290,,0,1,1,33
5291,5291,,0,1,1,39
5292,5292,,1,0,1,3
5293,5293,,1,0,1,18
5294,5294,,1,0,1,7
5295,5295,,0,1,1,4
5296,5296,,1,0,1,94
5297,5297,,1,0,1,9
5298,5298,,1,0,1,78
5299,5299,,0,1,1,3
5300,5300,,0,1,1,5
5301,5301,,1,0,1,4
5302,5302,,0,0,0,298
5303,5303,,0,1,1,18
5304,5304,,0,1,1,32
5305,5305,,0,0,0,299
5306,5306,,0,1,1,19
5307,5307,,0,1,1,7
5308,5308,,0,1,1,3
5309,5309,,1,0,1,9
5310,5310,,1,0,1,16
5311,5311,,0,1,1,370
5312,5312,,1,0,1,34
5313,5313,,0,1,1,57
5314,5314,,0,1,1,10
5315,5315,,1,0,1,94
5316,5316,,1,0,1,7
5317,5317,,1,0,1,5
5318,5318,,1,0,1,4
5319,5319,,1,0,1,22
5320,5320,,0,0,0,300
5321,5321,,1,0,1,4
5322,5322,,1,0,1,4
5323,5323,,0,1,1,22
5324,5324,,0,1,1,94
5325,5325,,0,1,1,4
5326,5326,,0,1,1,8
5327,5327,,0,1,1,78
5328,5328,,1,0,1,8
5329,5329,,0,1,1,5
5330,5330,,0,1,1,18
5331,5331,,1,0,1,1
5332,5332,,0,1,1,1
5333,5333,,0,1,1,45
5334,5334,,0,1,1,33
5335,5335,,0,1,1,3
5336,5336,,1,0,1,27
5337,5337,,0,1,1,10
5338,5338,,0,1,1,27
5339,5339,,0,1,1,301
5340,5340,,0,1,1,33
5341,5341,,0,0,0,302
5342,5342,,1,0,1,4
5343,5343,,0,1,1,4
5344,5344,,0,1,1,105
5345,5345,,0,1,1,14
5346,5346,,1,0,1,5
5347,5347,,0,1,1,4
5348,5348,,0,0,0,303
5349,5349,,1,0,1,3
5350,5350,,0,0,0,304
5351,5351,,1,0,1,4
5352,5352,,1,0,1,105
5353,5353,,0,0,0,305
5354,5354,,1,0,1,306
5355,5355,,1,0,1,22
5356,5356,,0,1,1,5
5357,5357,,0,1,1,4
5358,5358,,0,1,1,4
5359,5359,,0,1,1,8
5360,5360,,1,0,1,10
5361,5361,,1,0,1,77
5362,5362,,1,0,1,1
5363,5363,,1,0,1,7
5364,5364,,0,1,1,24
5365,5365,,0,1,1,94
5366,5366,,0,1,1,9
5367,5367,,0,1,1,307
5368,5368,,0,1,1,4
5369,5369,,1,0,1,5
5370,5370,,0,1,1,308
5371,5371,,0,0,0,309
5372,5372,,0,1,1,77
5373,5373,,1,0,1,105
5374,5374,,0,1,1,4
5375,5375,,0,1,1,8
5376,5376,,0,0,0,310
5377,5377,,0,1,1,77
5378,5378,,0,0,0,311
5379,5379,,0,0,0,312
5380,5380,,0,1,1,18
5381,5381,,0,1,1,78
5382,5382,,0,0,0,313
5383,5383,,1,0,1,314
5384,5384,,1,0,1,4
5385,5385,,1,0,1,39
5386,5386,,0,0,0,315
5387,5387,,0,0,0,316
5388,5388,,1,0,1,16
5389,5389,,0,0,0,317
5390,5390,,0,1,1,33
5391,5391,,0,1,1,0
5392,5392,,0,0,0,318
5393,5393,,0,1,1,105
5394,5394,,0,0,0,319
5395,5395,,0,1,1,8
5396,5396,,1,0,1,4
5397,5397,,0,1,1,33
5398,5398,,0,1,1,105
5399,5399,,0,1,1,0
5400,5400,,1,0,1,4
5401,5401,,0,0,0,320
5402,5402,,1,0,1,5
5403,5403,,0,1,1,321
5404,5404,,0,1,1,77
5405,5405,,0,0,0,322
5406,5406,,0,1,1,5
5407,5407,,0,1,1,371
5408,5408,,0,1,1,33
5409,5409,,0,0,0,323
5410,5410,,0,1,1,16
5411,5411,,0,1,1,7
5412,5412,,1,0,1,5
5413,5413,,0,1,1,2
5414,5414,,1,0,1,94
5415,5415,,0,1,1,19
5416,5416,,1,0,1,5
5417,5417,,0,1,1,34
5418,5418,,0,0,0,324
5419,5419,,1,0,1,223
5420,5420,,1,0,1,5
5421,5421,,0,0,0,325
5422,5422,,0,0,0,326
5423,5423,,0,1,1,16
5424,5424,,1,0,1,4
5425,5425,,0,1,1,8
5426,5426,,0,0,0,327
5427,5427,,0,1,1,7
5428,5428,,0,0,0,328
5429,5429,,0,1,1,94
5430,5430,,0,1,1,33
5431,5431,,1,0,1,40
5432,5432,,0,0,0,329
5433,5433,,1,0,1,4
5434,5434,,0,1,1,22
5435,5435,,1,0,1,14
5436,5436,,0,1,1,105
5437,5437,,1,0,1,5
5438,5438,,0,1,1,1
5439,5439,,1,0,1,4
5440,5440,,0,0,0,330
5441,5441,,0,0,0,331
5442,5442,,0,1,1,1
5443,5443,,0,1,1,4
5444,5444,,0,1,1,7
5445,5445,,0,1,1,14
5446,5446,,0,1,1,22
5447,5447,,0,1,1,1
5448,5448,,0,1,1,27
5449,5449,,0,0,0,332
5450,5450,,0,0,0,333
5451,5451,,0,1,1,5
5452,5452,,1,0,1,8
5453,5453,,0,1,1,3
5454,5454,,1,0,1,3
5455,5455,,0,0,0,334
5456,5456,,1,0,1,32
5457,5457,,1,0,1,3
5458,5458,,1,0,1,5
5459,5459,,1,0,1,94
5460,5460,,0,1,1,5
5461,5461,,0,1,1,6
5462,5462,,0,0,0,335
5463,5463,,0,1,1,336
5464,5464,,1,0,1,22
5465,5465,,0,1,1,32
5466,5466,,0,0,0,337
5467,5467,,0,1,1,3
5468,5468,,0,1,1,338
5469,5469,,0,0,0,339
5470,5470,,0,0,0,340
5471,5471,,0,1,1,18
5472,5472,,0,1,1,105
5473,5473,,0,1,1,0
5474,5474,,1,0,1,14
5475,5475,,0,1,1,5
5476,5476,,0,1,1,33
5477,5477,,1,0,1,105
5478,5478,,0,1,1,14
5479,5479,,0,1,1,14
5480,5480,,0,0,0,341
5481,5481,,0,0,0,342
5482,5482,,0,1,1,4
5483,5483,,1,0,1,343
5484,5484,,1,0,1,141
5485,5485,,0,1,1,3
5486,5486,,1,0,1,3
5487,5487,,0,1,1,5
5488,5488,,0,0,0,344
5489,5489,,0,1,1,3
5490,5490,,1,0,1,345
5491,5491,,1,0,1,346
5492,5492,,1,0,1,3
5493,5493,,1,0,1,27
5494,5494,,0,1,1,3
5495,5495,,1,0,1,22
5496,5496,,0,0,0,347
5497,5497,,0,1,1,33
5498,5498,,0,1,1,18
5499,5499,,0,1,1,74
5500,5500,,0,1,1,105
5501,5501,,0,0,0,348
5502,5502,,0,1,1,78
5503,5503,,0,1,1,3
5504,5504,,1,0,1,18
5505,5505,,0,1,1,18
5506,5506,,1,0,1,8
5507,5507,,0,1,1,1
5508,5508,,0,0,0,349
5509,5509,,0,1,1,22
5510,5510,,1,0,1,33
5511,5511,,1,0,1,8
5512,5512,,0,1,1,18
5513,5513,,0,1,1,14
5514,5514,,1,0,1,32
5515,5515,,1,0,1,4
5516,5516,,0,0,0,350
5517,5517,,0,0,0,351
5518,5518,,0,0,0,352
5519,5519,,1,0,1,33
5520,5520,,0,1,1,3
5521,5521,,1,0,1,78
5522,5522,,1,0,1,353
5523,5523,,1,0,1,8
5524,5524,,0,0,0,354
5525,5525,,1,0,1,3
5526,5526,,0,0,0,355
5527,5527,,0,1,1,5
5528,5528,,0,1,1,77
5529,5529,,1,0,1,4
5530,5530,,0,1,1,356
5531,5531,,0,0,0,357
5532,5532,,1,0,1,3
5533,5533,,1,0,1,3
5534,5534,,1,0,1,358
5535,5535,,1,0,1,359
5536,5536,,1,0,1,82
5537,5537,,0,1,1,8
5538,5538,,1,0,1,4
5539,5539,,1,0,1,3
5540,5540,,0,0,0,360
5541,5541,,0,0,0,361
5542,5542,,0,1,1,94
5543,5543,,0,1,1,3
5544,5544,,0,1,1,0
5545,5545,,0,1,1,3
5546,5546,,1,0,1,22
5547,5547,,1,0,1,19
5548,5548,,0,1,1,3
5549,5549,,0,1,1,3
5550,5550,,0,1,1,126
5551,5551,,1,0,1,0
5552,5552,,0,1,1,5
5553,5553,,1,0,1,362
5554,5554,,1,0,1,94
5555,5555,,1,0,1,9
5556,5556,,0,1,1,7
5557,5557,,0,1,1,9
5558,5558,,0,0,0,363
5559,5559,,0,0,0,364
5560,5560,,0,0,0,365
5561,5561,,0,1,1,366
5562,5562,,0,0,0,367
5563,5563,,0,1,1,3
5564,5564,,1,0,1,32
5565,5565,,1,0,1,1
5566,5566,,0,1,1,1
5567,5567,,0,1,1,3
5568,5568,,0,1,1,4
5569,5569,,0,0,0,368
5570,5570,,0,1,1,4
5571,5571,,0,1,1,3
5572,5572,,1,0,1,14
5573,5573,,0,1,1,3
5574,5574,,1,0,1,369
5575,5575,,1,0,1,24
5576,5576,,1,0,1,78
5577,5577,,1,0,1,0
5578,5578,,1,0,1,14
5579,5579,,1,0,1,9
5580,5580,,1,0,1,22
5581,5581,,1,0,1,34
5582,5582,,0,1,1,18
5583,5583,,1,0,1,370
5584,5584,,1,0,1,4
5585,5585,,1,0,1,33
5586,5586,,1,0,1,371
5587,5587,,0,0,0,372
5588,5588,,1,0,1,18
5589,5589,,1,0,1,6
5590,5590,,1,0,1,3
5591,5591,,0,1,1,18
5592,5592,,0,0,0,373
5593,5593,,1,0,1,435
5594,5594,,1,0,1,33
5595,5595,,1,0,1,3
5596,5596,,1,0,1,3
5597,5597,,0,0,0,374
5598,5598,,1,0,1,390
5599,5599,,1,0,1,338
5600,5600,,0,1,1,8
5601,5601,,0,1,1,3
5602,5602,,0,1,1,3
5603,5603,,1,0,1,74
5604,5604,,0,1,1,7
5605,5605,,0,1,1,105
5606,5606,,0,1,1,22
5607,5607,,0,0,0,375
5608,5608,,0,1,1,18
5609,5609,,1,0,1,94
5610,5610,,0,0,0,376
5611,5611,,1,0,1,3
5612,5612,,0,1,1,5
5613,5613,,0,0,0,377
5614,5614,,0,0,0,378
5615,5615,,0,1,1,22
5616,5616,,1,0,1,10
5617,5617,,1,0,1,4
5618,5618,,1,0,1,4
5619,5619,,1,0,1,4
5620,5620,,1,0,1,5
5621,5621,,0,1,1,94
5622,5622,,0,1,1,516
5623,5623,,0,1,1,77
5624,5624,,1,0,1,1
5625,5625,,1,0,1,0
5626,5626,,1,0,1,27
5627,5627,,0,0,0,379
5628,5628,,1,0,1,94
5629,5629,,0,1,1,5
5630,5630,,1,0,1,5
5631,5631,,0,1,1,8
5632,5632,,0,1,1,105
5633,5633,,0,1,1,7
5634,5634,,1,0,1,4
5635,5635,,1,0,1,5
5636,5636,,0,1,1,105
5637,5637,,1,0,1,5
5638,5638,,1,0,1,7
5639,5639,,0,1,1,4
5640,5640,,1,0,1,94
5641,5641,,0,0,0,380
5642,5642,,0,1,1,4
5643,5643,,0,1,1,94
5644,5644,,0,0,0,381
5645,5645,,0,1,1,362
5646,5646,,0,1,1,1
5647,5647,,0,1,1,3
5648,5648,,0,0,0,382
5649,5649,,0,1,1,105
5650,5650,,1,0,1,3
5651,5651,,1,0,1,105
5652,5652,,1,0,1,599
5653,5653,,0,1,1,353
5654,5654,,1,0,1,18
5655,5655,,1,0,1,532
5656,5656,,0,0,0,383
5657,5657,,0,1,1,105
5658,5658,,0,0,0,384
5659,5659,,1,0,1,22
5660,5660,,1,0,1,5
5661,5661,,0,1,1,4
5662,5662,,0,0,0,385
5663,5663,,0,1,1,7
5664,5664,,0,1,1,22
5665,5665,,0,1,1,455
5666,5666,,0,1,1,105
5667,5667,,0,1,1,1
5668,5668,,0,1,1,3
5669,5669,,1,0,1,105
5670,5670,,0,0,0,386
5671,5671,,0,1,1,148
5672,5672,,0,1,1,57
5673,5673,,1,0,1,292
5674,5674,,0,1,1,19
5675,5675,,1,0,1,5
5676,5676,,0,1,1,16
5677,5677,,1,0,1,3
5678,5678,,0,0,0,387
5679,5679,,1,0,1,8
5680,5680,,1,0,1,3
5681,5681,,0,1,1,32
5682,5682,,0,1,1,3
5683,5683,,0,1,1,3
5684,5684,,1,0,1,3
5685,5685,,0,1,1,658
5686,5686,,0,1,1,39
5687,5687,,0,1,1,447
5688,5688,,0,1,1,3
5689,5689,,0,1,1,479
5690,5690,,0,1,1,0
5691,5691,,0,0,0,388
5692,5692,,1,0,1,3
5693,5693,,0,1,1,4
5694,5694,,1,0,1,6
5695,5695,,1,0,1,3
5696,5696,,0,0,0,389
5697,5697,,0,1,1,33
5698,5698,,1,0,1,29
5699,5699,,0,1,1,3
5700,5700,,0,1,1,8
5701,5701,,0,1,1,3
5702,5702,,0,1,1,22
5703,5703,,0,1,1,4
5704,5704,,1,0,1,3
5705,5705,,1,0,1,94
5706,5706,,0,1,1,22
5707,5707,,1,0,1,4
5708,5708,,1,0,1,5
5709,5709,,0,1,1,22
5710,5710,,0,1,1,78
5711,5711,,1,0,1,480
5712,5712,,1,0,1,18
5713,5713,,0,1,1,5
5714,5714,,0,1,1,3
5715,5715,,0,1,1,9
5716,5716,,0,1,1,33
5717,5717,,0,1,1,390
5718,5718,,1,0,1,33
5719,5719,,1,0,1,8
5720,5720,,1,0,1,39
5721,5721,,1,0,1,94
5722,5722,,0,0,0,391
5723,5723,,1,0,1,78
5724,5724,,1,0,1,9
5725,5725,,0,1,1,4
5726,5726,,0,0,0,392
5727,5727,,0,1,1,39
5728,5728,,1,0,1,9
5729,5729,,0,1,1,8
5730,5730,,0,0,0,393
5731,5731,,0,1,1,105
5732,5732,,1,0,1,94
5733,5733,,0,1,1,3
5734,5734,,0,0,0,394
5735,5735,,0,0,0,395
5736,5736,,1,0,1,5
5737,5737,,1,0,1,6
5738,5738,,1,0,1,575
5739,5739,,0,0,0,396
5740,5740,,0,0,0,397
5741,5741,,0,1,1,5
5742,5742,,0,1,1,22
5743,5743,,0,1,1,105
5744,5744,,1,0,1,32
5745,5745,,0,1,1,78
5746,5746,,0,0,0,398
5747,5747,,1,0,1,22
5748,5748,,0,1,1,33
5749,5749,,0,1,1,8
5750,5750,,1,0,1,3
5751,5751,,1,0,1,3
5752,5752,,1,0,1,105
5753,5753,,1,0,1,105
5754,5754,,1,0,1,14
5755,5755,,0,0,0,399
5756,5756,,1,0,1,7
5757,5757,,0,1,1,8
5758,5758,,0,1,1,5
5759,5759,,0,0,0,400
5760,5760,,0,0,0,401
5761,5761,,0,0,0,402
5762,5762,,1,0,1,570
5763,5763,,0,1,1,171
5764,5764,,0,0,0,403
5765,5765,,0,1,1,105
5766,5766,,0,0,0,404
5767,5767,,1,0,1,105
5768,5768,,0,1,1,3
5769,5769,,1,0,1,4
5770,5770,,1,0,1,4
5771,5771,,0,0,0,405
5772,5772,,0,1,1,5
5773,5773,,0,0,0,406
5774,5774,,0,1,1,27
5775,5775,,0,1,1,7
5776,5776,,1,0,1,77
5777,5777,,0,1,1,4
5778,5778,,0,1,1,3
5779,5779,,0,0,0,407
5780,5780,,1,0,1,1
5781,5781,,0,0,0,408
5782,5782,,0,1,1,16
5783,5783,,0,1,1,3
5784,5784,,0,1,1,8
5785,5785,,0,1,1,4
5786,5786,,1,0,1,8
5787,5787,,1,0,1,4
5788,5788,,0,1,1,105
5789,5789,,0,0,0,409
5790,5790,,0,1,1,105
5791,5791,,0,1,1,94
5792,5792,,0,0,0,410
5793,5793,,1,0,1,29
5794,5794,,1,0,1,1
5795,5795,,1,0,1,9
5796,5796,,1,0,1,3
5797,5797,,1,0,1,94
5798,5798,,1,0,1,22
5799,5799,,0,0,0,411
5800,5800,,0,1,1,5
5801,5801,,1,0,1,1
5802,5802,,1,0,1,4
5803,5803,,0,1,1,4
5804,5804,,1,0,1,18
5805,5805,,0,1,1,4
5806,5806,,0,1,1,22
5807,5807,,0,0,0,412
5808,5808,,0,1,1,33
5809,5809,,0,1,1,440
5810,5810,,0,1,1,4
5811,5811,,1,0,1,4
5812,5812,,0,1,1,5
5813,5813,,0,0,0,413
5814,5814,,0,1,1,94
5815,5815,,0,0,0,414
5816,5816,,0,1,1,4
5817,5817,,0,0,0,415
5818,5818,,0,1,1,4
5819,5819,,0,1,1,5
5820,5820,,0,0,0,416
5821,5821,,1,0,1,8
5822,5822,,0,1,1,4
5823,5823,,0,1,1,3
5824,5824,,0,1,1,1
5825,5825,,1,0,1,18
5826,5826,,0,0,0,417
5827,5827,,1,0,1,3
5828,5828,,0,0,0,418
5829,5829,,1,0,1,22
5830,5830,,1,0,1,3
5831,5831,,0,1,1,78
5832,5832,,0,1,1,314
5833,5833,,0,1,1,8
5834,5834,,0,0,0,419
5835,5835,,1,0,1,57
5836,5836,,0,0,0,420
5837,5837,,0,1,1,430
5838,5838,,0,1,1,32
5839,5839,,0,0,0,421
5840,5840,,0,1,1,8
5841,5841,,1,0,1,554
5842,5842,,1,0,1,76
5843,5843,,1,0,1,22
5844,5844,,0,0,0,422
5845,5845,,1,0,1,5
5846,5846,,1,0,1,301
5847,5847,,0,1,1,3
5848,5848,,1,0,1,366
5849,5849,,0,1,1,8
5850,5850,,0,1,1,27
5851,5851,,0,1,1,1
5852,5852,,0,1,1,4
5853,5853,,0,0,0,423
5854,5854,,0,1,1,77
5855,5855,,1,0,1,24
5856,5856,,0,1,1,94
5857,5857,,1,0,1,45
5858,5858,,1,0,1,4
5859,5859,,1,0,1,105
5860,5860,,1,0,1,356
5861,5861,,0,1,1,8
5862,5862,,1,0,1,3
5863,5863,,0,1,1,10
5864,5864,,0,1,1,3
5865,5865,,0,1,1,4
5866,5866,,0,1,1,5
5867,5867,,0,1,1,78
5868,5868,,1,0,1,77
5869,5869,,0,1,1,19
5870,5870,,0,1,1,105
5871,5871,,0,1,1,77
5872,5872,,1,0,1,3
5873,5873,,0,0,0,424
5874,5874,,0,1,1,3
5875,5875,,0,0,0,425
5876,5876,,0,1,1,105
5877,5877,,0,1,1,10
5878,5878,,0,0,0,426
5879,5879,,1,0,1,5
5880,5880,,0,0,0,427
5881,5881,,0,1,1,610
5882,5882,,0,1,1,3
5883,5883,,1,0,1,19
5884,5884,,0,1,1,32
5885,5885,,0,1,1,3
5886,5886,,0,1,1,5
5887,5887,,0,1,1,94
5888,5888,,0,1,1,18
5889,5889,,1,0,1,78
5890,5890,,1,0,1,5
5891,5891,,0,1,1,33
5892,5892,,0,1,1,18
5893,5893,,1,0,1,3
5894,5894,,0,0,0,428
5895,5895,,0,1,1,3
5896,5896,,0,1,1,94
5897,5897,,1,0,1,105
5898,5898,,0,1,1,9
5899,5899,,1,0,1,9
5900,5900,,0,1,1,1
5901,5901,,0,0,0,429
5902,5902,,0,1,1,7
5903,5903,,1,0,1,5
5904,5904,,0,1,1,3
5905,5905,,1,0,1,430
5906,5906,,1,0,1,105
5907,5907,,1,0,1,18
5908,5908,,0,1,1,78
5909,5909,,0,1,1,78
5910,5910,,0,1,1,78
5911,5911,,1,0,1,617
5912,5912,,0,1,1,16
5913,5913,,0,1,1,22
5914,5914,,1,0,1,7
5915,5915,,0,1,1,105
5916,5916,,0,1,1,94
5917,5917,,1,0,1,0
5918,5918,,1,0,1,601
5919,5919,,1,0,1,22
5920,5920,,0,0,0,431
5921,5921,,1,0,1,632
5922,5922,,0,1,1,77
5923,5923,,0,0,0,432
5924,5924,,1,0,1,642
5925,5925,,1,0,1,511
5926,5926,,1,0,1,33
5927,5927,,1,0,1,94
5928,5928,,0,0,0,433
5929,5929,,0,1,1,78
5930,5930,,1,0,1,7
5931,5931,,0,0,0,434
5932,5932,,0,1,1,34
5933,5933,,0,1,1,32
5934,5934,,1,0,1,34
5935,5935,,0,1,1,22
5936,5936,,1,0,1,4
5937,5937,,1,0,1,10
5938,5938,,1,0,1,9
5939,5939,,1,0,1,0
5940,5940,,1,0,1,24
5941,5941,,1,0,1,5
5942,5942,,0,1,1,7
5943,5943,,1,0,1,126
5944,5944,,1,0,1,18
5945,5945,,0,1,1,435
5946,5946,,0,1,1,235
5947,5947,,0,1,1,22
5948,5948,,1,0,1,105
5949,5949,,0,1,1,22
5950,5950,,0,0,0,436
5951,5951,,0,0,0,437
5952,5952,,0,1,1,44
5953,5953,,0,1,1,571
5954,5954,,0,1,1,226
5955,5955,,0,1,1,77
5956,5956,,0,0,0,438
5957,5957,,1,0,1,5
5958,5958,,1,0,1,16
5959,5959,,1,0,1,3
5960,5960,,1,0,1,5
5961,5961,,1,0,1,8
5962,5962,,0,1,1,8
5963,5963,,0,1,1,4
5964,5964,,0,1,1,4
5965,5965,,1,0,1,8
5966,5966,,0,1,1,9
5967,5967,,1,0,1,3
5968,5968,,0,0,0,439
5969,5969,,1,0,1,440
5970,5970,,0,0,0,441
5971,5971,,0,1,1,3
5972,5972,,0,1,1,4
5973,5973,,1,0,1,19
5974,5974,,0,0,0,442
5975,5975,,1,0,1,3
5976,5976,,1,0,1,3
5977,5977,,1,0,1,4
5978,5978,,0,0,0,443
5979,5979,,1,0,1,5
5980,5980,,1,0,1,4
5981,5981,,1,0,1,504
5982,5982,,1,0,1,19
5983,5983,,1,0,1,22
5984,5984,,1,0,1,27
5985,5985,,1,0,1,32
5986,5986,,0,1,1,3
5987,5987,,0,0,0,444
5988,5988,,1,0,1,3
5989,5989,,0,0,0,445
5990,5990,,1,0,1,6
5991,5991,,1,0,1,33
5992,5992,,1,0,1,3
5993,5993,,0,1,1,5
5994,5994,,0,1,1,1
5995,5995,,0,1,1,7
5996,5996,,1,0,1,3
5997,5997,,0,1,1,8
5998,5998,,0,1,1,8
5999,5999,,0,0,0,446
6000,6000,,0,1,1,10
6001,6001,,0,1,1,3
6002,6002,,0,1,1,5
6003,6003,,0,1,1,9
6004,6004,,1,0,1,4
6005,6005,,1,0,1,447
6006,6006,,1,0,1,3
6007,6007,,1,0,1,1
6008,6008,,0,1,1,3
6009,6009,,0,1,1,4
6010,6010,,1,0,1,264
6011,6011,,1,0,1,4
6012,6012,,0,1,1,77
6013,6013,,1,0,1,77
6014,6014,,0,1,1,18
6015,6015,,0,1,1,4
6016,6016,,0,1,1,7
6017,6017,,0,1,1,78
6018,6018,,0,1,1,77
6019,6019,,0,1,1,3
6020,6020,,1,0,1,18
6021,6021,,1,0,1,5
6022,6022,,0,1,1,3
6023,6023,,0,1,1,541
6024,6024,,1,0,1,3
6025,6025,,1,0,1,3
6026,6026,,0,1,1,5
6027,6027,,0,1,1,4
6028,6028,,0,0,0,448
6029,6029,,1,0,1,611
6030,6030,,0,0,0,449
6031,6031,,1,0,1,4
6032,6032,,0,1,1,9
6033,6033,,0,1,1,3
6034,6034,,0,1,1,5
6035,6035,,1,0,1,14
6036,6036,,0,1,1,33
6037,6037,,1,0,1,19
6038,6038,,1,0,1,4
6039,6039,,0,1,1,6
6040,6040,,1,0,1,8
6041,6041,,1,0,1,94
6042,6042,,0,1,1,273
6043,6043,,0,1,1,27
6044,6044,,0,1,1,22
6045,6045,,1,0,1,77
6046,6046,,1,0,1,16
6047,6047,,0,0,0,450
6048,6048,,1,0,1,5
6049,6049,,1,0,1,5
6050,6050,,1,0,1,94
6051,6051,,1,0,1,3
6052,6052,,1,0,1,8
6053,6053,,1,0,1,24
6054,6054,,0,0,0,451
6055,6055,,0,0,0,452
6056,6056,,0,0,0,453
6057,6057,,0,0,0,454
6058,6058,,0,1,1,105
6059,6059,,1,0,1,19
6060,6060,,0,1,1,105
6061,6061,,1,0,1,24
6062,6062,,1,0,1,5
6063,6063,,1,0,1,4
6064,6064,,1,0,1,4
6065,6065,,1,0,1,4
6066,6066,,1,0,1,3
6067,6067,,0,1,1,3
6068,6068,,0,1,1,33
6069,6069,,1,0,1,455
6070,6070,,1,0,1,94
6071,6071,,0,0,0,456
6072,6072,,1,0,1,539
6073,6073,,1,0,1,75
6074,6074,,0,1,1,19
6075,6075,,0,0,0,457
6076,6076,,1,0,1,3
6077,6077,,0,1,1,4
6078,6078,,0,1,1,33
6079,6079,,0,1,1,5
6080,6080,,0,1,1,22
6081,6081,,1,0,1,8
6082,6082,,0,0,0,458
6083,6083,,0,1,1,18
6084,6084,,1,0,1,16
6085,6085,,0,0,0,459
6086,6086,,1,0,1,4
6087,6087,,1,0,1,240
6088,6088,,0,1,1,33
6089,6089,,0,1,1,8
6090,6090,,0,1,1,4
6091,6091,,0,0,0,460
6092,6092,,0,0,0,461
6093,6093,,0,0,0,462
6094,6094,,0,1,1,14
6095,6095,,1,0,1,3
6096,6096,,1,0,1,5
6097,6097,,1,0,1,1
6098,6098,,1,0,1,24
6099,6099,,1,0,1,4
6100,6100,,0,0,0,463
6101,6101,,1,0,1,1
6102,6102,,0,1,1,491
6103,6103,,0,0,0,464
6104,6104,,0,1,1,5
6105,6105,,0,1,1,7
6106,6106,,1,0,1,4
6107,6107,,0,1,1,9
6108,6108,,1,0,1,1
6109,6109,,1,0,1,9
6110,6110,,0,1,1,4
6111,6111,,1,0,1,240
6112,6112,,0,1,1,4
6113,6113,,1,0,1,4
6114,6114,,0,1,1,4
6115,6115,,0,1,1,94
6116,6116,,0,0,0,465
6117,6117,,1,0,1,18
6118,6118,,1,0,1,1
6119,6119,,0,1,1,94
6120,6120,,0,1,1,33
6121,6121,,1,0,1,3
6122,6122,,1,0,1,4
6123,6123,,0,0,0,466
6124,6124,,1,0,1,16
6125,6125,,0,1,1,3
6126,6126,,0,1,1,346
6127,6127,,0,1,1,469
6128,6128,,0,1,1,9
6129,6129,,0,0,0,467
6130,6130,,0,0,0,468
6131,6131,,0,1,1,4
6132,6132,,0,1,1,18
6133,6133,,0,1,1,4
6134,6134,,1,0,1,469
6135,6135,,1,0,1,555
6136,6136,,0,0,0,470
6137,6137,,0,1,1,4
6138,6138,,0,1,1,9
6139,6139,,0,1,1,544
6140,6140,,0,0,0,471
6141,6141,,0,0,0,472
6142,6142,,1,0,1,22
6143,6143,,0,1,1,19
6144,6144,,1,0,1,143
6145,6145,,0,1,1,3
6146,6146,,0,0,0,473
6147,6147,,1,0,1,4
6148,6148,,1,0,1,5
6149,6149,,0,1,1,3
6150,6150,,0,1,1,18
6151,6151,,1,0,1,5
6152,6152,,0,1,1,4
6153,6153,,0,1,1,18
6154,6154,,0,0,0,474
6155,6155,,0,0,0,475
6156,6156,,0,1,1,0
6157,6157,,0,1,1,8
6158,6158,,0,1,1,4
6159,6159,,0,1,1,1
6160,6160,,1,0,1,8
6161,6161,,1,0,1,8
6162,6162,,0,1,1,1
6163,6163,,0,0,0,476
6164,6164,,0,1,1,77
6165,6165,,0,1,1,22
6166,6166,,0,1,1,9
6167,6167,,0,1,1,105
6168,6168,,0,0,0,477
6169,6169,,0,1,1,105
6170,6170,,0,1,1,3
6171,6171,,1,0,1,8
6172,6172,,0,1,1,105
6173,6173,,0,1,1,39
6174,6174,,1,0,1,77
6175,6175,,0,1,1,18
6176,6176,,0,1,1,22
6177,6177,,0,1,1,39
6178,6178,,0,1,1,105
6179,6179,,0,1,1,34
6180,6180,,1,0,1,105
6181,6181,,0,1,1,3
6182,6182,,0,1,1,94
6183,6183,,0,1,1,33
6184,6184,,0,1,1,9
6185,6185,,0,1,1,76
6186,6186,,0,1,1,578
6187,6187,,0,1,1,4
6188,6188,,0,1,1,5
6189,6189,,1,0,1,18
6190,6190,,1,0,1,9
6191,6191,,0,1,1,94
6192,6192,,0,1,1,7
6193,6193,,0,1,1,9
6194,6194,,1,0,1,14
6195,6195,,1,0,1,7
6196,6196,,0,0,0,478
6197,6197,,0,1,1,78
6198,6198,,0,1,1,4
6199,6199,,0,1,1,27
6200,6200,,1,0,1,479
6201,6201,,0,1,1,77
6202,6202,,1,0,1,32
6203,6203,,1,0,1,4
6204,6204,,0,1,1,3
6205,6205,,0,1,1,9
6206,6206,,0,1,1,3
6207,6207,,1,0,1,3
6208,6208,,0,1,1,3
6209,6209,,1,0,1,1
6210,6210,,0,1,1,9
6211,6211,,1,0,1,4
6212,6212,,0,1,1,480
6213,6213,,1,0,1,308
6214,6214,,0,1,1,3
6215,6215,,1,0,1,3
6216,6216,,0,1,1,34
6217,6217,,1,0,1,264
6218,6218,,0,1,1,78
6219,6219,,0,1,1,82
6220,6220,,1,0,1,39
6221,6221,,0,1,1,94
6222,6222,,0,1,1,33
6223,6223,,0,1,1,5
6224,6224,,0,0,0,481
6225,6225,,0,1,1,5
6226,6226,,0,1,1,9
6227,6227,,0,1,1,9
6228,6228,,0,1,1,4
6229,6229,,0,1,1,4
6230,6230,,0,0,0,482
6231,6231,,1,0,1,569
6232,6232,,1,0,1,3
6233,6233,,1,0,1,113
6234,6234,,0,0,0,483
6235,6235,,1,0,1,7
6236,6236,,1,0,1,1
6237,6237,,1,0,1,22
6238,6238,,1,0,1,63
6239,6239,,0,0,0,484
6240,6240,,1,0,1,1
6241,6241,,1,0,1,5
6242,6242,,0,1,1,4
6243,6243,,1,0,1,9
6244,6244,,1,0,1,22
6245,6245,,0,0,0,485
6246,6246,,0,1,1,514
6247,6247,,0,1,1,18
6248,6248,,0,1,1,78
6249,6249,,0,1,1,40
6250,6250,,0,0,0,486
6251,6251,,0,0,0,487
6252,6252,,1,0,1,39
6253,6253,,0,1,1,33
6254,6254,,0,1,1,5
6255,6255,,0,1,1,633
6256,6256,,0,1,1,4
6257,6257,,0,1,1,18
6258,6258,,0,1,1,3
6259,6259,,0,1,1,22
6260,6260,,1,0,1,8
6261,6261,,0,1,1,3
6262,6262,,1,0,1,5
6263,6263,,0,1,1,3
6264,6264,,1,0,1,3
6265,6265,,0,1,1,24
6266,6266,,0,0,0,488
6267,6267,,0,1,1,8
6268,6268,,0,1,1,74
6269,6269,,0,0,0,489
6270,6270,,0,1,1,29
6271,6271,,0,0,0,490
6272,6272,,0,1,1,16
6273,6273,,1,0,1,491
6274,6274,,0,1,1,18
6275,6275,,1,0,1,586
6276,6276,,1,0,1,93
6277,6277,,0,1,1,94
6278,6278,,1,0,1,105
6279,6279,,1,0,1,39
6280,6280,,0,1,1,18
6281,6281,,0,0,0,492
6282,6282,,1,0,1,9
6283,6283,,0,1,1,4
6284,6284,,1,0,1,4
6285,6285,,1,0,1,18
6286,6286,,0,1,1,19
6287,6287,,0,1,1,5
6288,6288,,1,0,1,5
6289,6289,,0,1,1,8
6290,6290,,0,1,1,3
6291,6291,,0,1,1,78
6292,6292,,1,0,1,7
6293,6293,,0,1,1,92
6294,6294,,1,0,1,3
6295,6295,,0,0,0,493
6296,6296,,0,1,1,9
6297,6297,,0,1,1,4
6298,6298,,1,0,1,8
6299,6299,,0,1,1,33
6300,6300,,0,1,1,94
6301,6301,,0,0,0,494
6302,6302,,0,1,1,7
6303,6303,,1,0,1,77
6304,6304,,0,1,1,4
6305,6305,,1,0,1,3
6306,6306,,1,0,1,3
6307,6307,,0,1,1,3
6308,6308,,0,0,0,495
6309,6309,,1,0,1,7
6310,6310,,0,1,1,8
6311,6311,,0,0,0,496
6312,6312,,0,0,0,497
6313,6313,,0,0,0,498
6314,6314,,1,0,1,77
6315,6315,,0,1,1,105
6316,6316,,0,1,1,219
6317,6317,,0,1,1,105
6318,6318,,0,1,1,57
6319,6319,,0,0,0,499
6320,6320,,1,0,1,22
6321,6321,,0,0,0,500
6322,6322,,0,0,0,501
6323,6323,,0,0,0,502
6324,6324,,1,0,1,33
6325,6325,,1,0,1,105
6326,6326,,0,1,1,3
6327,6327,,0,0,0,503
6328,6328,,0,1,1,94
6329,6329,,1,0,1,21
6330,6330,,0,1,1,4
6331,6331,,0,1,1,504
6332,6332,,0,1,1,32
6333,6333,,0,1,1,3
6334,6334,,1,0,1,94
6335,6335,,1,0,1,19
6336,6336,,1,0,1,22
6337,6337,,1,0,1,19
6338,6338,,0,0,0,505
6339,6339,,1,0,1,22
6340,6340,,0,1,1,10
6341,6341,,1,0,1,3
6342,6342,,1,0,1,7
6343,6343,,0,1,1,33
6344,6344,,0,1,1,9
6345,6345,,1,0,1,22
6346,6346,,0,0,0,506
6347,6347,,0,0,0,507
6348,6348,,1,0,1,57
6349,6349,,0,1,1,5
6350,6350,,0,0,0,508
6351,6351,,0,1,1,16
6352,6352,,0,1,1,3
6353,6353,,0,1,1,27
6354,6354,,0,1,1,4
6355,6355,,0,1,1,78
6356,6356,,1,0,1,14
6357,6357,,0,1,1,551
6358,6358,,0,0,0,509
6359,6359,,0,1,1,3
6360,6360,,1,0,1,3
6361,6361,,0,1,1,5
6362,6362,,0,1,1,3
6363,6363,,0,0,0,510
6364,6364,,0,1,1,511
6365,6365,,0,1,1,4
6366,6366,,1,0,1,9
6367,6367,,0,1,1,45
6368,6368,,0,1,1,4
6369,6369,,0,0,0,512
6370,6370,,0,1,1,7
6371,6371,,1,0,1,94
6372,6372,,0,1,1,105
6373,6373,,0,1,1,25
6374,6374,,0,0,0,513
6375,6375,,1,0,1,514
6376,6376,,1,0,1,77
6377,6377,,0,1,1,8
6378,6378,,0,1,1,4
6379,6379,,0,1,1,4
6380,6380,,1,0,1,33
6381,6381,,1,0,1,3
6382,6382,,1,0,1,94
6383,6383,,0,1,1,0
6384,6384,,1,0,1,8
6385,6385,,1,0,1,3
6386,6386,,0,0,0,515
6387,6387,,0,1,1,8
6388,6388,,0,1,1,4
6389,6389,,0,1,1,3
6390,6390,,1,0,1,105
6391,6391,,0,1,1,8
6392,6392,,1,0,1,94
6393,6393,,0,1,1,4
6394,6394,,1,0,1,516
6395,6395,,0,0,0,517
6396,6396,,0,0,0,518
6397,6397,,0,0,0,519
6398,6398,,1,0,1,5
6399,6399,,1,0,1,5
6400,6400,,0,0,0,520
6401,6401,,0,1,1,1
6402,6402,,1,0,1,105
6403,6403,,0,1,1,19
6404,6404,,1,0,1,4
6405,6405,,0,1,1,292
6406,6406,,1,0,1,3
6407,6407,,1,0,1,6
6408,6408,,1,0,1,14
6409,6409,,0,1,1,19
6410,6410,,0,0,0,521
6411,6411,,0,1,1,5
6412,6412,,0,1,1,94
6413,6413,,0,1,1,4
6414,6414,,0,1,1,45
6415,6415,,0,0,0,522
6416,6416,,0,1,1,192
6417,6417,,0,0,0,523
6418,6418,,0,0,0,524
6419,6419,,1,0,1,16
6420,6420,,0,1,1,22
6421,6421,,1,0,1,94
6422,6422,,0,1,1,78
6423,6423,,1,0,1,18
6424,6424,,0,1,1,5
6425,6425,,1,0,1,3
6426,6426,,1,0,1,4
6427,6427,,0,1,1,5
6428,6428,,0,1,1,5
6429,6429,,1,0,1,24
6430,6430,,1,0,1,4
6431,6431,,1,0,1,6
6432,6432,,0,0,0,525
6433,6433,,0,1,1,19
6434,6434,,0,1,1,5
6435,6435,,1,0,1,3
6436,6436,,0,1,1,9
6437,6437,,0,1,1,5
6438,6438,,0,1,1,22
6439,6439,,0,1,1,1
6440,6440,,1,0,1,7
6441,6441,,0,1,1,557
6442,6442,,0,1,1,8
6443,6443,,1,0,1,9
6444,6444,,1,0,1,33
6445,6445,,1,0,1,22
6446,6446,,0,1,1,3
6447,6447,,0,1,1,0
6448,6448,,0,0,0,526
6449,6449,,0,1,1,94
6450,6450,,1,0,1,4
6451,6451,,0,0,0,527
6452,6452,,0,0,0,528
6453,6453,,0,1,1,19
6454,6454,,0,0,0,529
6455,6455,,1,0,1,3
6456,6456,,0,1,1,5
6457,6457,,1,0,1,19
6458,6458,,0,1,1,78
6459,6459,,1,0,1,3
6460,6460,,1,0,1,10
6461,6461,,1,0,1,18
6462,6462,,0,1,1,3
6463,6463,,0,1,1,5
6464,6464,,1,0,1,74
6465,6465,,0,1,1,94
6466,6466,,0,1,1,5
6467,6467,,0,1,1,105
6468,6468,,0,1,1,7
6469,6469,,1,0,1,3
6470,6470,,0,0,0,530
6471,6471,,0,0,0,531
6472,6472,,0,1,1,94
6473,6473,,0,1,1,8
6474,6474,,0,1,1,4
6475,6475,,1,0,1,40
6476,6476,,0,1,1,27
6477,6477,,0,1,1,5
6478,6478,,0,1,1,19
6479,6479,,0,1,1,532
6480,6480,,0,1,1,1
6481,6481,,0,1,1,1
6482,6482,,0,0,0,533
6483,6483,,1,0,1,9
6484,6484,,1,0,1,5
6485,6485,,1,0,1,10
6486,6486,,0,1,1,14
6487,6487,,1,0,1,16
6488,6488,,0,0,0,534
6489,6489,,1,0,1,19
6490,6490,,1,0,1,5
6491,6491,,1,0,1,3
6492,6492,,0,0,0,535
6493,6493,,1,0,1,5
6494,6494,,0,0,0,536
6495,6495,,0,1,1,27
6496,6496,,1,0,1,4
6497,6497,,0,0,0,537
6498,6498,,1,0,1,24
6499,6499,,0,1,1,33
6500,6500,,1,0,1,4
6501,6501,,0,0,0,538
6502,6502,,1,0,1,24
6503,6503,,1,0,1,8
6504,6504,,0,1,1,4
6505,6505,,1,0,1,4
6506,6506,,1,0,1,24
6507,6507,,0,1,1,539
6508,6508,,1,0,1,5
6509,6509,,1,0,1,7
6510,6510,,1,0,1,105
6511,6511,,1,0,1,18
6512,6512,,0,1,1,7
6513,6513,,1,0,1,3
6514,6514,,1,0,1,14
6515,6515,,0,0,0,540
6516,6516,,0,1,1,78
6517,6517,,1,0,1,3
6518,6518,,0,1,1,16
6519,6519,,1,0,1,3
6520,6520,,0,1,1,5
6521,6521,,0,1,1,9
6522,6522,,1,0,1,5
6523,6523,,1,0,1,78
6524,6524,,0,1,1,5
6525,6525,,1,0,1,541
6526,6526,,0,1,1,9
6527,6527,,1,0,1,3
6528,6528,,1,0,1,33
6529,6529,,1,0,1,4
6530,6530,,0,1,1,8
6531,6531,,0,1,1,33
6532,6532,,1,0,1,105
6533,6533,,1,0,1,94
6534,6534,,0,1,1,10
6535,6535,,0,1,1,105
6536,6536,,0,0,0,542
6537,6537,,0,1,1,4
6538,6538,,0,1,1,4
6539,6539,,1,0,1,3
6540,6540,,0,1,1,4
6541,6541,,1,0,1,105
6542,6542,,0,0,0,543
6543,6543,,0,1,1,1
6544,6544,,1,0,1,110
6545,6545,,1,0,1,5
6546,6546,,1,0,1,544
6547,6547,,0,1,1,32
6548,6548,,1,0,1,22
6549,6549,,0,0,0,545
6550,6550,,1,0,1,9
6551,6551,,1,0,1,3
6552,6552,,1,0,1,57
6553,6553,,0,1,1,8
6554,6554,,1,0,1,94
6555,6555,,0,0,0,546
6556,6556,,0,1,1,22
6557,6557,,1,0,1,5
6558,6558,,0,1,1,33
6559,6559,,0,1,1,19
6560,6560,,1,0,1,3
6561,6561,,1,0,1,94
6562,6562,,0,1,1,21
6563,6563,,0,0,0,547
6564,6564,,1,0,1,3
6565,6565,,0,1,1,18
6566,6566,,1,0,1,18
6567,6567,,0,1,1,18
6568,6568,,0,1,1,7
6569,6569,,0,1,1,14
6570,6570,,0,1,1,22
6571,6571,,1,0,1,226
6572,6572,,0,1,1,3
6573,6573,,0,1,1,1
6574,6574,,1,0,1,33
6575,6575,,1,0,1,4
6576,6576,,1,0,1,33
6577,6577,,1,0,1,19
6578,6578,,0,1,1,32
6579,6579,,0,1,1,4
6580,6580,,0,1,1,4
6581,6581,,1,0,1,0
6582,6582,,0,0,0,548
6583,6583,,1,0,1,151
6584,6584,,0,0,0,549
6585,6585,,1,0,1,5
6586,6586,,1,0,1,1
6587,6587,,0,1,1,8
6588,6588,,0,1,1,132
6589,6589,,0,1,1,5
6590,6590,,0,0,0,550
6591,6591,,0,1,1,3
6592,6592,,1,0,1,8
6593,6593,,0,1,1,10
6594,6594,,1,0,1,0
6595,6595,,0,1,1,94
6596,6596,,0,1,1,33
6597,6597,,0,1,1,3
6598,6598,,0,1,1,4
6599,6599,,1,0,1,14
6600,6600,,0,1,1,34
6601,6601,,0,1,1,24
6602,6602,,0,1,1,5
6603,6603,,0,1,1,18
6604,6604,,1,0,1,78
6605,6605,,1,0,1,33
6606,6606,,1,0,1,8
6607,6607,,1,0,1,238
6608,6608,,1,0,1,3
6609,6609,,1,0,1,14
6610,6610,,0,1,1,3
6611,6611,,0,1,1,0
6612,6612,,1,0,1,551
6613,6613,,0,1,1,1
6614,6614,,0,1,1,3
6615,6615,,0,0,0,552
6616,6616,,1,0,1,19
6617,6617,,0,0,0,553
6618,6618,,1,0,1,3
6619,6619,,0,1,1,554
6620,6620,,0,1,1,34
6621,6621,,0,1,1,22
6622,6622,,0,1,1,555
6623,6623,,0,1,1,22
6624,6624,,0,0,0,556
6625,6625,,0,1,1,3
6626,6626,,0,1,1,16
6627,6627,,1,0,1,557
6628,6628,,1,0,1,3
6629,6629,,1,0,1,8
6630,6630,,1,0,1,3
6631,6631,,0,0,0,558
6632,6632,,1,0,1,22
6633,6633,,0,1,1,33
6634,6634,,0,0,0,559
6635,6635,,1,0,1,3
6636,6636,,0,1,1,0
6637,6637,,0,1,1,3
6638,6638,,0,1,1,7
6639,6639,,0,1,1,3
6640,6640,,0,0,0,560
6641,6641,,1,0,1,78
6642,6642,,0,1,1,94
6643,6643,,0,0,0,561
6644,6644,,0,1,1,64
6645,6645,,0,1,1,8
6646,6646,,0,1,1,78
6647,6647,,0,1,1,33
6648,6648,,0,1,1,3
6649,6649,,0,1,1,9
6650,6650,,0,1,1,4
6651,6651,,0,1,1,345
6652,6652,,0,1,1,78
6653,6653,,1,0,1,93
6654,6654,,0,1,1,94
6655,6655,,0,1,1,3
6656,6656,,1,0,1,4
6657,6657,,1,0,1,5
6658,6658,,1,0,1,22
6659,6659,,1,0,1,4
6660,6660,,0,0,0,562
6661,6661,,0,0,0,563
6662,6662,,0,1,1,18
6663,6663,,0,1,1,5
6664,6664,,0,1,1,5
6665,6665,,0,0,0,564
6666,6666,,1,0,1,6
6667,6667,,1,0,1,3
6668,6668,,1,0,1,94
6669,6669,,0,0,0,565
6670,6670,,1,0,1,3
6671,6671,,0,1,1,3
6672,6672,,0,0,0,566
6673,6673,,0,1,1,3
6674,6674,,0,0,0,567
6675,6675,,1,0,1,3
6676,6676,,0,0,0,568
6677,6677,,0,1,1,569
6678,6678,,0,1,1,570
6679,6679,,1,0,1,571
6680,6680,,1,0,1,5
6681,6681,,0,1,1,5
6682,6682,,0,1,1,10
6683,6683,,0,1,1,358
6684,6684,,0,1,1,32
6685,6685,,0,1,1,5
6686,6686,,0,0,0,572
6687,6687,,1,0,1,3
6688,6688,,0,0,0,573
6689,6689,,0,1,1,223
6690,6690,,0,0,0,574
6691,6691,,0,1,1,1
6692,6692,,0,1,1,575
6693,6693,,0,1,1,105
6694,6694,,1,0,1,3
6695,6695,,0,1,1,39
6696,6696,,1,0,1,22
6697,6697,,1,0,1,1
6698,6698,,1,0,1,77
6699,6699,,0,1,1,4
6700,6700,,0,0,0,576
6701,6701,,0,0,0,577
6702,6702,,1,0,1,3
6703,6703,,0,1,1,5
6704,6704,,0,1,1,7
6705,6705,,1,0,1,5
6706,6706,,1,0,1,19
6707,6707,,1,0,1,3
6708,6708,,1,0,1,578
6709,6709,,0,1,1,105
6710,6710,,0,1,1,9
6711,6711,,1,0,1,9
6712,6712,,1,0,1,18
6713,6713,,0,1,1,94
6714,6714,,1,0,1,32
6715,6715,,0,0,0,579
6716,6716,,1,0,1,14
6717,6717,,0,1,1,19
6718,6718,,0,1,1,4
6719,6719,,1,0,1,94
6720,6720,,0,1,1,105
6721,6721,,0,1,1,27
6722,6722,,0,0,0,580
6723,6723,,0,1,1,94
6724,6724,,1,0,1,77
6725,6725,,0,1,1,3
6726,6726,,0,1,1,18
6727,6727,,0,1,1,27
6728,6728,,0,1,1,3
6729,6729,,0,0,0,581
6730,6730,,1,0,1,4
6731,6731,,1,0,1,3
6732,6732,,1,0,1,5
6733,6733,,0,0,0,582
6734,6734,,0,0,0,583
6735,6735,,0,1,1,3
6736,6736,,0,1,1,1
6737,6737,,0,1,1,27
6738,6738,,0,0,0,584
6739,6739,,0,1,1,3
6740,6740,,1,0,1,8
6741,6741,,0,1,1,16
6742,6742,,0,1,1,105
6743,6743,,0,1,1,18
6744,6744,,1,0,1,1
6745,6745,,0,1,1,105
6746,6746,,0,1,1,105
6747,6747,,0,1,1,3
6748,6748,,0,1,1,10
6749,6749,,0,0,0,585
6750,6750,,0,1,1,4
6751,6751,,0,1,1,3
6752,6752,,0,1,1,586
6753,6753,,1,0,1,3
6754,6754,,0,1,1,5
6755,6755,,0,1,1,105
6756,6756,,0,0,0,587
6757,6757,,0,1,1,34
6758,6758,,0,1,1,5
6759,6759,,0,1,1,22
6760,6760,,1,0,1,22
6761,6761,,0,1,1,5
6762,6762,,0,0,0,588
6763,6763,,0,0,0,589
6764,6764,,0,1,1,32
6765,6765,,0,1,1,22
6766,6766,,1,0,1,32
6767,6767,,1,0,1,7
6768,6768,,1,0,1,18
6769,6769,,0,1,1,1
6770,6770,,1,0,1,4
6771,6771,,0,0,0,590
6772,6772,,0,0,0,591
6773,6773,,0,1,1,34
6774,6774,,1,0,1,7
6775,6775,,1,0,1,78
6776,6776,,0,1,1,19
6777,6777,,0,0,0,592
6778,6778,,1,0,1,94
6779,6779,,0,0,0,593
6780,6780,,0,1,1,24
6781,6781,,1,0,1,9
6782,6782,,0,0,0,594
6783,6783,,0,1,1,5
6784,6784,,0,1,1,105
6785,6785,,0,1,1,9
6786,6786,,1,0,1,22
6787,6787,,0,1,1,1
6788,6788,,0,1,1,4
6789,6789,,0,1,1,94
6790,6790,,0,1,1,4
6791,6791,,0,1,1,4
6792,6792,,0,1,1,3
6793,6793,,1,0,1,16
6794,6794,,1,0,1,1
6795,6795,,0,1,1,7
6796,6796,,1,0,1,4
6797,6797,,1,0,1,33
6798,6798,,0,0,0,595
6799,6799,,0,0,0,596
6800,6800,,1,0,1,94
6801,6801,,0,1,1,16
6802,6802,,0,1,1,32
6803,6803,,1,0,1,24
6804,6804,,0,1,1,14
6805,6805,,1,0,1,6
6806,6806,,0,1,1,3
6807,6807,,1,0,1,57
6808,6808,,0,1,1,105
6809,6809,,0,0,0,597
6810,6810,,1,0,1,33
6811,6811,,0,0,0,598
6812,6812,,0,1,1,1
6813,6813,,0,1,1,5
6814,6814,,0,1,1,10
6815,6815,,1,0,1,33
6816,6816,,0,1,1,3
6817,6817,,0,1,1,599
6818,6818,,1,0,1,94
6819,6819,,0,1,1,9
6820,6820,,0,0,0,600
6821,6821,,0,1,1,3
6822,6822,,1,0,1,5
6823,6823,,0,1,1,5
6824,6824,,0,1,1,601
6825,6825,,0,1,1,1
6826,6826,,0,1,1,9
6827,6827,,0,0,0,602
6828,6828,,0,1,1,3
6829,6829,,1,0,1,8
6830,6830,,0,1,1,4
6831,6831,,0,1,1,3
6832,6832,,0,1,1,5
6833,6833,,0,1,1,5
6834,6834,,0,1,1,94
6835,6835,,1,0,1,78
6836,6836,,0,1,1,3
6837,6837,,0,1,1,22
6838,6838,,0,1,1,3
6839,6839,,1,0,1,4
6840,6840,,1,0,1,0
6841,6841,,0,1,1,63
6842,6842,,0,0,0,603
6843,6843,,0,1,1,4
6844,6844,,1,0,1,1
6845,6845,,0,1,1,94
6846,6846,,1,0,1,644
6847,6847,,0,0,0,604
6848,6848,,0,1,1,19
6849,6849,,1,0,1,105
6850,6850,,1,0,1,105
6851,6851,,0,1,1,3
6852,6852,,0,1,1,5
6853,6853,,1,0,1,14
6854,6854,,0,1,1,105
6855,6855,,1,0,1,9
6856,6856,,0,1,1,22
6857,6857,,1,0,1,7
6858,6858,,1,0,1,1
6859,6859,,0,0,0,605
6860,6860,,0,1,1,3
6861,6861,,0,0,0,606
6862,6862,,1,0,1,14
6863,6863,,0,1,1,32
6864,6864,,0,1,1,3
6865,6865,,0,1,1,8
6866,6866,,1,0,1,34
6867,6867,,0,1,1,4
6868,6868,,0,1,1,4
6869,6869,,0,0,0,607
6870,6870,,1,0,1,77
6871,6871,,1,0,1,8
6872,6872,,0,1,1,3
6873,6873,,1,0,1,9
6874,6874,,0,1,1,1
6875,6875,,0,1,1,22
6876,6876,,0,0,0,608
6877,6877,,1,0,1,4
6878,6878,,1,0,1,9
6879,6879,,0,1,1,3
6880,6880,,0,1,1,5
6881,6881,,1,0,1,6
6882,6882,,0,1,1,33
6883,6883,,1,0,1,652
6884,6884,,0,1,1,3
6885,6885,,1,0,1,7
6886,6886,,0,1,1,4
6887,6887,,0,1,1,78
6888,6888,,1,0,1,1
6889,6889,,1,0,1,4
6890,6890,,1,0,1,7
6891,6891,,1,0,1,8
6892,6892,,0,1,1,105
6893,6893,,1,0,1,3
6894,6894,,1,0,1,4
6895,6895,,0,1,1,639
6896,6896,,1,0,1,16
6897,6897,,1,0,1,18
6898,6898,,0,0,0,609
6899,6899,,0,1,1,105
6900,6900,,1,0,1,610
6901,6901,,1,0,1,9
6902,6902,,1,0,1,78
6903,6903,,1,0,1,14
6904,6904,,0,1,1,3
6905,6905,,1,0,1,77
6906,6906,,0,1,1,6
6907,6907,,0,1,1,4
6908,6908,,0,1,1,33
6909,6909,,0,1,1,33
6910,6910,,0,1,1,1
6911,6911,,0,1,1,94
6912,6912,,0,1,1,94
6913,6913,,0,1,1,94
6914,6914,,0,1,1,5
6915,6915,,0,1,1,611
6916,6916,,1,0,1,4
6917,6917,,0,0,0,612
6918,6918,,1,0,1,16
6919,6919,,0,0,0,613
6920,6920,,0,0,0,614
6921,6921,,1,0,1,105
6922,6922,,0,1,1,1
6923,6923,,0,1,1,0
6924,6924,,0,1,1,5
6925,6925,,1,0,1,32
6926,6926,,0,1,1,105
6927,6927,,0,0,0,615
6928,6928,,0,1,1,16
6929,6929,,0,0,0,616
6930,6930,,0,1,1,617
6931,6931,,0,1,1,32
6932,6932,,0,1,1,4
6933,6933,,0,0,0,618
6934,6934,,0,1,1,4
6935,6935,,1,0,1,3
6936,6936,,0,1,1,3
6937,6937,,0,0,0,619
6938,6938,,1,0,1,18
6939,6939,,0,1,1,8
6940,6940,,0,0,0,620
6941,6941,,0,1,1,18
6942,6942,,0,0,0,621
6943,6943,,0,0,0,622
6944,6944,,0,0,0,623
6945,6945,,1,0,1,105
6946,6946,,0,1,1,3
6947,6947,,0,1,1,206
6948,6948,,0,1,1,5
6949,6949,,0,1,1,3
6950,6950,,0,1,1,3
6951,6951,,0,0,0,624
6952,6952,,0,1,1,3
6953,6953,,0,0,0,625
6954,6954,,0,1,1,16
6955,6955,,1,0,1,3
6956,6956,,1,0,1,5
6957,6957,,0,1,1,1
6958,6958,,0,1,1,14
6959,6959,,0,1,1,94
6960,6960,,0,1,1,14
6961,6961,,1,0,1,78
6962,6962,,0,1,1,5
6963,6963,,0,1,1,94
6964,6964,,0,1,1,78
6965,6965,,0,0,0,626
6966,6966,,0,0,0,627
6967,6967,,0,1,1,22
6968,6968,,0,1,1,77
6969,6969,,1,0,1,4
6970,6970,,0,0,0,628
6971,6971,,0,0,0,629
6972,6972,,0,0,0,630
6973,6973,,1,0,1,4
6974,6974,,1,0,1,8
6975,6975,,1,0,1,4
6976,6976,,1,0,1,3
6977,6977,,0,1,1,16
6978,6978,,1,0,1,3
6979,6979,,1,0,1,4
6980,6980,,0,1,1,18
6981,6981,,0,1,1,4
6982,6982,,0,1,1,39
6983,6983,,0,1,1,32
6984,6984,,1,0,1,5
6985,6985,,1,0,1,0
6986,6986,,1,0,1,34
6987,6987,,0,1,1,5
6988,6988,,0,0,0,631
6989,6989,,0,1,1,343
6990,6990,,0,1,1,33
6991,6991,,0,1,1,632
6992,6992,,1,0,1,4
6993,6993,,1,0,1,4
6994,6994,,1,0,1,9
6995,6995,,1,0,1,94
6996,6996,,0,1,1,147
6997,6997,,1,0,1,633
6998,6998,,0,0,0,634
6999,6999,,1,0,1,32
7000,7000,,0,0,0,635
7001,7001,,1,0,1,14
7002,7002,,0,1,1,7
7003,7003,,0,0,0,636
7004,7004,,1,0,1,4
7005,7005,,1,0,1,4
7006,7006,,0,0,0,637
7007,7007,,0,0,0,638
7008,7008,,0,1,1,16
7009,7009,,1,0,1,639
7010,7010,,1,0,1,82
7011,7011,,0,1,1,33
7012,7012,,1,0,1,77
7013,7013,,1,0,1,3
7014,7014,,0,0,0,640
7015,7015,,1,0,1,4
7016,7016,,0,1,1,3
7017,7017,,1,0,1,14
7018,7018,,0,0,0,641
7019,7019,,1,0,1,19
7020,7020,,0,1,1,16
7021,7021,,0,1,1,4
7022,7022,,1,0,1,82
7023,7023,,0,1,1,642
7024,7024,,1,0,1,22
7025,7025,,1,0,1,78
7026,7026,,0,1,1,4
7027,7027,,1,0,1,8
7028,7028,,1,0,1,33
7029,7029,,1,0,1,105
7030,7030,,0,0,0,643
7031,7031,,0,1,1,14
7032,7032,,1,0,1,4
7033,7033,,1,0,1,4
7034,7034,,1,0,1,3
7035,7035,,0,1,1,24
7036,7036,,1,0,1,3
7037,7037,,0,1,1,644
7038,7038,,0,0,0,645
7039,7039,,1,0,1,22
7040,7040,,0,1,1,3
7041,7041,,0,1,1,5
7042,7042,,0,0,0,646
7043,7043,,0,1,1,8
7044,7044,,0,0,0,647
7045,7045,,0,1,1,16
7046,7046,,1,0,1,4
7047,7047,,1,0,1,4
7048,7048,,0,0,0,648
7049,7049,,1,0,1,33
7050,7050,,1,0,1,32
7051,7051,,0,1,1,78
7052,7052,,0,1,1,8
7053,7053,,0,1,1,9
7054,7054,,0,0,0,649
7055,7055,,0,1,1,16
7056,7056,,0,1,1,16
7057,7057,,0,1,1,5
7058,7058,,0,1,1,19
7059,7059,,1,0,1,8
7060,7060,,0,0,0,650
7061,7061,,0,1,1,105
7062,7062,,0,0,0,651
7063,7063,,0,1,1,652
7064,7064,,1,0,1,33
7065,7065,,1,0,1,33
7066,7066,,0,1,1,19
7067,7067,,0,1,1,18
7068,7068,,0,1,1,1
7069,7069,,1,0,1,94
7070,7070,,0,1,1,94
7071,7071,,0,1,1,4
7072,7072,,0,1,1,16
7073,7073,,0,1,1,5
7074,7074,,1,0,1,57
7075,7075,,1,0,1,32
7076,7076,,1,0,1,7
7077,7077,,0,0,0,653
7078,7078,,0,1,1,8
7079,7079,,1,0,1,1
7080,7080,,1,0,1,7
7081,7081,,1,0,1,3
7082,7082,,1,0,1,16
7083,7083,,1,0,1,4
7084,7084,,0,1,1,9
7085,7085,,0,1,1,94
7086,7086,,0,1,1,3
7087,7087,,1,0,1,3
7088,7088,,0,1,1,16
7089,7089,,0,0,0,654
7090,7090,,0,1,1,4
7091,7091,,1,0,1,3
7092,7092,,0,0,0,655
7093,7093,,0,1,1,4
7094,7094,,1,0,1,8
7095,7095,,1,0,1,19
7096,7096,,1,0,1,4
7097,7097,,1,0,1,1
7098,7098,,1,0,1,33
7099,7099,,0,0,0,656
7100,7100,,1,0,1,94
7101,7101,,1,0,1,7
7102,7102,,0,0,0,657
7103,7103,,1,0,1,658
7104,7104,,0,0,0,659
7105,7105,,0,1,1,3
7106,7106,,1,0,1,3
7107,7107,,0,0,0,660
7108,7108,,1,0,1,4
7109,7109,,1,0,1,3
7110,7110,,0,1,1,39
7111,7111,,0,1,1,4
7112,7112,,1,0,1,78
7113,7113,,0,0,0,661
7114,7114,,0,1,1,27
7115,7115,,0,0,0,662
7116,7116,,0,0,0,663
7117,7117,,0,1,1,105
7118,7118,,1,0,1,307
7119,7119,,1,0,1,3
7120,7120,,0,0,0,664
7121,7121,,0,1,1,5
7122,7122,,0,1,1,33
7123,7123,,1,0,1,16
7124,7124,,0,1,1,94
7125,7125,,0,1,1,18
7126,7126,,0,1,1,359
7127,7127,,1,0,1,77
