Id,Label,timeset,modularity_class,indegree,outdegree,degree
0,0,,46,0,111,111
1,1,,46,102,212,314
2,2,,46,0,276,276
3,3,,46,16,0,16
4,4,,46,0,257,257
5,5,,46,242,0,242
6,6,,1214,19,24,43
7,7,,1214,24,0,24
8,8,,0,0,0,0
9,9,,1,0,0,0
10,10,,2,0,0,0
11,11,,3,0,0,0
12,12,,61,0,383,383
13,13,,61,106,0,106
14,14,,61,268,0,268
15,15,,46,0,302,302
16,16,,46,242,0,242
17,17,,46,0,423,423
18,18,,46,256,0,256
19,19,,261,0,227,227
20,20,,261,51,0,51
21,21,,4,0,1266,1266
22,22,,4,422,0,422
23,23,,4,422,0,422
24,24,,4,422,0,422
25,25,,46,291,1287,1578
26,26,,46,283,0,283
27,27,,61,228,0,228
28,28,,46,3154,218,3372
29,29,,46,4449,0,4449
30,30,,46,5785,0,5785
31,31,,5,0,0,0
32,32,,6,211,0,211
33,33,,46,288,0,288
34,34,,7,0,0,0
35,35,,8,0,0,0
36,36,,9,0,0,0
37,37,,10,0,0,0
38,38,,11,0,0,0
39,39,,12,0,0,0
40,40,,261,16,210,226
41,41,,261,12,0,12
42,42,,29,0,1266,1266
43,43,,29,422,0,422
44,44,,46,4,712,716
45,45,,46,142,0,142
46,46,,46,864,0,864
47,47,,46,0,354,354
48,48,,46,98,0,98
49,49,,46,12,0,12
50,50,,13,0,138,138
51,51,,13,138,0,138
52,52,,14,0,0,0
53,53,,15,0,422,422
54,54,,15,1055,0,1055
55,55,,46,0,405,405
56,56,,16,0,0,0
57,57,,17,0,0,0
58,58,,46,77,0,77
59,59,,46,187,0,187
60,60,,18,0,278,278
61,61,,18,278,0,278
62,62,,19,0,422,422
63,63,,19,1055,0,1055
64,64,,21,0,138,138
65,65,,20,0,0,0
66,66,,21,138,0,138
67,67,,22,0,422,422
68,68,,22,1055,0,1055
69,69,,61,10,428,438
70,70,,61,106,0,106
71,71,,23,0,0,0
72,72,,61,284,0,284
73,73,,61,8,0,8
74,74,,61,112,0,112
75,75,,24,0,422,422
76,76,,24,422,0,422
77,77,,46,0,425,425
78,78,,46,276,0,276
79,79,,46,0,278,278
80,80,,25,0,0,0
81,81,,46,138,0,138
82,82,,46,69,0,69
83,83,,46,0,464,464
84,84,,46,225,0,225
85,85,,1203,0,212,212
86,86,,26,0,0,0
87,87,,27,0,0,0
88,88,,46,0,632,632
89,89,,46,122,0,122
90,90,,46,288,0,288
91,91,,46,124,0,124
92,92,,121,0,228,228
93,93,,121,179,0,179
94,94,,115,0,422,422
95,95,,115,1103,0,1103
96,96,,28,0,422,422
97,97,,28,422,0,422
98,98,,46,0,283,283
99,99,,46,633,0,633
100,100,,46,0,365,365
101,101,,46,118,0,118
102,102,,29,422,0,422
103,103,,29,422,0,422
104,104,,61,0,425,425
105,105,,30,0,0,0
106,106,,61,83,0,83
107,107,,61,284,0,284
108,108,,31,0,0,0
109,109,,32,0,248,248
110,110,,32,248,0,248
111,111,,33,0,0,0
112,112,,34,0,0,0
113,113,,46,0,342,342
114,114,,1203,378,213,591
115,115,,1203,1560,682,2242
116,116,,1203,2438,0,2438
117,117,,1203,394,0,394
118,118,,61,0,68,68
119,119,,61,251,0,251
120,120,,61,165,0,165
121,121,,174,0,208,208
122,122,,174,10629,0,10629
123,123,,174,14108,0,14108
124,124,,162,0,209,209
125,125,,162,13760,0,13760
126,126,,162,3696,0,3696
127,127,,162,0,159,159
128,128,,174,0,208,208
129,129,,174,22080,0,22080
130,130,,35,0,211,211
131,131,,35,422,0,422
132,132,,174,0,212,212
133,133,,162,0,209,209
134,134,,162,0,209,209
135,135,,158,1554,2156,3710
136,136,,36,0,0,0
137,137,,158,844,0,844
138,138,,162,0,420,420
139,139,,162,0,209,209
140,140,,174,0,208,208
141,141,,174,0,208,208
142,142,,46,0,206,206
143,143,,46,10,0,10
144,144,,174,0,212,212
145,145,,174,0,208,208
146,146,,174,0,208,208
147,147,,38,0,208,208
148,148,,38,19735,0,19735
149,149,,162,0,334,334
150,150,,174,0,208,208
151,151,,174,0,208,208
152,152,,174,0,208,208
153,153,,162,0,209,209
154,154,,37,0,211,211
155,155,,37,2743,0,2743
156,156,,174,0,208,208
157,157,,174,0,208,208
158,158,,38,0,208,208
159,159,,38,841,0,841
160,160,,162,126,82,208
161,161,,38,0,208,208
162,162,,38,203,0,203
163,163,,38,2488,0,2488
164,164,,991,0,422,422
165,165,,991,422,0,422
166,166,,39,0,0,0
167,167,,38,0,208,208
168,168,,38,0,208,208
169,169,,1602,271,419,690
170,170,,1602,1381,0,1381
171,171,,1602,626,0,626
172,172,,1602,256,242,498
173,173,,1602,726,0,726
174,174,,40,0,0,0
175,175,,41,0,0,0
176,176,,46,65,0,65
177,177,,174,0,208,208
178,178,,1203,3,316,319
179,179,,1203,318,0,318
180,180,,42,0,0,0
181,181,,43,0,0,0
182,182,,174,0,208,208
183,183,,99,0,633,633
184,184,,99,1266,0,1266
185,185,,174,0,208,208
186,186,,79,0,211,211
187,187,,44,0,0,0
188,188,,261,0,211,211
189,189,,261,2663,0,2663
190,190,,45,0,0,0
191,191,,46,0,357,357
192,192,,46,0,211,211
193,193,,180,211,0,211
194,194,,38,0,208,208
195,195,,261,0,211,211
196,196,,261,0,211,211
197,197,,261,0,211,211
198,198,,261,0,211,211
199,199,,261,0,211,211
200,200,,47,0,211,211
201,201,,47,422,0,422
202,202,,48,0,0,0
203,203,,174,0,208,208
204,204,,174,0,208,208
205,205,,46,0,635,635
206,206,,46,0,211,211
207,207,,46,633,0,633
208,208,,49,0,0,0
209,209,,38,0,208,208
210,210,,38,1488,0,1488
211,211,,261,0,211,211
212,212,,261,0,211,211
213,213,,261,0,211,211
214,214,,162,0,159,159
215,215,,261,0,211,211
216,216,,38,0,208,208
217,217,,38,0,208,208
218,218,,162,0,209,209
219,219,,991,0,211,211
220,220,,50,0,0,0
221,221,,82,0,211,211
222,222,,82,844,0,844
223,223,,51,0,0,0
224,224,,174,0,208,208
225,225,,52,0,12,12
226,226,,52,20,0,20
227,227,,174,0,208,208
228,228,,261,0,297,297
229,229,,261,255,212,467
230,230,,1203,3,3,6
231,231,,174,0,208,208
232,232,,19,0,211,211
233,233,,53,0,0,0
234,234,,15,0,211,211
235,235,,38,0,208,208
236,236,,54,0,46,46
237,237,,54,86,0,86
238,238,,82,0,211,211
239,239,,55,0,0,0
240,240,,174,0,208,208
241,241,,38,638,0,638
242,242,,99,0,633,633
243,243,,99,1055,0,1055
244,244,,56,0,212,212
245,245,,56,218,0,218
246,246,,162,0,127,127
247,247,,57,0,0,0
248,248,,174,0,208,208
249,249,,38,0,208,208
250,250,,38,0,208,208
251,251,,162,0,209,209
252,252,,174,0,208,208
253,253,,46,0,216,216
254,254,,38,0,208,208
255,255,,38,0,208,208
256,256,,76,0,211,211
257,257,,58,0,0,0
258,258,,1602,0,90,90
259,259,,1602,473,0,473
260,260,,261,0,211,211
261,261,,46,0,21,21
262,262,,46,21,0,21
263,263,,46,22,0,22
264,264,,991,0,211,211
265,265,,162,0,209,209
266,266,,38,0,208,208
267,267,,46,0,118,118
268,268,,46,48,37,85
269,269,,162,0,209,209
270,270,,174,0,208,208
271,271,,61,0,72,72
272,272,,61,68,0,68
273,273,,162,0,209,209
274,274,,59,0,211,211
275,275,,59,633,0,633
276,276,,46,49,0,49
277,277,,162,0,209,209
278,278,,115,211,0,211
279,279,,162,0,420,420
280,280,,158,0,479,479
281,281,,158,222,0,222
282,282,,158,328,211,539
283,283,,158,323,0,323
284,284,,261,0,370,370
285,285,,261,60,0,60
286,286,,149,0,211,211
287,287,,60,0,0,0
288,288,,19,0,211,211
289,289,,76,0,211,211
290,290,,52,0,9,9
291,291,,52,16,0,16
292,292,,61,0,211,211
293,293,,62,0,211,211
294,294,,62,1055,0,1055
295,295,,63,0,0,0
296,296,,99,0,633,633
297,297,,162,126,82,208
298,298,,46,0,42,42
299,299,,46,92,0,92
300,300,,64,0,211,211
301,301,,64,422,0,422
302,302,,65,0,0,0
303,303,,261,0,211,211
304,304,,66,0,0,0
305,305,,38,0,208,208
306,306,,136,0,422,422
307,307,,67,0,0,0
308,308,,991,0,422,422
309,309,,1012,0,152,152
310,310,,1012,20,211,231
311,311,,38,0,229,229
312,312,,38,200,0,200
313,313,,38,0,208,208
314,314,,68,0,0,0
315,315,,174,0,208,208
316,316,,1502,0,212,212
317,317,,1502,372,0,372
318,318,,1602,0,211,211
319,319,,1602,1055,0,1055
320,320,,46,130,0,130
321,321,,46,0,141,141
322,322,,46,9,0,9
323,323,,46,267,0,267
324,324,,69,0,130,130
325,325,,69,182,0,182
326,326,,69,4,0,4
327,327,,69,74,0,74
328,328,,172,0,211,211
329,329,,70,0,0,0
330,330,,71,0,211,211
331,331,,71,422,0,422
332,332,,46,26,0,26
333,333,,62,0,211,211
334,334,,72,0,0,0
335,335,,37,24,211,235
336,336,,73,0,0,0
337,337,,74,0,211,211
338,338,,74,422,0,422
339,339,,99,0,633,633
340,340,,1602,0,57,57
341,341,,1602,195,0,195
342,342,,174,0,208,208
343,343,,75,0,0,0
344,344,,174,0,208,208
345,345,,174,0,208,208
346,346,,76,0,211,211
347,347,,76,844,0,844
348,348,,99,211,633,844
349,349,,99,633,633,1266
350,350,,38,0,208,208
351,351,,174,0,208,208
352,352,,991,0,422,422
353,353,,991,844,0,844
354,354,,162,0,209,209
355,355,,82,0,211,211
356,356,,174,0,208,208
357,357,,77,0,0,0
358,358,,46,66,61,127
359,359,,162,0,159,159
360,360,,78,0,211,211
361,361,,78,633,0,633
362,362,,79,211,0,211
363,363,,46,0,72,72
364,364,,46,60,122,182
365,365,,99,0,633,633
366,366,,99,422,0,422
367,367,,174,0,208,208
368,368,,80,0,211,211
369,369,,80,1688,0,1688
370,370,,81,0,0,0
371,371,,80,0,211,211
372,372,,80,0,211,211
373,373,,80,0,211,211
374,374,,80,0,211,211
375,375,,80,0,211,211
376,376,,80,0,211,211
377,377,,162,126,82,208
378,378,,82,0,211,211
379,379,,82,633,0,633
380,380,,46,0,283,283
381,381,,1602,8,283,291
382,382,,83,0,211,211
383,383,,83,422,0,422
384,384,,84,0,0,0
385,385,,38,0,208,208
386,386,,38,0,208,208
387,387,,69,0,175,175
388,388,,69,45,0,45
389,389,,174,0,208,208
390,390,,38,0,102,102
391,391,,174,0,208,208
392,392,,38,0,208,208
393,393,,174,0,208,208
394,394,,38,0,208,208
395,395,,174,0,208,208
396,396,,46,5,362,367
397,397,,46,163,0,163
398,398,,38,0,208,208
399,399,,1602,42,261,303
400,400,,1602,504,249,753
401,401,,1602,5,0,5
402,402,,1602,384,0,384
403,403,,1602,3,0,3
404,404,,1602,9,0,9
405,405,,1602,1227,0,1227
406,406,,61,0,160,160
407,407,,61,40,0,40
408,408,,61,257,0,257
409,409,,162,126,82,208
410,410,,85,0,211,211
411,411,,85,3587,0,3587
412,412,,38,0,208,208
413,413,,176,0,56,56
414,414,,176,47,0,47
415,415,,261,0,211,211
416,416,,261,3376,0,3376
417,417,,1602,0,211,211
418,418,,86,0,211,211
419,419,,86,1477,0,1477
420,420,,87,0,0,0
421,421,,46,0,140,140
422,422,,46,68,0,68
423,423,,127,0,211,211
424,424,,1602,0,422,422
425,425,,1602,0,211,211
426,426,,88,0,211,211
427,427,,88,633,0,633
428,428,,1602,0,360,360
429,429,,89,0,0,0
430,430,,38,0,208,208
431,431,,261,0,211,211
432,432,,38,0,208,208
433,433,,38,290,0,290
434,434,,174,0,208,208
435,435,,162,126,82,208
436,436,,90,0,68,68
437,437,,90,68,0,68
438,438,,158,204,204,408
439,439,,91,0,144,144
440,440,,91,144,0,144
441,441,,99,0,633,633
442,442,,92,0,0,0
443,443,,261,0,211,211
444,444,,1602,356,1544,1900
445,445,,1602,5,0,5
446,446,,1602,42,206,248
447,447,,162,0,294,294
448,448,,46,40,37,77
449,449,,46,37,0,37
450,450,,38,0,208,208
451,451,,99,0,633,633
452,452,,155,0,35,35
453,453,,155,12,0,12
454,454,,155,235,0,235
455,455,,162,0,294,294
456,456,,162,0,209,209
457,457,,162,0,209,209
458,458,,162,0,420,420
459,459,,162,0,209,209
460,460,,162,0,209,209
461,461,,162,0,209,209
462,462,,162,0,209,209
463,463,,162,0,209,209
464,464,,162,0,209,209
465,465,,162,0,209,209
466,466,,162,0,209,209
467,467,,162,0,209,209
468,468,,162,0,209,209
469,469,,162,0,209,209
470,470,,162,0,209,209
471,471,,93,0,0,0
472,472,,38,0,208,208
473,473,,261,0,462,462
474,474,,38,0,208,208
475,475,,38,0,208,208
476,476,,38,0,208,208
477,477,,174,0,208,208
478,478,,1602,323,372,695
479,479,,1602,285,0,285
480,480,,46,0,283,283
481,481,,46,101,0,101
482,482,,96,0,211,211
483,483,,94,0,0,0
484,484,,38,0,208,208
485,485,,38,0,208,208
486,486,,99,0,633,633
487,487,,99,2321,0,2321
488,488,,46,0,307,307
489,489,,162,126,82,208
490,490,,99,0,633,633
491,491,,99,844,0,844
492,492,,1012,0,422,422
493,493,,1012,422,0,422
494,494,,46,0,212,212
495,495,,142,0,211,211
496,496,,95,0,0,0
497,497,,96,633,0,633
498,498,,97,0,211,211
499,499,,97,422,0,422
500,500,,38,0,208,208
501,501,,99,211,422,633
502,502,,99,844,1055,1899
503,503,,98,0,0,0
504,504,,38,0,208,208
505,505,,38,0,208,208
506,506,,99,0,633,633
507,507,,99,2743,0,2743
508,508,,99,0,633,633
509,509,,46,8,482,490
510,510,,46,150,0,150
511,511,,46,98,0,98
512,512,,99,0,633,633
513,513,,118,0,211,211
514,514,,99,0,633,633
515,515,,100,0,0,0
516,516,,115,0,211,211
517,517,,101,0,211,211
518,518,,152,422,0,422
519,519,,101,422,0,422
520,520,,15,0,211,211
521,521,,88,0,211,211
522,522,,105,211,0,211
523,523,,99,0,633,633
524,524,,102,0,0,0
525,525,,991,0,211,211
526,526,,103,0,0,0
527,527,,165,0,211,211
528,528,,165,4642,0,4642
529,529,,104,0,0,0
530,530,,105,0,211,211
531,531,,106,0,0,0
532,532,,99,0,633,633
533,533,,107,0,0,0
534,534,,158,211,422,633
535,535,,158,1055,0,1055
536,536,,99,0,633,633
537,537,,108,0,0,0
538,538,,110,0,211,211
539,539,,109,0,0,0
540,540,,110,1266,0,1266
541,541,,158,0,490,490
542,542,,158,89,211,300
543,543,,158,89,0,89
544,544,,46,0,60,60
545,545,,46,61,0,61
546,546,,110,0,211,211
547,547,,110,0,211,211
548,548,,110,0,211,211
549,549,,110,0,211,211
550,550,,46,30,0,30
551,551,,46,10,0,10
552,552,,111,0,0,0
553,553,,112,0,0,0
554,554,,99,0,633,633
555,555,,99,0,633,633
556,556,,113,0,0,0
557,557,,114,0,181,181
558,558,,114,6,0,6
559,559,,114,86,0,86
560,560,,114,270,0,270
561,561,,115,0,422,422
562,562,,116,0,211,211
563,563,,116,422,0,422
564,564,,117,0,211,211
565,565,,117,422,0,422
566,566,,99,0,633,633
567,567,,162,126,82,208
568,568,,162,126,82,208
569,569,,78,0,211,211
570,570,,162,126,82,208
571,571,,162,126,82,208
572,572,,118,211,0,211
573,573,,1007,0,336,336
574,574,,1007,132,0,132
575,575,,174,0,208,208
576,576,,119,0,67,67
577,577,,119,67,0,67
578,578,,46,11,212,223
579,579,,46,0,365,365
580,580,,46,24,0,24
581,581,,120,0,211,211
582,582,,120,422,0,422
583,583,,1602,0,252,252
584,584,,1602,113,152,265
585,585,,121,7,53,60
586,586,,121,55,0,55
587,587,,162,0,209,209
588,588,,46,0,317,317
589,589,,46,216,0,216
590,590,,46,18,0,18
591,591,,46,166,0,166
592,592,,46,115,0,115
593,593,,991,0,211,211
594,594,,122,0,0,0
595,595,,162,0,209,209
596,596,,46,15,0,15
597,597,,1012,0,211,211
598,598,,46,50,212,262
599,599,,123,0,0,0
600,600,,1012,0,128,128
601,601,,124,0,0,0
602,602,,158,30,208,238
603,603,,176,26,0,26
604,604,,158,957,0,957
605,605,,56,0,100,100
606,606,,56,94,0,94
607,607,,46,0,140,140
608,608,,115,0,48,48
609,609,,86,0,211,211
610,610,,261,0,211,211
611,611,,97,0,211,211
612,612,,99,0,633,633
613,613,,261,0,211,211
614,614,,174,0,208,208
615,615,,120,0,211,211
616,616,,125,0,0,0
617,617,,170,211,0,211
618,618,,126,0,0,0
619,619,,99,0,633,633
620,620,,99,0,633,633
621,621,,174,0,208,208
622,622,,99,0,633,633
623,623,,99,211,633,844
624,624,,76,0,211,211
625,625,,261,93,0,93
626,626,,46,5,132,137
627,627,,46,10,0,10
628,628,,38,0,208,208
629,629,,46,133,213,346
630,630,,46,0,283,283
631,631,,46,85,0,85
632,632,,46,71,0,71
633,633,,62,0,211,211
634,634,,127,633,0,633
635,635,,62,0,211,211
636,636,,1602,478,875,1353
637,637,,99,0,633,633
638,638,,128,0,211,211
639,639,,128,422,0,422
640,640,,187,0,70,70
641,641,,129,0,0,0
642,642,,187,1897,0,1897
643,643,,162,0,209,209
644,644,,162,126,82,208
645,645,,162,126,82,208
646,646,,174,0,208,208
647,647,,162,0,209,209
648,648,,187,0,70,70
649,649,,187,0,70,70
650,650,,130,0,41,41
651,651,,130,41,0,41
652,652,,38,0,208,208
653,653,,64,0,211,211
654,654,,174,0,208,208
655,655,,86,0,211,211
656,656,,46,211,212,423
657,657,,38,0,208,208
658,658,,1602,0,212,212
659,659,,1602,0,280,280
660,660,,1602,256,0,256
661,661,,1602,60,0,60
662,662,,99,211,633,844
663,663,,99,422,422,844
664,664,,187,0,70,70
665,665,,187,0,70,70
666,666,,165,211,0,211
667,667,,187,0,70,70
668,668,,96,0,211,211
669,669,,96,0,211,211
670,670,,99,211,633,844
671,671,,131,0,0,0
672,672,,174,0,208,208
673,673,,38,0,287,287
674,674,,174,0,208,208
675,675,,46,179,782,961
676,676,,174,0,208,208
677,677,,38,0,208,208
678,678,,132,0,211,211
679,679,,132,4220,0,4220
680,680,,158,0,1283,1283
681,681,,133,0,0,0
682,682,,99,211,422,633
683,683,,99,0,633,633
684,684,,99,422,0,422
685,685,,158,0,211,211
686,686,,134,0,0,0
687,687,,158,1055,0,1055
688,688,,99,211,422,633
689,689,,99,0,633,633
690,690,,99,0,633,633
691,691,,174,0,208,208
692,692,,176,0,77,77
693,693,,176,66,0,66
694,694,,176,71,0,71
695,695,,135,0,0,0
696,696,,158,844,0,844
697,697,,158,0,211,211
698,698,,158,633,0,633
699,699,,174,0,208,208
700,700,,136,0,422,422
701,701,,136,633,0,633
702,702,,46,0,424,424
703,703,,158,0,211,211
704,704,,158,633,0,633
705,705,,158,0,211,211
706,706,,158,173,211,384
707,707,,137,0,0,0
708,708,,158,633,0,633
709,709,,80,10,211,221
710,710,,174,0,208,208
711,711,,46,0,212,212
712,712,,38,0,208,208
713,713,,52,0,12,12
714,714,,99,0,633,633
715,715,,162,126,82,208
716,716,,38,0,208,208
717,717,,1602,97,211,308
718,718,,1602,112,0,112
719,719,,132,0,211,211
720,720,,46,0,212,212
721,721,,174,0,208,208
722,722,,163,0,212,212
723,723,,163,130,0,130
724,724,,1602,22,50,72
725,725,,1602,7,0,7
726,726,,165,0,211,211
727,727,,82,0,422,422
728,728,,1602,67,278,345
729,729,,46,0,322,322
730,730,,46,75,0,75
731,731,,46,312,0,312
732,732,,138,0,0,0
733,733,,46,0,181,181
734,734,,46,9,517,526
735,735,,46,78,0,78
736,736,,46,14,0,14
737,737,,174,0,208,208
738,738,,174,0,208,208
739,739,,99,0,633,633
740,740,,46,0,211,211
741,741,,132,0,211,211
742,742,,46,0,202,202
743,743,,46,35,0,35
744,744,,38,0,208,208
745,745,,46,0,31,31
746,746,,139,0,0,0
747,747,,46,63,0,63
748,748,,46,61,0,61
749,749,,85,0,211,211
750,750,,140,0,0,0
751,751,,85,0,211,211
752,752,,99,211,633,844
753,753,,99,211,211,422
754,754,,162,0,209,209
755,755,,52,9,0,9
756,756,,165,0,211,211
757,757,,141,0,0,0
758,758,,46,0,47,47
759,759,,46,46,212,258
760,760,,99,0,633,633
761,761,,174,0,208,208
762,762,,46,0,62,62
763,763,,142,0,211,211
764,764,,142,1688,0,1688
765,765,,46,0,411,411
766,766,,46,252,0,252
767,767,,46,135,0,135
768,768,,52,0,12,12
769,769,,46,58,212,270
770,770,,162,0,209,209
771,771,,46,0,418,418
772,772,,46,108,0,108
773,773,,46,30,0,30
774,774,,46,18,0,18
775,775,,174,0,208,208
776,776,,1012,0,422,422
777,777,,1012,0,211,211
778,778,,1012,422,0,422
779,779,,115,0,211,211
780,780,,162,0,209,209
781,781,,38,0,208,208
782,782,,78,0,211,211
783,783,,174,0,208,208
784,784,,1502,0,372,372
785,785,,1502,212,39,251
786,786,,1012,0,126,126
787,787,,143,0,0,0
788,788,,1602,18,41,59
789,789,,1602,244,0,244
790,790,,88,0,211,211
791,791,,1602,18,20,38
792,792,,1602,18,66,84
793,793,,1602,0,115,115
794,794,,1602,0,112,112
795,795,,38,0,208,208
796,796,,46,0,271,271
797,797,,46,120,0,120
798,798,,46,0,78,78
799,799,,46,0,68,68
800,800,,261,0,211,211
801,801,,1012,0,72,72
802,802,,174,0,208,208
803,803,,174,0,208,208
804,804,,174,0,208,208
805,805,,174,0,208,208
806,806,,174,0,208,208
807,807,,38,0,208,208
808,808,,165,0,211,211
809,809,,46,77,0,77
810,810,,261,0,211,211
811,811,,261,0,211,211
812,812,,261,0,211,211
813,813,,38,0,208,208
814,814,,156,0,211,211
815,815,,144,0,0,0
816,816,,165,0,211,211
817,817,,38,0,208,208
818,818,,261,0,211,211
819,819,,46,0,212,212
820,820,,46,75,0,75
821,821,,46,374,0,374
822,822,,261,0,211,211
823,823,,38,0,208,208
824,824,,99,0,633,633
825,825,,174,0,208,208
826,826,,38,0,208,208
827,827,,1012,0,132,132
828,828,,145,0,0,0
829,829,,1012,0,72,72
830,830,,38,0,208,208
831,831,,261,0,211,211
832,832,,261,0,211,211
833,833,,46,0,62,62
834,834,,46,55,0,55
835,835,,132,0,211,211
836,836,,182,0,211,211
837,837,,182,399,0,399
838,838,,132,0,211,211
839,839,,132,0,211,211
840,840,,132,0,211,211
841,841,,132,0,211,211
842,842,,132,0,211,211
843,843,,132,0,211,211
844,844,,132,0,211,211
845,845,,46,29,212,241
846,846,,46,211,214,425
847,847,,132,0,211,211
848,848,,146,0,211,211
849,849,,146,211,0,211
850,850,,132,0,211,211
851,851,,132,0,211,211
852,852,,147,0,6,6
853,853,,147,6,0,6
854,854,,158,211,422,633
855,855,,132,0,211,211
856,856,,132,0,211,211
857,857,,1012,0,129,129
858,858,,132,0,211,211
859,859,,132,0,211,211
860,860,,132,0,211,211
861,861,,99,0,633,633
862,862,,148,0,0,0
863,863,,149,1688,0,1688
864,864,,150,0,211,211
865,865,,150,12238,0,12238
866,866,,151,0,0,0
867,867,,150,0,211,211
868,868,,150,0,211,211
869,869,,150,0,211,211
870,870,,150,0,211,211
871,871,,150,0,211,211
872,872,,150,0,211,211
873,873,,150,0,211,211
874,874,,150,0,211,211
875,875,,150,0,211,211
876,876,,162,126,82,208
877,877,,150,0,211,211
878,878,,150,0,211,211
879,879,,150,0,211,211
880,880,,150,0,211,211
881,881,,150,0,211,211
882,882,,150,0,211,211
883,883,,46,0,62,62
884,884,,1203,24,37,61
885,885,,46,136,0,136
886,886,,150,0,211,211
887,887,,150,0,211,211
888,888,,150,0,211,211
889,889,,150,0,211,211
890,890,,150,0,211,211
891,891,,150,0,211,211
892,892,,150,0,211,211
893,893,,150,0,211,211
894,894,,150,0,211,211
895,895,,150,0,211,211
896,896,,150,0,211,211
897,897,,150,0,211,211
898,898,,150,0,211,211
899,899,,82,0,211,211
900,900,,150,0,211,211
901,901,,150,0,211,211
902,902,,150,0,211,211
903,903,,150,0,211,211
904,904,,150,0,211,211
905,905,,150,0,211,211
906,906,,150,0,211,211
907,907,,182,0,211,211
908,908,,152,0,211,211
909,909,,38,0,208,208
910,910,,152,0,211,211
911,911,,46,36,10,46
912,912,,261,20,0,20
913,913,,153,0,211,211
914,914,,153,214,0,214
915,915,,46,0,79,79
916,916,,154,0,211,211
917,917,,154,844,0,844
918,918,,38,0,208,208
919,919,,46,0,195,195
920,920,,46,136,0,136
921,921,,46,130,266,396
922,922,,150,0,211,211
923,923,,150,0,211,211
924,924,,150,0,211,211
925,925,,150,0,211,211
926,926,,150,0,211,211
927,927,,150,0,211,211
928,928,,150,0,211,211
929,929,,150,0,211,211
930,930,,150,0,211,211
931,931,,150,0,211,211
932,932,,38,0,208,208
933,933,,150,0,211,211
934,934,,150,0,211,211
935,935,,150,0,211,211
936,936,,150,0,211,211
937,937,,150,0,211,211
938,938,,150,0,211,211
939,939,,150,0,211,211
940,940,,150,0,211,211
941,941,,150,0,211,211
942,942,,150,0,211,211
943,943,,150,0,211,211
944,944,,150,0,211,211
945,945,,59,0,211,211
946,946,,38,0,208,208
947,947,,38,0,943,943
948,948,,38,405,0,405
949,949,,38,0,208,208
950,950,,38,0,208,208
951,951,,38,0,208,208
952,952,,991,0,15,15
953,953,,175,15333,0,15333
954,954,,158,30,212,242
955,955,,46,0,68,68
956,956,,46,109,0,109
957,957,,162,0,213,213
958,958,,38,0,208,208
959,959,,38,0,148,148
960,960,,85,0,211,211
961,961,,38,0,208,208
962,962,,38,0,208,208
963,963,,38,0,208,208
964,964,,38,0,208,208
965,965,,38,0,208,208
966,966,,99,211,633,844
967,967,,162,126,82,208
968,968,,61,0,159,159
969,969,,1974,18,0,18
970,970,,182,445,0,445
971,971,,38,0,208,208
972,972,,174,0,208,208
973,973,,155,0,212,212
974,974,,174,0,208,208
975,975,,38,213,0,213
976,976,,38,0,208,208
977,977,,991,0,211,211
978,978,,127,0,211,211
979,979,,162,126,82,208
980,980,,154,0,211,211
981,981,,62,0,211,211
982,982,,38,0,208,208
983,983,,85,0,211,211
984,984,,38,0,208,208
985,985,,38,0,208,208
986,986,,99,0,633,633
987,987,,38,0,208,208
988,988,,1602,0,221,221
989,989,,1602,10,0,10
990,990,,46,0,252,252
991,991,,46,249,0,249
992,992,,174,0,333,333
993,993,,174,0,208,208
994,994,,46,0,212,212
995,995,,38,0,208,208
996,996,,174,0,208,208
997,997,,174,0,208,208
998,998,,38,0,208,208
999,999,,174,0,208,208
1000,1000,,156,0,211,211
1001,1001,,156,2110,0,2110
1002,1002,,38,0,208,208
1003,1003,,46,0,77,77
1004,1004,,46,33,0,33
1005,1005,,46,11,0,11
1006,1006,,99,0,633,633
1007,1007,,157,0,0,0
1008,1008,,46,2,0,2
1009,1009,,162,0,334,334
1010,1010,,187,0,211,211
1011,1011,,174,0,208,208
1012,1012,,46,0,46,46
1013,1013,,158,30,208,238
1014,1014,,158,30,208,238
1015,1015,,38,0,208,208
1016,1016,,162,0,209,209
1017,1017,,149,0,211,211
1018,1018,,149,0,211,211
1019,1019,,149,0,211,211
1020,1020,,149,0,211,211
1021,1021,,149,0,211,211
1022,1022,,149,0,211,211
1023,1023,,149,0,211,211
1024,1024,,174,0,208,208
1025,1025,,46,0,212,212
1026,1026,,158,0,211,211
1027,1027,,158,844,0,844
1028,1028,,159,0,0,0
1029,1029,,158,633,0,633
1030,1030,,158,0,211,211
1031,1031,,158,633,0,633
1032,1032,,165,0,211,211
1033,1033,,158,173,211,384
1034,1034,,160,0,0,0
1035,1035,,158,633,0,633
1036,1036,,158,0,211,211
1037,1037,,158,0,211,211
1038,1038,,38,0,208,208
1039,1039,,158,0,211,211
1040,1040,,161,0,0,0
1041,1041,,158,633,0,633
1042,1042,,162,0,2983,2983
1043,1043,,162,0,209,209
1044,1044,,162,0,209,209
1045,1045,,162,0,209,209
1046,1046,,38,0,208,208
1047,1047,,38,0,208,208
1048,1048,,38,0,208,208
1049,1049,,38,0,208,208
1050,1050,,162,126,82,208
1051,1051,,162,126,82,208
1052,1052,,165,0,211,211
1053,1053,,165,0,211,211
1054,1054,,174,0,208,208
1055,1055,,174,0,208,208
1056,1056,,187,0,211,211
1057,1057,,46,0,109,109
1058,1058,,165,0,211,211
1059,1059,,187,0,211,211
1060,1060,,165,0,211,211
1061,1061,,187,0,211,211
1062,1062,,165,0,211,211
1063,1063,,187,0,211,211
1064,1064,,165,0,211,211
1065,1065,,165,0,211,211
1066,1066,,99,0,633,633
1067,1067,,38,0,208,208
1068,1068,,110,0,211,211
1069,1069,,165,0,211,211
1070,1070,,85,0,211,211
1071,1071,,163,0,212,212
1072,1072,,163,294,0,294
1073,1073,,165,0,211,211
1074,1074,,142,0,211,211
1075,1075,,991,0,422,422
1076,1076,,991,422,0,422
1077,1077,,164,0,0,0
1078,1078,,174,0,208,208
1079,1079,,99,0,633,633
1080,1080,,174,0,208,208
1081,1081,,158,145,419,564
1082,1082,,165,0,211,211
1083,1083,,174,0,208,208
1084,1084,,261,0,8,8
1085,1085,,261,16,0,16
1086,1086,,61,0,72,72
1087,1087,,61,63,0,63
1088,1088,,61,6,0,6
1089,1089,,165,0,422,422
1090,1090,,99,0,633,633
1091,1091,,121,47,0,47
1092,1092,,165,0,211,211
1093,1093,,46,256,0,256
1094,1094,,162,0,424,424
1095,1095,,165,0,211,211
1096,1096,,136,0,422,422
1097,1097,,166,0,0,0
1098,1098,,165,0,211,211
1099,1099,,38,0,208,208
1100,1100,,46,0,268,268
1101,1101,,156,0,211,211
1102,1102,,38,0,208,208
1103,1103,,165,0,211,211
1104,1104,,156,0,211,211
1105,1105,,156,0,211,211
1106,1106,,156,0,211,211
1107,1107,,156,0,211,211
1108,1108,,156,0,211,211
1109,1109,,156,0,211,211
1110,1110,,46,0,212,212
1111,1111,,167,0,211,211
1112,1112,,167,422,0,422
1113,1113,,168,0,0,0
1114,1114,,167,0,211,211
1115,1115,,169,0,158,158
1116,1116,,169,158,0,158
1117,1117,,38,0,208,208
1118,1118,,165,0,211,211
1119,1119,,187,0,211,211
1120,1120,,170,0,211,211
1121,1121,,54,0,46,46
1122,1122,,171,0,0,0
1123,1123,,54,6,0,6
1124,1124,,172,0,211,211
1125,1125,,172,633,0,633
1126,1126,,38,0,208,208
1127,1127,,46,0,263,263
1128,1128,,127,0,211,211
1129,1129,,99,0,633,633
1130,1130,,162,0,209,209
1131,1131,,173,0,140,140
1132,1132,,173,140,0,140
1133,1133,,46,0,432,432
1134,1134,,46,18,0,18
1135,1135,,117,0,211,211
1136,1136,,74,0,211,211
1137,1137,,46,0,66,66
1138,1138,,162,0,209,209
1139,1139,,46,0,67,67
1140,1140,,38,0,208,208
1141,1141,,175,0,209,209
1142,1142,,175,6106,0,6106
1143,1143,,175,0,420,420
1144,1144,,46,169,0,169
1145,1145,,175,0,209,209
1146,1146,,175,0,209,209
1147,1147,,175,0,209,209
1148,1148,,175,0,209,209
1149,1149,,175,0,209,209
1150,1150,,175,0,209,209
1151,1151,,175,0,209,209
1152,1152,,175,0,209,209
1153,1153,,175,0,209,209
1154,1154,,175,0,209,209
1155,1155,,175,0,209,209
1156,1156,,175,0,209,209
1157,1157,,175,0,209,209
1158,1158,,175,0,209,209
1159,1159,,175,0,285,285
1160,1160,,175,0,285,285
1161,1161,,175,410,0,410
1162,1162,,175,0,209,209
1163,1163,,175,0,209,209
1164,1164,,175,0,209,209
1165,1165,,175,0,294,294
1166,1166,,175,0,209,209
1167,1167,,175,0,209,209
1168,1168,,175,0,209,209
1169,1169,,175,0,209,209
1170,1170,,175,0,209,209
1171,1171,,175,0,420,420
1172,1172,,175,0,159,159
1173,1173,,175,0,420,420
1174,1174,,175,0,209,209
1175,1175,,175,0,209,209
1176,1176,,175,0,209,209
1177,1177,,175,0,285,285
1178,1178,,175,0,159,159
1179,1179,,175,0,209,209
1180,1180,,175,0,294,294
1181,1181,,175,0,209,209
1182,1182,,175,0,209,209
1183,1183,,175,0,209,209
1184,1184,,175,0,209,209
1185,1185,,175,0,209,209
1186,1186,,175,0,209,209
1187,1187,,175,0,209,209
1188,1188,,175,0,294,294
1189,1189,,175,0,209,209
1190,1190,,175,0,209,209
1191,1191,,175,0,285,285
1192,1192,,175,0,209,209
1193,1193,,175,0,209,209
1194,1194,,175,0,209,209
1195,1195,,175,0,294,294
1196,1196,,175,0,209,209
1197,1197,,175,0,209,209
1198,1198,,175,0,209,209
1199,1199,,175,0,294,294
1200,1200,,175,0,159,159
1201,1201,,175,0,209,209
1202,1202,,175,0,291,291
1203,1203,,175,0,285,285
1204,1204,,175,0,209,209
1205,1205,,175,0,209,209
1206,1206,,175,0,376,376
1207,1207,,175,0,294,294
1208,1208,,175,0,209,209
1209,1209,,174,0,209,209
1210,1210,,174,8217,0,8217
1211,1211,,174,0,209,209
1212,1212,,174,0,209,209
1213,1213,,174,0,285,285
1214,1214,,174,0,209,209
1215,1215,,175,0,209,209
1216,1216,,175,0,209,209
1217,1217,,175,0,209,209
1218,1218,,174,0,209,209
1219,1219,,174,0,209,209
1220,1220,,174,0,285,285
1221,1221,,174,0,294,294
1222,1222,,174,0,294,294
1223,1223,,174,0,294,294
1224,1224,,174,0,209,209
1225,1225,,174,0,213,213
1226,1226,,174,0,209,209
1227,1227,,174,0,209,209
1228,1228,,174,0,209,209
1229,1229,,174,0,209,209
1230,1230,,174,0,209,209
1231,1231,,174,0,209,209
1232,1232,,174,0,209,209
1233,1233,,174,0,209,209
1234,1234,,174,0,209,209
1235,1235,,174,0,209,209
1236,1236,,174,0,209,209
1237,1237,,174,0,209,209
1238,1238,,174,0,294,294
1239,1239,,174,0,209,209
1240,1240,,174,0,209,209
1241,1241,,174,0,209,209
1242,1242,,175,0,209,209
1243,1243,,175,0,209,209
1244,1244,,174,0,294,294
1245,1245,,174,0,209,209
1246,1246,,174,0,209,209
1247,1247,,174,0,209,209
1248,1248,,174,0,209,209
1249,1249,,174,0,209,209
1250,1250,,174,0,209,209
1251,1251,,174,0,209,209
1252,1252,,174,0,159,159
1253,1253,,174,0,209,209
1254,1254,,174,0,209,209
1255,1255,,174,0,209,209
1256,1256,,174,0,334,334
1257,1257,,174,0,209,209
1258,1258,,174,0,209,209
1259,1259,,174,0,209,209
1260,1260,,174,0,209,209
1261,1261,,174,0,209,209
1262,1262,,174,0,209,209
1263,1263,,174,0,209,209
1264,1264,,174,0,209,209
1265,1265,,174,0,294,294
1266,1266,,174,0,159,159
1267,1267,,174,0,209,209
1268,1268,,174,0,209,209
1269,1269,,174,0,209,209
1270,1270,,174,0,209,209
1271,1271,,174,0,209,209
1272,1272,,174,0,209,209
1273,1273,,174,0,209,209
1274,1274,,174,0,209,209
1275,1275,,174,0,209,209
1276,1276,,174,0,159,159
1277,1277,,174,0,209,209
1278,1278,,174,0,285,285
1279,1279,,174,0,209,209
1280,1280,,174,0,285,285
1281,1281,,174,0,209,209
1282,1282,,174,0,209,209
1283,1283,,174,0,209,209
1284,1284,,174,0,209,209
1285,1285,,174,0,209,209
1286,1286,,174,0,209,209
1287,1287,,174,0,209,209
1288,1288,,174,0,294,294
1289,1289,,174,0,209,209
1290,1290,,174,0,209,209
1291,1291,,174,0,209,209
1292,1292,,174,0,209,209
1293,1293,,174,0,209,209
1294,1294,,174,0,209,209
1295,1295,,174,0,159,159
1296,1296,,174,0,209,209
1297,1297,,174,0,209,209
1298,1298,,174,0,294,294
1299,1299,,174,0,209,209
1300,1300,,174,0,159,159
1301,1301,,174,0,159,159
1302,1302,,174,0,209,209
1303,1303,,174,0,209,209
1304,1304,,85,0,211,211
1305,1305,,174,0,159,159
1306,1306,,174,0,209,209
1307,1307,,174,0,209,209
1308,1308,,174,0,209,209
1309,1309,,174,0,209,209
1310,1310,,174,0,209,209
1311,1311,,174,0,209,209
1312,1312,,174,0,209,209
1313,1313,,174,0,209,209
1314,1314,,174,0,209,209
1315,1315,,174,0,209,209
1316,1316,,174,0,209,209
1317,1317,,174,0,209,209
1318,1318,,174,0,209,209
1319,1319,,174,0,159,159
1320,1320,,174,0,209,209
1321,1321,,174,0,209,209
1322,1322,,174,0,209,209
1323,1323,,174,0,209,209
1324,1324,,174,0,209,209
1325,1325,,174,0,209,209
1326,1326,,174,0,209,209
1327,1327,,174,0,159,159
1328,1328,,174,0,209,209
1329,1329,,174,0,159,159
1330,1330,,174,0,209,209
1331,1331,,174,0,209,209
1332,1332,,174,0,209,209
1333,1333,,174,0,285,285
1334,1334,,174,0,209,209
1335,1335,,174,0,209,209
1336,1336,,174,0,209,209
1337,1337,,174,0,285,285
1338,1338,,174,0,209,209
1339,1339,,174,0,209,209
1340,1340,,174,0,209,209
1341,1341,,175,0,285,285
1342,1342,,175,0,209,209
1343,1343,,174,0,209,209
1344,1344,,174,0,209,209
1345,1345,,175,0,209,209
1346,1346,,175,0,209,209
1347,1347,,175,0,209,209
1348,1348,,175,0,209,209
1349,1349,,174,0,209,209
1350,1350,,174,0,209,209
1351,1351,,174,0,294,294
1352,1352,,175,0,209,209
1353,1353,,174,0,209,209
1354,1354,,175,0,376,376
1355,1355,,175,0,209,209
1356,1356,,175,0,209,209
1357,1357,,175,0,209,209
1358,1358,,175,0,209,209
1359,1359,,174,0,209,209
1360,1360,,175,0,209,209
1361,1361,,175,0,209,209
1362,1362,,175,0,209,209
1363,1363,,61,68,207,275
1364,1364,,176,0,77,77
1365,1365,,174,0,209,209
1366,1366,,175,0,294,294
1367,1367,,175,0,209,209
1368,1368,,175,0,209,209
1369,1369,,174,0,209,209
1370,1370,,174,0,209,209
1371,1371,,174,0,209,209
1372,1372,,175,0,209,209
1373,1373,,175,0,209,209
1374,1374,,175,0,209,209
1375,1375,,175,0,209,209
1376,1376,,175,0,294,294
1377,1377,,175,0,209,209
1378,1378,,175,0,209,209
1379,1379,,175,0,209,209
1380,1380,,175,0,291,291
1381,1381,,175,0,209,209
1382,1382,,175,0,209,209
1383,1383,,174,0,294,294
1384,1384,,174,0,285,285
1385,1385,,174,0,209,209
1386,1386,,174,0,209,209
1387,1387,,174,0,294,294
1388,1388,,174,0,209,209
1389,1389,,174,0,209,209
1390,1390,,174,0,209,209
1391,1391,,174,0,159,159
1392,1392,,174,0,209,209
1393,1393,,46,0,108,108
1394,1394,,1203,0,214,214
1395,1395,,177,0,0,0
1396,1396,,46,0,202,202
1397,1397,,38,0,208,208
1398,1398,,85,0,211,211
1399,1399,,85,0,211,211
1400,1400,,85,0,211,211
1401,1401,,85,0,211,211
1402,1402,,46,0,25,25
1403,1403,,178,0,65,65
1404,1404,,178,15,0,15
1405,1405,,178,50,0,50
1406,1406,,1602,0,422,422
1407,1407,,179,0,0,0
1408,1408,,85,0,211,211
1409,1409,,83,0,211,211
1410,1410,,174,0,208,208
1411,1411,,38,0,208,208
1412,1412,,174,0,208,208
1413,1413,,174,0,208,208
1414,1414,,174,0,208,208
1415,1415,,38,0,386,386
1416,1416,,174,0,208,208
1417,1417,,1012,0,336,336
1418,1418,,46,0,62,62
1419,1419,,174,0,208,208
1420,1420,,162,0,209,209
1421,1421,,162,0,209,209
1422,1422,,180,0,211,211
1423,1423,,174,0,208,208
1424,1424,,1602,193,95,288
1425,1425,,174,0,208,208
1426,1426,,158,211,422,633
1427,1427,,181,0,0,0
1428,1428,,162,0,209,209
1429,1429,,46,0,251,251
1430,1430,,182,0,211,211
1431,1431,,1203,0,226,226
1432,1432,,1203,86,0,86
1433,1433,,1203,86,396,482
1434,1434,,1203,280,0,280
1435,1435,,162,0,209,209
1436,1436,,46,5,0,5
1437,1437,,46,0,84,84
1438,1438,,1203,0,226,226
1439,1439,,261,373,0,373
1440,1440,,61,0,68,68
1441,1441,,162,126,82,208
1442,1442,,162,0,209,209
1443,1443,,37,0,211,211
1444,1444,,174,0,208,208
1445,1445,,172,0,211,211
1446,1446,,59,0,211,211
1447,1447,,37,0,211,211
1448,1448,,183,0,211,211
1449,1449,,183,633,0,633
1450,1450,,184,0,0,0
1451,1451,,185,0,211,211
1452,1452,,185,422,0,422
1453,1453,,86,0,422,422
1454,1454,,1023,0,63,63
1455,1455,,1023,52,0,52
1456,1456,,186,0,0,0
1457,1457,,37,0,211,211
1458,1458,,183,0,211,211
1459,1459,,15,0,211,211
1460,1460,,22,0,211,211
1461,1461,,185,0,211,211
1462,1462,,187,0,211,211
1463,1463,,1602,0,422,422
1464,1464,,1602,422,0,422
1465,1465,,37,0,211,211
1466,1466,,37,0,211,211
1467,1467,,162,126,82,208
1468,1468,,158,30,208,238
1469,1469,,183,0,211,211
1470,1470,,158,211,211,422
1471,1471,,46,16,0,16
1472,1472,,37,0,211,211
1473,1473,,1203,0,211,211
1474,1474,,1203,44,0,44
1475,1475,,37,0,211,211
1476,1476,,38,0,208,208
1477,1477,,37,0,211,211
1478,1478,,1203,0,211,211
1479,1479,,37,0,211,211
1480,1480,,85,0,211,211
1481,1481,,162,0,209,209
1482,1482,,46,140,0,140
1483,1483,,46,13,0,13
1484,1484,,37,0,211,211
1485,1485,,37,0,211,211
1486,1486,,46,0,134,134
1487,1487,,71,0,211,211
1488,1488,,35,0,211,211
1489,1489,,174,0,208,208
1490,1490,,991,0,211,211
1491,1491,,162,0,213,213
1492,1492,,162,0,209,209
1493,1493,,174,0,208,208
1494,1494,,1602,0,89,89
1495,1495,,1602,106,0,106
1496,1496,,1602,96,0,96
1497,1497,,38,0,208,208
1498,1498,,189,0,211,211
1499,1499,,174,0,208,208
1500,1500,,38,0,75,75
1501,1501,,38,0,208,208
1502,1502,,261,0,211,211
1503,1503,,46,12,0,12
1504,1504,,1602,0,211,211
1505,1505,,1602,231,0,231
1506,1506,,99,0,633,633
1507,1507,,188,0,211,211
1508,1508,,188,422,0,422
1509,1509,,174,0,208,208
1510,1510,,174,0,208,208
1511,1511,,22,0,211,211
1512,1512,,189,422,0,422
1513,1513,,46,0,70,70
1514,1514,,38,0,208,208
1515,1515,,38,0,208,208
1516,1516,,991,0,422,422
1517,1517,,38,0,208,208
1518,1518,,174,0,208,208
1519,1519,,38,0,208,208
1520,1520,,38,0,208,208
1521,1521,,38,0,208,208
1522,1522,,38,0,208,208
1523,1523,,154,0,211,211
1524,1524,,85,0,211,211
1525,1525,,46,0,242,242
1526,1526,,190,0,0,0
1527,1527,,162,0,285,285
1528,1528,,162,0,209,209
1529,1529,,38,0,208,208
1530,1530,,191,0,0,0
1531,1531,,101,0,211,211
1532,1532,,192,0,0,0
1533,1533,,86,0,211,211
1534,1534,,174,0,208,208
1535,1535,,174,0,208,208
1536,1536,,22,0,211,211
1537,1537,,46,0,68,68
1538,1538,,38,0,208,208
1539,1539,,38,0,208,208
1540,1540,,38,0,208,208
1541,1541,,38,0,208,208
1542,1542,,38,0,208,208
1543,1543,,38,0,208,208
1544,1544,,38,0,208,208
1545,1545,,38,0,208,208
1546,1546,,99,0,633,633
1547,1547,,46,0,128,128
1548,1548,,38,0,208,208
1549,1549,,188,0,211,211
1550,1550,,38,0,54,54
1551,1551,,162,126,82,208
1552,1552,,46,0,211,211
1553,1553,,174,0,208,208
1554,1554,,142,0,211,211
1555,1555,,991,0,419,419
1556,1556,,38,0,208,208
1557,1557,,46,0,67,67
1558,1558,,38,0,208,208
1559,1559,,1602,18,19,37
1560,1560,,46,8,0,8
1561,1561,,261,101,0,101
1562,1562,,142,0,211,211
1563,1563,,174,0,208,208
1564,1564,,174,0,208,208
1565,1565,,38,0,208,208
1566,1566,,38,0,208,208
1567,1567,,46,0,75,75
1568,1568,,85,0,211,211
1569,1569,,114,0,181,181
1570,1570,,174,0,208,208
1571,1571,,99,211,633,844
1572,1572,,174,0,208,208
1573,1573,,142,0,211,211
1574,1574,,182,0,211,211
1575,1575,,142,0,211,211
1576,1576,,86,0,211,211
1577,1577,,85,0,211,211
1578,1578,,85,0,211,211
1579,1579,,46,0,209,209
1580,1580,,19,0,211,211
1581,1581,,174,0,208,208
1582,1582,,174,0,208,208
1583,1583,,174,0,208,208
1584,1584,,174,0,208,208
1585,1585,,38,0,550,550
1586,1586,,991,0,211,211
1587,1587,,174,0,208,208
1588,1588,,46,2,250,252
1589,1589,,46,5,0,5
1590,1590,,174,0,208,208
1591,1591,,158,211,422,633
1592,1592,,46,0,270,270
1593,1593,,46,0,206,206
1594,1594,,46,289,0,289
1595,1595,,193,0,211,211
1596,1596,,193,6330,0,6330
1597,1597,,194,0,0,0
1598,1598,,193,0,211,211
1599,1599,,193,0,211,211
1600,1600,,46,40,0,40
1601,1601,,193,0,211,211
1602,1602,,193,0,211,211
1603,1603,,193,0,211,211
1604,1604,,193,0,211,211
1605,1605,,193,0,211,211
1606,1606,,193,0,211,211
1607,1607,,193,0,211,211
1608,1608,,1023,0,73,73
1609,1609,,193,0,211,211
1610,1610,,193,0,211,211
1611,1611,,193,0,211,211
1612,1612,,38,0,208,208
1613,1613,,116,0,211,211
1614,1614,,99,0,633,633
1615,1615,,193,0,211,211
1616,1616,,193,0,211,211
1617,1617,,193,0,211,211
1618,1618,,193,0,211,211
1619,1619,,193,0,211,211
1620,1620,,193,0,211,211
1621,1621,,193,0,211,211
1622,1622,,193,0,211,211
1623,1623,,193,0,211,211
1624,1624,,193,0,211,211
1625,1625,,193,0,211,211
1626,1626,,162,0,209,209
1627,1627,,193,0,211,211
1628,1628,,193,0,211,211
1629,1629,,193,0,211,211
1630,1630,,193,0,211,211
1631,1631,,193,0,211,211
1632,1632,,193,0,211,211
1633,1633,,174,0,208,208
1634,1634,,99,0,633,633
1635,1635,,256,0,74,74
1636,1636,,195,0,0,0
1637,1637,,261,0,203,203
1638,1638,,156,0,211,211
1639,1639,,162,0,209,209
1640,1640,,162,0,209,209
1641,1641,,38,0,208,208
1642,1642,,174,0,208,208
1643,1643,,174,0,208,208
1644,1644,,46,0,284,284
1645,1645,,162,0,209,209
1646,1646,,158,0,82,82
1647,1647,,174,0,208,208
1648,1648,,174,0,208,208
1649,1649,,38,0,106,106
1650,1650,,174,0,208,208
1651,1651,,162,126,82,208
1652,1652,,189,0,211,211
1653,1653,,142,0,211,211
1654,1654,,154,0,211,211
1655,1655,,38,0,208,208
1656,1656,,128,0,211,211
1657,1657,,99,0,633,633
1658,1658,,38,0,208,208
1659,1659,,196,0,10,10
1660,1660,,196,10,0,10
1661,1661,,162,0,209,209
1662,1662,,162,0,209,209
1663,1663,,174,0,208,208
1664,1664,,162,0,209,209
1665,1665,,162,0,209,209
1666,1666,,162,0,209,209
1667,1667,,162,0,209,209
1668,1668,,38,0,208,208
1669,1669,,86,0,211,211
1670,1670,,206,0,4,4
1671,1671,,206,944,0,944
1672,1672,,206,1191,0,1191
1673,1673,,206,0,84,84
1674,1674,,197,0,0,0
1675,1675,,206,0,2,2
1676,1676,,206,0,36,36
1677,1677,,206,0,12,12
1678,1678,,206,0,53,53
1679,1679,,206,0,88,88
1680,1680,,206,0,90,90
1681,1681,,206,0,64,64
1682,1682,,198,0,0,0
1683,1683,,199,0,0,0
1684,1684,,206,0,71,71
1685,1685,,206,0,6,6
1686,1686,,200,0,0,0
1687,1687,,206,0,90,90
1688,1688,,201,0,0,0
1689,1689,,202,0,0,0
1690,1690,,203,0,0,0
1691,1691,,204,0,0,0
1692,1692,,206,0,4,4
1693,1693,,206,0,7,7
1694,1694,,206,12,0,12
1695,1695,,206,0,48,48
1696,1696,,205,0,0,0
1697,1697,,206,4,0,4
1698,1698,,206,0,19,19
1699,1699,,206,0,22,22
1700,1700,,207,0,0,0
1701,1701,,206,0,7,7
1702,1702,,208,0,0,0
1703,1703,,206,0,85,85
1704,1704,,206,0,21,21
1705,1705,,209,0,0,0
1706,1706,,206,0,9,9
1707,1707,,206,0,26,26
1708,1708,,206,0,14,14
1709,1709,,206,0,23,23
1710,1710,,206,0,16,16
1711,1711,,206,0,53,53
1712,1712,,206,0,46,46
1713,1713,,210,0,0,0
1714,1714,,206,0,5,5
1715,1715,,206,0,3,3
1716,1716,,206,0,92,92
1717,1717,,211,0,0,0
1718,1718,,212,0,0,0
1719,1719,,206,0,32,32
1720,1720,,213,0,0,0
1721,1721,,206,0,53,53
1722,1722,,214,0,0,0
1723,1723,,215,0,0,0
1724,1724,,216,0,0,0
1725,1725,,217,0,0,0
1726,1726,,206,0,9,9
1727,1727,,206,0,44,44
1728,1728,,218,0,0,0
1729,1729,,219,0,0,0
1730,1730,,206,0,22,22
1731,1731,,206,0,80,80
1732,1732,,220,0,0,0
1733,1733,,206,0,32,32
1734,1734,,221,0,0,0
1735,1735,,206,0,17,17
1736,1736,,206,0,82,82
1737,1737,,222,0,0,0
1738,1738,,206,0,22,22
1739,1739,,206,0,17,17
1740,1740,,206,0,23,23
1741,1741,,223,0,0,0
1742,1742,,206,0,18,18
1743,1743,,224,0,0,0
1744,1744,,206,0,24,24
1745,1745,,242,0,211,211
1746,1746,,225,0,0,0
1747,1747,,206,0,32,32
1748,1748,,226,0,0,0
1749,1749,,206,0,42,42
1750,1750,,227,0,0,0
1751,1751,,228,0,0,0
1752,1752,,206,0,17,17
1753,1753,,206,0,5,5
1754,1754,,206,0,3,3
1755,1755,,229,0,0,0
1756,1756,,230,0,0,0
1757,1757,,206,0,84,84
1758,1758,,206,0,22,22
1759,1759,,206,0,18,18
1760,1760,,206,0,16,16
1761,1761,,206,0,17,17
1762,1762,,231,0,0,0
1763,1763,,206,0,18,18
1764,1764,,206,0,62,62
1765,1765,,232,0,0,0
1766,1766,,206,0,27,27
1767,1767,,233,0,0,0
1768,1768,,206,0,15,15
1769,1769,,234,0,0,0
1770,1770,,206,0,19,19
1771,1771,,206,0,61,61
1772,1772,,206,0,92,92
1773,1773,,206,0,19,19
1774,1774,,206,0,9,9
1775,1775,,235,0,211,211
1776,1776,,235,9674,0,9674
1777,1777,,235,0,211,211
1778,1778,,236,0,0,0
1779,1779,,235,0,211,211
1780,1780,,235,0,211,211
1781,1781,,235,0,211,211
1782,1782,,235,0,211,211
1783,1783,,235,0,212,212
1784,1784,,235,143,0,143
1785,1785,,235,0,211,211
1786,1786,,235,0,211,211
1787,1787,,235,0,211,211
1788,1788,,235,0,211,211
1789,1789,,235,0,211,211
1790,1790,,235,0,212,212
1791,1791,,235,0,211,211
1792,1792,,235,0,211,211
1793,1793,,235,0,211,211
1794,1794,,235,0,211,211
1795,1795,,235,0,211,211
1796,1796,,235,0,211,211
1797,1797,,235,0,211,211
1798,1798,,235,0,212,212
1799,1799,,235,0,211,211
1800,1800,,235,0,212,212
1801,1801,,235,100,0,100
1802,1802,,235,0,212,212
1803,1803,,235,0,213,213
1804,1804,,235,0,211,211
1805,1805,,235,0,211,211
1806,1806,,235,0,212,212
1807,1807,,235,0,211,211
1808,1808,,235,0,211,211
1809,1809,,235,0,211,211
1810,1810,,235,0,212,212
1811,1811,,235,0,211,211
1812,1812,,235,0,211,211
1813,1813,,235,10,0,10
1814,1814,,235,0,211,211
1815,1815,,235,0,211,211
1816,1816,,235,0,211,211
1817,1817,,235,0,211,211
1818,1818,,235,0,212,212
1819,1819,,235,0,211,211
1820,1820,,235,0,211,211
1821,1821,,235,0,211,211
1822,1822,,235,0,211,211
1823,1823,,235,0,211,211
1824,1824,,235,0,211,211
1825,1825,,235,0,211,211
1826,1826,,235,0,211,211
1827,1827,,237,0,0,0
1828,1828,,807,2,0,2
1829,1829,,2110,9,0,9
1830,1830,,1502,0,10,10
1831,1831,,1998,3,0,3
1832,1832,,807,0,1,1
1833,1833,,807,41,0,41
1834,1834,,427,0,3,3
1835,1835,,427,4,0,4
1836,1836,,1502,0,14,14
1837,1837,,427,0,6,6
1838,1838,,1502,0,2,2
1839,1839,,1502,16,0,16
1840,1840,,427,0,1,1
1841,1841,,427,0,123,123
1842,1842,,427,4,0,4
1843,1843,,427,3,0,3
1844,1844,,427,0,4,4
1845,1845,,1974,0,8,8
1846,1846,,1502,0,89,89
1847,1847,,1502,0,1,1
1848,1848,,427,0,1,1
1849,1849,,1502,0,2,2
1850,1850,,1985,0,327,327
1851,1851,,427,0,468,468
1852,1852,,807,0,18,18
1853,1853,,2110,0,12,12
1854,1854,,1502,0,186,186
1855,1855,,1502,0,28,28
1856,1856,,2110,2,0,2
1857,1857,,807,0,1,1
1858,1858,,1974,0,43,43
1859,1859,,239,1,0,1
1860,1860,,427,0,144,144
1861,1861,,2048,0,16,16
1862,1862,,1502,4,0,4
1863,1863,,2110,0,233,233
1864,1864,,807,0,52,52
1865,1865,,1502,0,15,15
1866,1866,,1602,0,395,395
1867,1867,,1502,0,12,12
1868,1868,,1502,0,16,16
1869,1869,,2110,0,2,2
1870,1870,,427,0,8,8
1871,1871,,1502,0,213,213
1872,1872,,1502,0,3,3
1873,1873,,1502,0,2,2
1874,1874,,1502,0,17,17
1875,1875,,807,0,73,73
1876,1876,,1998,0,1,1
1877,1877,,2063,1,34,35
1878,1878,,807,0,1,1
1879,1879,,807,0,1,1
1880,1880,,807,2,0,2
1881,1881,,427,0,3,3
1882,1882,,443,0,50,50
1883,1883,,238,0,0,0
1884,1884,,239,0,1,1
1885,1885,,1502,0,7,7
1886,1886,,1502,0,3,3
1887,1887,,427,0,16,16
1888,1888,,1502,2,0,2
1889,1889,,2110,0,33,33
1890,1890,,1998,0,6,6
1891,1891,,1502,0,2,2
1892,1892,,1502,1,0,1
1893,1893,,1502,0,161,161
1894,1894,,1502,0,241,241
1895,1895,,240,0,0,0
1896,1896,,807,0,132,132
1897,1897,,807,0,35,35
1898,1898,,427,0,142,142
1899,1899,,1974,2,0,2
1900,1900,,1974,0,63,63
1901,1901,,1974,2,0,2
1902,1902,,1502,0,200,200
1903,1903,,443,0,2,2
1904,1904,,807,0,1,1
1905,1905,,1974,0,2,2
1906,1906,,1502,0,1,1
1907,1907,,241,0,0,0
1908,1908,,807,0,47,47
1909,1909,,1602,0,31,31
1910,1910,,2110,0,53,53
1911,1911,,1974,0,8,8
1912,1912,,1602,0,393,393
1913,1913,,1602,56,0,56
1914,1914,,1602,10,0,10
1915,1915,,1214,0,76,76
1916,1916,,1214,24,0,24
1917,1917,,46,0,53,53
1918,1918,,38,2,0,2
1919,1919,,46,8,0,8
1920,1920,,1602,35,0,35
1921,1921,,261,0,197,197
1922,1922,,261,27,212,239
1923,1923,,1602,0,36,36
1924,1924,,1602,31,0,31
1925,1925,,467,0,15,15
1926,1926,,1214,164,0,164
1927,1927,,1602,0,39,39
1928,1928,,1602,31,0,31
1929,1929,,1602,7,2,9
1930,1930,,46,0,335,335
1931,1931,,1203,21,217,238
1932,1932,,261,11,0,11
1933,1933,,1007,0,13,13
1934,1934,,1602,8,0,8
1935,1935,,1602,39,211,250
1936,1936,,242,216,0,216
1937,1937,,1602,3,0,3
1938,1938,,1502,7,0,7
1939,1939,,1602,0,166,166
1940,1940,,1602,48,0,48
1941,1941,,261,0,429,429
1942,1942,,261,6,0,6
1943,1943,,261,211,0,211
1944,1944,,46,87,0,87
1945,1945,,1602,0,138,138
1946,1946,,1602,7,0,7
1947,1947,,1602,22,235,257
1948,1948,,1007,13,43,56
1949,1949,,261,0,21,21
1950,1950,,261,51,0,51
1951,1951,,46,0,11,11
1952,1952,,46,6,0,6
1953,1953,,46,11,0,11
1954,1954,,243,0,0,0
1955,1955,,244,0,0,0
1956,1956,,261,0,267,267
1957,1957,,1602,26,216,242
1958,1958,,261,2,208,210
1959,1959,,261,0,202,202
1960,1960,,261,7,0,7
1961,1961,,261,15,216,231
1962,1962,,46,64,0,64
1963,1963,,46,101,0,101
1964,1964,,245,0,0,0
1965,1965,,46,1,5,6
1966,1966,,246,0,0,0
1967,1967,,991,0,252,252
1968,1968,,46,0,56,56
1969,1969,,247,0,0,0
1970,1970,,261,0,210,210
1971,1971,,121,0,14,14
1972,1972,,261,21,0,21
1973,1973,,1602,49,0,49
1974,1974,,261,25,0,25
1975,1975,,261,5,244,249
1976,1976,,261,0,232,232
1977,1977,,1214,149,0,149
1978,1978,,46,1,0,1
1979,1979,,1502,1,96,97
1980,1980,,261,30,29,59
1981,1981,,261,49,0,49
1982,1982,,261,13,0,13
1983,1983,,1602,0,358,358
1984,1984,,1602,5,0,5
1985,1985,,261,41,0,41
1986,1986,,261,25,0,25
1987,1987,,261,39,0,39
1988,1988,,261,0,12,12
1989,1989,,1602,11,0,11
1990,1990,,261,7,0,7
1991,1991,,1602,497,0,497
1992,1992,,1602,50,0,50
1993,1993,,1502,81,0,81
1994,1994,,256,7,74,81
1995,1995,,46,11,0,11
1996,1996,,46,30,0,30
1997,1997,,1602,12,0,12
1998,1998,,46,0,50,50
1999,1999,,1602,0,70,70
2000,2000,,1602,5,0,5
2001,2001,,61,0,16,16
2002,2002,,248,0,0,0
2003,2003,,46,51,215,266
2004,2004,,158,211,0,211
2005,2005,,80,0,12,12
2006,2006,,46,0,212,212
2007,2007,,261,0,195,195
2008,2008,,261,1472,116,1588
2009,2009,,261,1522,0,1522
2010,2010,,261,0,195,195
2011,2011,,46,0,216,216
2012,2012,,1602,425,0,425
2013,2013,,249,0,0,0
2014,2014,,261,0,211,211
2015,2015,,1203,0,90,90
2016,2016,,1203,0,197,197
2017,2017,,261,0,195,195
2018,2018,,261,1589,0,1589
2019,2019,,46,346,0,346
2020,2020,,261,0,217,217
2021,2021,,1602,0,129,129
2022,2022,,1203,0,109,109
2023,2023,,1203,96,0,96
2024,2024,,261,2,24,26
2025,2025,,261,10,0,10
2026,2026,,46,0,217,217
2027,2027,,46,950,0,950
2028,2028,,250,0,0,0
2029,2029,,46,56,0,56
2030,2030,,261,0,216,216
2031,2031,,261,88,0,88
2032,2032,,261,171,0,171
2033,2033,,46,0,66,66
2034,2034,,1203,0,197,197
2035,2035,,261,0,135,135
2036,2036,,261,3,0,3
2037,2037,,261,0,105,105
2038,2038,,46,48,0,48
2039,2039,,251,0,1,1
2040,2040,,261,1739,0,1739
2041,2041,,1602,397,0,397
2042,2042,,1602,10,0,10
2043,2043,,1602,12,0,12
2044,2044,,46,108,0,108
2045,2045,,261,453,0,453
2046,2046,,261,0,56,56
2047,2047,,1602,0,212,212
2048,2048,,1985,341,0,341
2049,2049,,46,0,213,213
2050,2050,,1602,15,0,15
2051,2051,,46,24,0,24
2052,2052,,1602,22,0,22
2053,2053,,252,0,0,0
2054,2054,,261,12,0,12
2055,2055,,158,671,4111,4782
2056,2056,,261,8,21,29
2057,2057,,1602,0,108,108
2058,2058,,253,0,0,0
2059,2059,,261,0,216,216
2060,2060,,261,188,0,188
2061,2061,,261,671,0,671
2062,2062,,261,31,0,31
2063,2063,,254,0,0,0
2064,2064,,255,0,0,0
2065,2065,,261,0,211,211
2066,2066,,261,153,0,153
2067,2067,,256,148,0,148
2068,2068,,46,0,218,218
2069,2069,,261,0,213,213
2070,2070,,261,16,0,16
2071,2071,,46,0,215,215
2072,2072,,46,6,62,68
2073,2073,,261,0,178,178
2074,2074,,1602,0,201,201
2075,2075,,1602,58,0,58
2076,2076,,1602,0,49,49
2077,2077,,261,0,214,214
2078,2078,,1602,0,49,49
2079,2079,,46,0,213,213
2080,2080,,1203,0,212,212
2081,2081,,257,0,0,0
2082,2082,,261,358,212,570
2083,2083,,261,6,0,6
2084,2084,,261,135,0,135
2085,2085,,261,0,211,211
2086,2086,,261,14,0,14
2087,2087,,261,10,0,10
2088,2088,,261,6,0,6
2089,2089,,1203,0,213,213
2090,2090,,1203,0,212,212
2091,2091,,1602,0,56,56
2092,2092,,1602,0,20,20
2093,2093,,1602,0,211,211
2094,2094,,261,0,216,216
2095,2095,,261,62,0,62
2096,2096,,261,57,0,57
2097,2097,,46,0,138,138
2098,2098,,258,0,0,0
2099,2099,,1203,15,535,550
2100,2100,,1203,6,37,43
2101,2101,,261,0,216,216
2102,2102,,261,0,217,217
2103,2103,,261,14,0,14
2104,2104,,261,12,0,12
2105,2105,,46,0,211,211
2106,2106,,261,11,59,70
2107,2107,,46,34,0,34
2108,2108,,259,0,0,0
2109,2109,,260,0,0,0
2110,2110,,1602,0,72,72
2111,2111,,46,9,0,9
2112,2112,,1602,0,49,49
2113,2113,,46,0,212,212
2114,2114,,261,20,10,30
2115,2115,,1203,0,197,197
2116,2116,,261,0,214,214
2117,2117,,261,0,81,81
2118,2118,,46,0,61,61
2119,2119,,261,0,414,414
2120,2120,,261,842,0,842
2121,2121,,1602,0,152,152
2122,2122,,1602,51,0,51
2123,2123,,1203,39,243,282
2124,2124,,1203,0,212,212
2125,2125,,261,0,94,94
2126,2126,,261,0,218,218
2127,2127,,1602,0,230,230
2128,2128,,261,343,0,343
2129,2129,,46,0,138,138
2130,2130,,261,0,267,267
2131,2131,,261,0,195,195
2132,2132,,1602,0,49,49
2133,2133,,261,0,137,137
2134,2134,,46,0,212,212
2135,2135,,261,0,272,272
2136,2136,,1602,0,94,94
2137,2137,,46,0,21,21
2138,2138,,261,0,214,214
2139,2139,,46,0,212,212
2140,2140,,261,0,215,215
2141,2141,,1602,0,70,70
2142,2142,,261,0,216,216
2143,2143,,261,0,23,23
2144,2144,,261,0,133,133
2145,2145,,261,42,0,42
2146,2146,,46,12,0,12
2147,2147,,1502,47,0,47
2148,2148,,1502,54,0,54
2149,2149,,46,0,76,76
2150,2150,,46,216,0,216
2151,2151,,261,10,0,10
2152,2152,,262,0,0,0
2153,2153,,46,0,219,219
2154,2154,,1502,0,20,20
2155,2155,,1502,1382,0,1382
2156,2156,,46,0,138,138
2157,2157,,261,66,101,167
2158,2158,,261,12,0,12
2159,2159,,46,0,214,214
2160,2160,,263,0,0,0
2161,2161,,261,0,135,135
2162,2162,,264,0,0,0
2163,2163,,261,0,212,212
2164,2164,,1203,0,197,197
2165,2165,,265,0,0,0
2166,2166,,1203,0,197,197
2167,2167,,1203,0,11,11
2168,2168,,1602,0,138,138
2169,2169,,46,0,212,212
2170,2170,,261,104,0,104
2171,2171,,1203,0,212,212
2172,2172,,261,0,213,213
2173,2173,,1602,0,18,18
2174,2174,,1602,11,0,11
2175,2175,,1502,135,0,135
2176,2176,,261,0,212,212
2177,2177,,1602,0,98,98
2178,2178,,46,0,70,70
2179,2179,,1602,25,0,25
2180,2180,,1602,11,0,11
2181,2181,,1602,11,0,11
2182,2182,,266,0,0,0
2183,2183,,1203,12,501,513
2184,2184,,267,0,0,0
2185,2185,,1203,12,14,26
2186,2186,,1203,10,13,23
2187,2187,,1203,9,0,9
2188,2188,,1203,7,0,7
2189,2189,,1203,4,6,10
2190,2190,,1203,2,0,2
2191,2191,,1203,4,16,20
2192,2192,,1203,17,0,17
2193,2193,,1203,4,4,8
2194,2194,,1203,7,0,7
2195,2195,,1203,4,7,11
2196,2196,,1203,10,0,10
2197,2197,,1203,4,0,4
2198,2198,,1203,7,0,7
2199,2199,,1203,2,2,4
2200,2200,,427,2,146,148
2201,2201,,1602,12,0,12
2202,2202,,46,15,0,15
2203,2203,,1602,5,7,12
2204,2204,,38,21,0,21
2205,2205,,1203,0,105,105
2206,2206,,268,0,0,0
2207,2207,,1502,0,393,393
2208,2208,,269,0,0,0
2209,2209,,270,0,0,0
2210,2210,,271,0,0,0
2211,2211,,272,0,0,0
2212,2212,,273,0,0,0
2213,2213,,274,0,0,0
2214,2214,,1203,0,247,247
2215,2215,,275,0,0,0
2216,2216,,276,10,0,10
2217,2217,,277,0,38,38
2218,2218,,277,10,0,10
2219,2219,,277,24,0,24
2220,2220,,277,4,0,4
2221,2221,,278,0,14,14
2222,2222,,278,14,0,14
2223,2223,,280,0,5,5
2224,2224,,279,0,0,0
2225,2225,,280,2,0,2
2226,2226,,280,3,0,3
2227,2227,,807,0,25,25
2228,2228,,46,3,0,3
2229,2229,,1602,11,17,28
2230,2230,,1602,17,3,20
2231,2231,,1602,12,2,14
2232,2232,,807,8,35,43
2233,2233,,509,17,36,53
2234,2234,,1602,13,0,13
2235,2235,,1602,19,5,24
2236,2236,,281,0,0,0
2237,2237,,282,0,5,5
2238,2238,,282,5,0,5
2239,2239,,61,6,0,6
2240,2240,,46,2,0,2
2241,2241,,1952,10,10,20
2242,2242,,1952,10,11,21
2243,2243,,1952,39,39,78
2244,2244,,1952,39,40,79
2245,2245,,1974,9,11,20
2246,2246,,1974,9,9,18
2247,2247,,283,13,21,34
2248,2248,,283,31,23,54
2249,2249,,284,25,25,50
2250,2250,,284,25,25,50
2251,2251,,285,4,4,8
2252,2252,,285,4,4,8
2253,2253,,1974,0,29,29
2254,2254,,1974,26,0,26
2255,2255,,286,0,0,0
2256,2256,,287,0,0,0
2257,2257,,288,7,7,14
2258,2258,,288,7,7,14
2259,2259,,289,17,17,34
2260,2260,,289,17,17,34
2261,2261,,509,169,169,338
2262,2262,,509,169,172,341
2263,2263,,290,0,0,0
2264,2264,,291,0,0,0
2265,2265,,1985,0,174,174
2266,2266,,1985,7,0,7
2267,2267,,1214,25,25,50
2268,2268,,1214,25,60,85
2269,2269,,2064,0,2,2
2270,2270,,2064,208,0,208
2271,2271,,292,14,14,28
2272,2272,,292,14,14,28
2273,2273,,293,0,0,0
2274,2274,,294,0,0,0
2275,2275,,295,23,23,46
2276,2276,,295,23,23,46
2277,2277,,1952,14,16,30
2278,2278,,1952,14,23,37
2279,2279,,296,0,0,0
2280,2280,,297,62,62,124
2281,2281,,297,62,62,124
2282,2282,,298,180,180,360
2283,2283,,298,180,180,360
2284,2284,,299,6,6,12
2285,2285,,299,6,6,12
2286,2286,,1499,37,42,79
2287,2287,,1499,37,37,74
2288,2288,,300,16,16,32
2289,2289,,300,16,16,32
2290,2290,,301,0,0,0
2291,2291,,302,0,0,0
2292,2292,,1952,0,16,16
2293,2293,,1952,15,0,15
2294,2294,,1952,6,164,170
2295,2295,,1952,6,6,12
2296,2296,,303,10,10,20
2297,2297,,303,10,10,20
2298,2298,,1502,3,117,120
2299,2299,,1502,3,4,7
2300,2300,,1502,44,0,44
2301,2301,,1985,20,302,322
2302,2302,,1985,172,172,344
2303,2303,,304,0,0,0
2304,2304,,305,0,0,0
2305,2305,,306,211,211,422
2306,2306,,306,211,211,422
2307,2307,,307,0,0,0
2308,2308,,308,0,0,0
2309,2309,,1602,0,29,29
2310,2310,,1602,22,79,101
2311,2311,,309,12,12,24
2312,2312,,309,12,12,24
2313,2313,,310,0,0,0
2314,2314,,311,0,0,0
2315,2315,,312,3,3,6
2316,2316,,312,3,3,6
2317,2317,,1499,5,6,11
2318,2318,,1499,40,40,80
2319,2319,,283,10,10,20
2320,2320,,313,0,0,0
2321,2321,,314,0,0,0
2322,2322,,315,0,0,0
2323,2323,,316,0,0,0
2324,2324,,317,0,211,211
2325,2325,,317,211,0,211
2326,2326,,1952,31,31,62
2327,2327,,1952,31,32,63
2328,2328,,318,0,0,0
2329,2329,,319,0,0,0
2330,2330,,1952,0,1,1
2331,2331,,320,0,0,0
2332,2332,,321,0,0,0
2333,2333,,322,0,0,0
2334,2334,,323,1,1,2
2335,2335,,323,1,1,2
2336,2336,,324,6,6,12
2337,2337,,324,6,6,12
2338,2338,,1952,2,4,6
2339,2339,,1952,2,4,6
2340,2340,,1952,15,15,30
2341,2341,,1952,18,22,40
2342,2342,,325,0,0,0
2343,2343,,326,0,0,0
2344,2344,,1974,0,1,1
2345,2345,,327,0,0,0
2346,2346,,328,11,11,22
2347,2347,,328,11,11,22
2348,2348,,2048,5,6,11
2349,2349,,2048,5,32,37
2350,2350,,427,212,224,436
2351,2351,,427,211,211,422
2352,2352,,1952,17,174,191
2353,2353,,1952,174,18,192
2354,2354,,329,15,15,30
2355,2355,,329,15,15,30
2356,2356,,330,0,0,0
2357,2357,,331,0,0,0
2358,2358,,332,0,5,5
2359,2359,,332,5,0,5
2360,2360,,2064,0,207,207
2361,2361,,1952,203,203,406
2362,2362,,1952,203,210,413
2363,2363,,2110,7,8,15
2364,2364,,2110,7,7,14
2365,2365,,1952,0,8,8
2366,2366,,1952,14,0,14
2367,2367,,333,0,0,0
2368,2368,,334,0,0,0
2369,2369,,427,15,16,31
2370,2370,,427,15,15,30
2371,2371,,335,13,13,26
2372,2372,,335,13,13,26
2373,2373,,1952,1,175,176
2374,2374,,1952,51,0,51
2375,2375,,336,0,0,0
2376,2376,,337,0,0,0
2377,2377,,1952,11,11,22
2378,2378,,1952,11,16,27
2379,2379,,1952,17,18,35
2380,2380,,1952,17,19,36
2381,2381,,1502,6,7,13
2382,2382,,1502,6,6,12
2383,2383,,338,7,7,14
2384,2384,,338,7,7,14
2385,2385,,1952,7,6,13
2386,2386,,1952,6,6,12
2387,2387,,1998,1,1,2
2388,2388,,1998,1,10,11
2389,2389,,1952,3,3,6
2390,2390,,339,20,20,40
2391,2391,,339,20,20,40
2392,2392,,1952,4,3,7
2393,2393,,1952,3,5,8
2394,2394,,1214,22,22,44
2395,2395,,1214,22,48,70
2396,2396,,340,0,26,26
2397,2397,,340,26,0,26
2398,2398,,1296,0,3,3
2399,2399,,1296,3,0,3
2400,2400,,1952,0,10,10
2401,2401,,1952,10,0,10
2402,2402,,2048,0,62,62
2403,2403,,2048,12,0,12
2404,2404,,509,15,23,38
2405,2405,,509,15,15,30
2406,2406,,1952,1,11,12
2407,2407,,1952,1,1,2
2408,2408,,1952,9,0,9
2409,2409,,1952,14,14,28
2410,2410,,1952,14,18,32
2411,2411,,341,39,39,78
2412,2412,,341,39,39,78
2413,2413,,342,0,0,0
2414,2414,,1952,0,26,26
2415,2415,,1952,26,0,26
2416,2416,,343,93,3,96
2417,2417,,343,3,93,96
2418,2418,,1998,9,11,20
2419,2419,,1998,9,9,18
2420,2420,,1839,3,7,10
2421,2421,,1839,3,3,6
2422,2422,,1952,0,8,8
2423,2423,,1952,7,0,7
2424,2424,,1952,0,58,58
2425,2425,,1952,54,0,54
2426,2426,,2048,211,14,225
2427,2427,,2048,6,211,217
2428,2428,,1952,0,8,8
2429,2429,,344,0,0,0
2430,2430,,345,0,0,0
2431,2431,,1985,152,152,304
2432,2432,,346,6,6,12
2433,2433,,346,6,6,12
2434,2434,,347,0,0,0
2435,2435,,348,0,0,0
2436,2436,,349,0,0,0
2437,2437,,360,0,2,2
2438,2438,,350,8,8,16
2439,2439,,350,8,8,16
2440,2440,,1499,35,35,70
2441,2441,,351,21,21,42
2442,2442,,351,21,21,42
2443,2443,,1952,16,17,33
2444,2444,,1952,16,16,32
2445,2445,,352,0,211,211
2446,2446,,352,211,0,211
2447,2447,,1214,4,185,189
2448,2448,,1952,15,22,37
2449,2449,,1952,0,25,25
2450,2450,,353,192,23,215
2451,2451,,353,23,192,215
2452,2452,,354,0,0,0
2453,2453,,355,0,0,0
2454,2454,,356,0,0,0
2455,2455,,357,0,0,0
2456,2456,,1502,0,42,42
2457,2457,,1502,38,4,42
2458,2458,,358,3,3,6
2459,2459,,358,3,3,6
2460,2460,,359,9,9,18
2461,2461,,359,9,9,18
2462,2462,,1952,11,11,22
2463,2463,,2062,1,45,46
2464,2464,,2062,43,0,43
2465,2465,,1214,0,48,48
2466,2466,,1214,33,3,36
2467,2467,,360,3,0,3
2468,2468,,361,0,0,0
2469,2469,,362,0,0,0
2470,2470,,1952,0,26,26
2471,2471,,1952,2,0,2
2472,2472,,1952,0,10,10
2473,2473,,1203,0,38,38
2474,2474,,363,0,0,0
2475,2475,,427,0,144,144
2476,2476,,427,3236,0,3236
2477,2477,,2011,0,2,2
2478,2478,,1998,7,0,7
2479,2479,,364,0,0,0
2480,2480,,421,1049,0,1049
2481,2481,,427,0,102,102
2482,2482,,427,3154,0,3154
2483,2483,,2110,0,124,124
2484,2484,,427,341,0,341
2485,2485,,1203,168,0,168
2486,2486,,1203,1259,0,1259
2487,2487,,1203,192,0,192
2488,2488,,1203,100,0,100
2489,2489,,1203,136,0,136
2490,2490,,1203,1222,0,1222
2491,2491,,1203,961,0,961
2492,2492,,1203,1006,0,1006
2493,2493,,1203,156,0,156
2494,2494,,1203,586,0,586
2495,2495,,1203,426,0,426
2496,2496,,1203,72,0,72
2497,2497,,1203,92,0,92
2498,2498,,1203,114,0,114
2499,2499,,365,0,0,0
2500,2500,,366,0,0,0
2501,2501,,1985,0,85,85
2502,2502,,1985,97,0,97
2503,2503,,427,0,23,23
2504,2504,,1502,0,51,51
2505,2505,,1502,1975,0,1975
2506,2506,,427,8,0,8
2507,2507,,427,0,70,70
2508,2508,,427,0,33,33
2509,2509,,427,148,0,148
2510,2510,,1502,0,50,50
2511,2511,,427,0,207,207
2512,2512,,367,0,0,0
2513,2513,,427,22,0,22
2514,2514,,427,0,11,11
2515,2515,,427,80,0,80
2516,2516,,427,0,227,227
2517,2517,,427,2255,0,2255
2518,2518,,2110,254,0,254
2519,2519,,427,0,15,15
2520,2520,,427,574,0,574
2521,2521,,427,0,133,133
2522,2522,,427,0,49,49
2523,2523,,368,0,0,0
2524,2524,,369,0,0,0
2525,2525,,410,0,10,10
2526,2526,,410,38,0,38
2527,2527,,410,25,0,25
2528,2528,,1998,0,2,2
2529,2529,,1502,39,0,39
2530,2530,,427,0,402,402
2531,2531,,427,58,148,206
2532,2532,,421,0,43,43
2533,2533,,421,273,0,273
2534,2534,,1502,0,7,7
2535,2535,,1502,1,0,1
2536,2536,,370,0,0,0
2537,2537,,1203,6,0,6
2538,2538,,421,0,85,85
2539,2539,,427,0,314,314
2540,2540,,427,954,0,954
2541,2541,,427,0,44,44
2542,2542,,421,20,0,20
2543,2543,,1502,0,4,4
2544,2544,,807,0,15,15
2545,2545,,807,67,0,67
2546,2546,,371,0,0,0
2547,2547,,427,0,56,56
2548,2548,,372,0,0,0
2549,2549,,373,0,0,0
2550,2550,,1502,0,40,40
2551,2551,,374,0,0,0
2552,2552,,375,0,0,0
2553,2553,,1502,0,40,40
2554,2554,,427,0,4,4
2555,2555,,376,0,0,0
2556,2556,,427,258,0,258
2557,2557,,421,0,60,60
2558,2558,,427,0,241,241
2559,2559,,2110,0,12,12
2560,2560,,2110,86,0,86
2561,2561,,377,0,0,0
2562,2562,,378,0,0,0
2563,2563,,379,0,0,0
2564,2564,,1502,0,89,89
2565,2565,,2096,0,23,23
2566,2566,,2096,122,0,122
2567,2567,,1203,72,0,72
2568,2568,,1203,96,0,96
2569,2569,,1203,36,0,36
2570,2570,,380,0,0,0
2571,2571,,1203,104,0,104
2572,2572,,427,0,55,55
2573,2573,,1502,0,33,33
2574,2574,,427,1,24,25
2575,2575,,421,0,1,1
2576,2576,,381,0,0,0
2577,2577,,427,0,48,48
2578,2578,,427,127,0,127
2579,2579,,382,0,0,0
2580,2580,,427,0,63,63
2581,2581,,1502,0,17,17
2582,2582,,427,0,146,146
2583,2583,,427,0,98,98
2584,2584,,427,0,70,70
2585,2585,,408,31,0,31
2586,2586,,427,0,66,66
2587,2587,,427,0,330,330
2588,2588,,427,337,0,337
2589,2589,,427,0,99,99
2590,2590,,807,0,12,12
2591,2591,,383,0,0,0
2592,2592,,427,0,120,120
2593,2593,,427,1299,0,1299
2594,2594,,384,0,6,6
2595,2595,,384,6,0,6
2596,2596,,421,0,24,24
2597,2597,,1502,0,27,27
2598,2598,,807,17,0,17
2599,2599,,385,0,0,0
2600,2600,,427,0,53,53
2601,2601,,46,2,0,2
2602,2602,,1203,46,0,46
2603,2603,,404,0,25,25
2604,2604,,404,112,0,112
2605,2605,,427,0,224,224
2606,2606,,427,235,0,235
2607,2607,,427,88,0,88
2608,2608,,427,0,21,21
2609,2609,,1203,0,182,182
2610,2610,,1203,231,0,231
2611,2611,,421,0,41,41
2612,2612,,421,27,0,27
2613,2613,,1502,0,2,2
2614,2614,,386,0,0,0
2615,2615,,427,0,361,361
2616,2616,,1203,0,222,222
2617,2617,,1203,32,0,32
2618,2618,,1203,22,0,22
2619,2619,,427,0,15,15
2620,2620,,421,0,62,62
2621,2621,,427,0,422,422
2622,2622,,427,0,162,162
2623,2623,,427,48,0,48
2624,2624,,1203,0,243,243
2625,2625,,1502,0,41,41
2626,2626,,1502,0,68,68
2627,2627,,1502,0,78,78
2628,2628,,1502,0,46,46
2629,2629,,427,0,116,116
2630,2630,,1502,0,15,15
2631,2631,,427,0,16,16
2632,2632,,427,0,202,202
2633,2633,,427,1,41,42
2634,2634,,427,0,38,38
2635,2635,,387,0,0,0
2636,2636,,1998,87,0,87
2637,2637,,427,0,153,153
2638,2638,,388,0,0,0
2639,2639,,421,0,3,3
2640,2640,,427,0,84,84
2641,2641,,421,0,7,7
2642,2642,,389,0,0,0
2643,2643,,427,0,59,59
2644,2644,,427,0,201,201
2645,2645,,1502,0,29,29
2646,2646,,427,0,66,66
2647,2647,,390,0,0,0
2648,2648,,1502,0,139,139
2649,2649,,1502,0,89,89
2650,2650,,391,0,0,0
2651,2651,,392,0,0,0
2652,2652,,393,0,0,0
2653,2653,,394,0,0,0
2654,2654,,395,0,0,0
2655,2655,,427,0,103,103
2656,2656,,807,0,3,3
2657,2657,,396,0,0,0
2658,2658,,1203,0,173,173
2659,2659,,1502,0,46,46
2660,2660,,1203,0,267,267
2661,2661,,1203,0,4,4
2662,2662,,1203,0,68,68
2663,2663,,2072,0,266,266
2664,2664,,1203,0,131,131
2665,2665,,1203,0,6,6
2666,2666,,421,0,71,71
2667,2667,,421,228,0,228
2668,2668,,1203,0,252,252
2669,2669,,427,0,5,5
2670,2670,,427,0,62,62
2671,2671,,2110,0,178,178
2672,2672,,2110,259,0,259
2673,2673,,1203,0,118,118
2674,2674,,1203,0,239,239
2675,2675,,427,0,211,211
2676,2676,,1203,0,236,236
2677,2677,,1203,0,285,285
2678,2678,,427,0,21,21
2679,2679,,427,0,50,50
2680,2680,,807,0,50,50
2681,2681,,427,0,202,202
2682,2682,,1502,0,56,56
2683,2683,,1502,11,0,11
2684,2684,,427,0,13,13
2685,2685,,1985,0,27,27
2686,2686,,421,119,0,119
2687,2687,,1203,9,259,268
2688,2688,,427,0,114,114
2689,2689,,1502,0,56,56
2690,2690,,427,0,8,8
2691,2691,,1985,0,527,527
2692,2692,,427,0,196,196
2693,2693,,46,0,255,255
2694,2694,,46,5,0,5
2695,2695,,1502,0,55,55
2696,2696,,427,0,196,196
2697,2697,,427,0,1,1
2698,2698,,1203,0,184,184
2699,2699,,421,0,130,130
2700,2700,,427,0,20,20
2701,2701,,1502,0,8,8
2702,2702,,2072,0,218,218
2703,2703,,427,219,0,219
2704,2704,,2072,219,0,219
2705,2705,,2072,635,0,635
2706,2706,,421,70,0,70
2707,2707,,421,0,10,10
2708,2708,,1502,0,11,11
2709,2709,,397,0,0,0
2710,2710,,421,0,87,87
2711,2711,,2096,0,25,25
2712,2712,,2096,38,0,38
2713,2713,,427,194,0,194
2714,2714,,427,0,3,3
2715,2715,,427,0,128,128
2716,2716,,1985,0,6,6
2717,2717,,427,0,116,116
2718,2718,,427,0,271,271
2719,2719,,427,0,182,182
2720,2720,,427,458,0,458
2721,2721,,427,69,0,69
2722,2722,,427,0,1,1
2723,2723,,427,0,225,225
2724,2724,,427,0,55,55
2725,2725,,398,0,0,0
2726,2726,,427,0,100,100
2727,2727,,421,0,2,2
2728,2728,,427,0,13,13
2729,2729,,1985,0,416,416
2730,2730,,1998,0,3,3
2731,2731,,1998,2,0,2
2732,2732,,1998,0,313,313
2733,2733,,1998,361,0,361
2734,2734,,427,0,15,15
2735,2735,,1203,0,218,218
2736,2736,,427,0,124,124
2737,2737,,421,0,117,117
2738,2738,,1502,0,36,36
2739,2739,,404,0,49,49
2740,2740,,427,0,107,107
2741,2741,,427,0,128,128
2742,2742,,399,0,0,0
2743,2743,,427,0,122,122
2744,2744,,427,0,162,162
2745,2745,,404,12,0,12
2746,2746,,427,0,51,51
2747,2747,,807,0,147,147
2748,2748,,807,75,0,75
2749,2749,,400,0,0,0
2750,2750,,1203,0,204,204
2751,2751,,427,0,21,21
2752,2752,,401,0,0,0
2753,2753,,1602,0,21,21
2754,2754,,1502,0,91,91
2755,2755,,427,0,40,40
2756,2756,,402,0,0,0
2757,2757,,1502,0,6,6
2758,2758,,421,0,66,66
2759,2759,,427,0,20,20
2760,2760,,427,0,47,47
2761,2761,,427,0,115,115
2762,2762,,1998,0,96,96
2763,2763,,1998,34,0,34
2764,2764,,1203,0,106,106
2765,2765,,1203,0,216,216
2766,2766,,403,0,0,0
2767,2767,,1203,0,246,246
2768,2768,,1602,0,45,45
2769,2769,,427,0,157,157
2770,2770,,427,0,226,226
2771,2771,,427,0,1,1
2772,2772,,404,0,50,50
2773,2773,,427,0,133,133
2774,2774,,807,0,67,67
2775,2775,,427,0,9,9
2776,2776,,1203,0,190,190
2777,2777,,1502,0,89,89
2778,2778,,1998,0,18,18
2779,2779,,1998,2,0,2
2780,2780,,807,0,8,8
2781,2781,,405,0,0,0
2782,2782,,1203,0,222,222
2783,2783,,1203,0,208,208
2784,2784,,427,0,4,4
2785,2785,,427,0,260,260
2786,2786,,1203,0,231,231
2787,2787,,1203,0,267,267
2788,2788,,1203,0,37,37
2789,2789,,2072,0,144,144
2790,2790,,406,0,0,0
2791,2791,,427,0,211,211
2792,2792,,427,0,83,83
2793,2793,,427,0,152,152
2794,2794,,1502,0,17,17
2795,2795,,1502,0,4,4
2796,2796,,1502,0,41,41
2797,2797,,427,0,41,41
2798,2798,,1502,0,85,85
2799,2799,,2072,0,211,211
2800,2800,,421,0,89,89
2801,2801,,407,0,0,0
2802,2802,,408,0,31,31
2803,2803,,409,0,0,0
2804,2804,,427,1,17,18
2805,2805,,1502,0,20,20
2806,2806,,427,0,6,6
2807,2807,,1502,0,89,89
2808,2808,,427,0,162,162
2809,2809,,2072,0,545,545
2810,2810,,1502,0,89,89
2811,2811,,427,0,122,122
2812,2812,,427,0,171,171
2813,2813,,427,0,107,107
2814,2814,,427,0,17,17
2815,2815,,46,0,197,197
2816,2816,,46,96,0,96
2817,2817,,427,0,16,16
2818,2818,,427,0,108,108
2819,2819,,410,0,53,53
2820,2820,,427,0,15,15
2821,2821,,1502,0,79,79
2822,2822,,1502,0,75,75
2823,2823,,427,0,42,42
2824,2824,,421,0,155,155
2825,2825,,421,162,0,162
2826,2826,,807,0,9,9
2827,2827,,1502,0,65,65
2828,2828,,427,0,213,213
2829,2829,,1998,0,2,2
2830,2830,,1502,0,14,14
2831,2831,,427,0,26,26
2832,2832,,427,0,161,161
2833,2833,,1998,0,88,88
2834,2834,,421,0,33,33
2835,2835,,411,0,0,0
2836,2836,,2072,0,265,265
2837,2837,,427,0,151,151
2838,2838,,1203,0,1,1
2839,2839,,412,0,0,0
2840,2840,,413,0,0,0
2841,2841,,427,0,10,10
2842,2842,,414,0,0,0
2843,2843,,415,0,0,0
2844,2844,,416,0,0,0
2845,2845,,2110,0,388,388
2846,2846,,1502,0,14,14
2847,2847,,417,0,0,0
2848,2848,,1998,0,422,422
2849,2849,,1502,0,56,56
2850,2850,,1502,34,0,34
2851,2851,,427,0,19,19
2852,2852,,1985,0,183,183
2853,2853,,2096,0,21,21
2854,2854,,421,0,28,28
2855,2855,,1502,0,16,16
2856,2856,,1502,0,34,34
2857,2857,,1502,0,28,28
2858,2858,,421,0,166,166
2859,2859,,1502,0,1,1
2860,2860,,555,0,3,3
2861,2861,,418,0,0,0
2862,2862,,158,0,50,50
2863,2863,,427,0,2,2
2864,2864,,427,0,207,207
2865,2865,,807,0,69,69
2866,2866,,419,0,0,0
2867,2867,,427,0,205,205
2868,2868,,46,0,34,34
2869,2869,,420,0,0,0
2870,2870,,1214,0,2,2
2871,2871,,1214,3,0,3
2872,2872,,421,0,136,136
2873,2873,,427,0,22,22
2874,2874,,427,0,219,219
2875,2875,,1502,0,40,40
2876,2876,,422,0,0,0
2877,2877,,1502,0,89,89
2878,2878,,423,0,0,0
2879,2879,,427,0,1,1
2880,2880,,427,0,114,114
2881,2881,,1502,0,21,21
2882,2882,,424,0,0,0
2883,2883,,427,0,224,224
2884,2884,,425,0,0,0
2885,2885,,421,0,128,128
2886,2886,,1602,0,307,307
2887,2887,,1602,56,0,56
2888,2888,,1502,0,7,7
2889,2889,,426,0,0,0
2890,2890,,427,0,28,28
2891,2891,,421,0,82,82
2892,2892,,427,0,59,59
2893,2893,,427,0,8,8
2894,2894,,427,0,214,214
2895,2895,,427,0,124,124
2896,2896,,427,0,43,43
2897,2897,,427,0,215,215
2898,2898,,427,0,70,70
2899,2899,,421,0,135,135
2900,2900,,1502,0,10,10
2901,2901,,1502,0,78,78
2902,2902,,1502,0,48,48
2903,2903,,1602,0,424,424
2904,2904,,427,0,26,26
2905,2905,,421,0,88,88
2906,2906,,1502,0,1,1
2907,2907,,421,0,13,13
2908,2908,,421,0,86,86
2909,2909,,427,0,421,421
2910,2910,,1502,0,12,12
2911,2911,,427,0,652,652
2912,2912,,427,116,0,116
2913,2913,,427,0,46,46
2914,2914,,1502,0,2,2
2915,2915,,428,0,0,0
2916,2916,,427,0,124,124
2917,2917,,427,0,320,320
2918,2918,,2039,0,1,1
2919,2919,,1502,0,14,14
2920,2920,,1502,182,0,182
2921,2921,,1502,268,0,268
2922,2922,,2110,200,0,200
2923,2923,,427,0,32,32
2924,2924,,427,528,0,528
2925,2925,,1214,0,323,323
2926,2926,,1214,102,0,102
2927,2927,,2110,0,47,47
2928,2928,,2110,214,0,214
2929,2929,,427,30,0,30
2930,2930,,2110,12,0,12
2931,2931,,2110,13,0,13
2932,2932,,427,23,0,23
2933,2933,,1998,0,34,34
2934,2934,,1998,33,0,33
2935,2935,,1985,885,0,885
2936,2936,,158,0,35,35
2937,2937,,1985,0,11,11
2938,2938,,1502,135,0,135
2939,2939,,1985,525,0,525
2940,2940,,427,291,0,291
2941,2941,,427,0,212,212
2942,2942,,427,178,0,178
2943,2943,,1214,0,18,18
2944,2944,,1214,9,0,9
2945,2945,,1499,0,238,238
2946,2946,,1499,601,0,601
2947,2947,,1502,85,0,85
2948,2948,,1502,5,0,5
2949,2949,,1502,183,0,183
2950,2950,,1985,0,58,58
2951,2951,,1985,1156,0,1156
2952,2952,,1985,608,0,608
2953,2953,,1985,0,46,46
2954,2954,,2110,42,0,42
2955,2955,,1985,341,0,341
2956,2956,,2074,177,0,177
2957,2957,,1985,35,0,35
2958,2958,,807,31,0,31
2959,2959,,427,0,4,4
2960,2960,,429,0,0,0
2961,2961,,443,19,0,19
2962,2962,,2110,0,30,30
2963,2963,,2110,88,0,88
2964,2964,,427,0,2,2
2965,2965,,427,3,0,3
2966,2966,,1985,741,0,741
2967,2967,,2063,0,195,195
2968,2968,,2063,202,0,202
2969,2969,,430,0,0,0
2970,2970,,431,0,0,0
2971,2971,,1502,10,0,10
2972,2972,,427,0,38,38
2973,2973,,427,1,11,12
2974,2974,,2074,0,3,3
2975,2975,,2074,387,0,387
2976,2976,,427,0,26,26
2977,2977,,2110,579,0,579
2978,2978,,427,0,38,38
2979,2979,,427,0,37,37
2980,2980,,1985,0,22,22
2981,2981,,1985,395,0,395
2982,2982,,1985,1089,0,1089
2983,2983,,1502,7,0,7
2984,2984,,1499,0,148,148
2985,2985,,1499,0,90,90
2986,2986,,1499,16,0,16
2987,2987,,432,0,0,0
2988,2988,,1502,0,3,3
2989,2989,,1502,643,0,643
2990,2990,,1214,0,271,271
2991,2991,,427,0,184,184
2992,2992,,427,174,0,174
2993,2993,,1985,0,214,214
2994,2994,,1985,5,0,5
2995,2995,,1985,213,0,213
2996,2996,,1214,516,0,516
2997,2997,,427,356,0,356
2998,2998,,3289,0,10,10
2999,2999,,3289,42,0,42
3000,3000,,1502,0,16,16
3001,3001,,1502,35,0,35
3002,3002,,1502,27,0,27
3003,3003,,427,0,3,3
3004,3004,,1985,0,37,37
3005,3005,,1985,37,0,37
3006,3006,,1502,0,3,3
3007,3007,,2063,185,0,185
3008,3008,,1502,0,1,1
3009,3009,,2110,4,0,4
3010,3010,,1499,0,30,30
3011,3011,,427,0,10,10
3012,3012,,427,27,0,27
3013,3013,,427,5,0,5
3014,3014,,427,42,0,42
3015,3015,,427,6,0,6
3016,3016,,427,8,0,8
3017,3017,,443,14,0,14
3018,3018,,2110,0,169,169
3019,3019,,2110,3,0,3
3020,3020,,1502,0,172,172
3021,3021,,427,0,28,28
3022,3022,,433,0,0,0
3023,3023,,1985,3130,0,3130
3024,3024,,1602,0,46,46
3025,3025,,1985,0,25,25
3026,3026,,1985,153,0,153
3027,3027,,2110,417,0,417
3028,3028,,2110,10,0,10
3029,3029,,1839,0,47,47
3030,3030,,1839,213,0,213
3031,3031,,434,0,0,0
3032,3032,,427,0,153,153
3033,3033,,1985,0,13,13
3034,3034,,2110,0,126,126
3035,3035,,1502,0,20,20
3036,3036,,427,0,14,14
3037,3037,,435,0,0,0
3038,3038,,443,0,194,194
3039,3039,,443,199,0,199
3040,3040,,1985,0,561,561
3041,3041,,2074,0,7,7
3042,3042,,1974,29,0,29
3043,3043,,1974,111,0,111
3044,3044,,1985,0,170,170
3045,3045,,1985,152,0,152
3046,3046,,2110,0,189,189
3047,3047,,443,0,32,32
3048,3048,,443,32,0,32
3049,3049,,1502,0,23,23
3050,3050,,427,0,38,38
3051,3051,,427,0,16,16
3052,3052,,427,3,0,3
3053,3053,,1974,0,250,250
3054,3054,,1974,106,0,106
3055,3055,,1974,0,37,37
3056,3056,,427,48,0,48
3057,3057,,1499,0,196,196
3058,3058,,1499,218,0,218
3059,3059,,427,0,39,39
3060,3060,,427,181,0,181
3061,3061,,1974,0,76,76
3062,3062,,427,0,12,12
3063,3063,,427,0,13,13
3064,3064,,1974,0,257,257
3065,3065,,427,0,71,71
3066,3066,,1985,0,420,420
3067,3067,,436,0,0,0
3068,3068,,2110,0,201,201
3069,3069,,1985,0,55,55
3070,3070,,437,0,0,0
3071,3071,,1985,0,9,9
3072,3072,,1985,25,0,25
3073,3073,,2110,38,0,38
3074,3074,,1502,195,0,195
3075,3075,,1974,0,75,75
3076,3076,,1839,0,384,384
3077,3077,,1839,185,0,185
3078,3078,,1602,41,0,41
3079,3079,,427,0,15,15
3080,3080,,807,0,23,23
3081,3081,,807,237,0,237
3082,3082,,807,0,265,265
3083,3083,,807,285,0,285
3084,3084,,807,0,211,211
3085,3085,,807,161,0,161
3086,3086,,1974,0,201,201
3087,3087,,1974,1177,0,1177
3088,3088,,438,0,0,0
3089,3089,,1602,212,0,212
3090,3090,,1974,0,82,82
3091,3091,,439,0,0,0
3092,3092,,807,0,75,75
3093,3093,,1974,0,207,207
3094,3094,,807,0,25,25
3095,3095,,807,456,0,456
3096,3096,,807,0,35,35
3097,3097,,2048,0,211,211
3098,3098,,2048,575,0,575
3099,3099,,807,0,42,42
3100,3100,,807,39,0,39
3101,3101,,509,0,212,212
3102,3102,,509,374,0,374
3103,3103,,807,0,20,20
3104,3104,,807,10,0,10
3105,3105,,1974,0,13,13
3106,3106,,1974,0,206,206
3107,3107,,807,266,0,266
3108,3108,,825,0,35,35
3109,3109,,825,34,0,34
3110,3110,,440,0,0,0
3111,3111,,1602,77,0,77
3112,3112,,1502,7,0,7
3113,3113,,509,0,176,176
3114,3114,,1502,0,3,3
3115,3115,,807,0,26,26
3116,3116,,441,0,0,0
3117,3117,,2048,0,212,212
3118,3118,,2048,281,0,281
3119,3119,,442,0,0,0
3120,3120,,447,211,0,211
3121,3121,,807,0,17,17
3122,3122,,443,0,211,211
3123,3123,,443,224,0,224
3124,3124,,444,0,0,0
3125,3125,,2048,0,213,213
3126,3126,,807,0,8,8
3127,3127,,1502,0,1,1
3128,3128,,1499,44,0,44
3129,3129,,1499,193,0,193
3130,3130,,509,0,85,85
3131,3131,,509,37,0,37
3132,3132,,981,0,47,47
3133,3133,,981,94,0,94
3134,3134,,1499,0,212,212
3135,3135,,46,0,285,285
3136,3136,,46,229,0,229
3137,3137,,1499,41,0,41
3138,3138,,1602,0,22,22
3139,3139,,1602,7,0,7
3140,3140,,807,0,13,13
3141,3141,,1974,0,60,60
3142,3142,,509,0,37,37
3143,3143,,1974,0,216,216
3144,3144,,1974,0,121,121
3145,3145,,445,0,0,0
3146,3146,,446,0,0,0
3147,3147,,807,0,13,13
3148,3148,,447,0,211,211
3149,3149,,448,0,0,0
3150,3150,,807,0,21,21
3151,3151,,807,0,3,3
3152,3152,,449,0,0,0
3153,3153,,1602,71,0,71
3154,3154,,645,0,2,2
3155,3155,,807,0,72,72
3156,3156,,807,0,12,12
3157,3157,,807,0,136,136
3158,3158,,1974,0,38,38
3159,3159,,1974,0,68,68
3160,3160,,2048,0,212,212
3161,3161,,807,8,0,8
3162,3162,,1499,0,19,19
3163,3163,,964,0,16,16
3164,3164,,1974,5,0,5
3165,3165,,509,15,0,15
3166,3166,,1974,0,233,233
3167,3167,,807,0,9,9
3168,3168,,807,0,15,15
3169,3169,,807,11,0,11
3170,3170,,1974,0,68,68
3171,3171,,807,0,1,1
3172,3172,,2110,0,211,211
3173,3173,,807,0,26,26
3174,3174,,807,0,11,11
3175,3175,,46,0,55,55
3176,3176,,981,0,76,76
3177,3177,,807,0,40,40
3178,3178,,1974,0,100,100
3179,3179,,509,0,14,14
3180,3180,,807,0,45,45
3181,3181,,825,0,19,19
3182,3182,,807,0,27,27
3183,3183,,6,0,211,211
3184,3184,,46,0,211,211
3185,3185,,1203,0,143,143
3186,3186,,1502,0,161,161
3187,3187,,158,0,268,268
3188,3188,,261,0,32,32
3189,3189,,261,0,198,198
3190,3190,,261,0,221,221
3191,3191,,46,0,82,82
3192,3192,,1502,0,158,158
3193,3193,,1502,0,223,223
3194,3194,,1998,0,46,46
3195,3195,,1998,147,0,147
3196,3196,,2048,0,2,2
3197,3197,,158,0,88,88
3198,3198,,1602,0,212,212
3199,3199,,1602,51,0,51
3200,3200,,158,0,128,128
3201,3201,,1502,1,41,42
3202,3202,,3289,0,25,25
3203,3203,,2074,0,1,1
3204,3204,,1602,0,125,125
3205,3205,,158,0,66,66
3206,3206,,261,0,229,229
3207,3207,,1203,0,11,11
3208,3208,,261,0,212,212
3209,3209,,46,0,203,203
3210,3210,,261,0,11,11
3211,3211,,261,0,224,224
3212,3212,,46,0,13,13
3213,3213,,1203,0,12,12
3214,3214,,261,0,222,222
3215,3215,,1985,1,99,100
3216,3216,,1502,0,211,211
3217,3217,,46,0,140,140
3218,3218,,261,0,276,276
3219,3219,,46,0,213,213
3220,3220,,261,0,80,80
3221,3221,,261,1,133,134
3222,3222,,1602,0,12,12
3223,3223,,450,0,0,0
3224,3224,,1203,0,212,212
3225,3225,,1502,0,357,357
3226,3226,,46,0,10,10
3227,3227,,46,0,139,139
3228,3228,,1203,0,211,211
3229,3229,,46,0,34,34
3230,3230,,1203,0,211,211
3231,3231,,46,0,212,212
3232,3232,,46,0,213,213
3233,3233,,2110,1,189,190
3234,3234,,1602,0,13,13
3235,3235,,1602,0,26,26
3236,3236,,1985,0,379,379
3237,3237,,1203,0,212,212
3238,3238,,1602,0,164,164
3239,3239,,1602,0,212,212
3240,3240,,451,0,0,0
3241,3241,,46,0,43,43
3242,3242,,261,0,215,215
3243,3243,,452,0,0,0
3244,3244,,467,0,4,4
3245,3245,,467,222,0,222
3246,3246,,456,0,63,63
3247,3247,,456,1125,0,1125
3248,3248,,456,0,8,8
3249,3249,,456,241,0,241
3250,3250,,456,0,137,137
3251,3251,,456,0,65,65
3252,3252,,456,1064,0,1064
3253,3253,,453,0,0,0
3254,3254,,467,0,70,70
3255,3255,,467,4798,0,4798
3256,3256,,467,0,22,22
3257,3257,,454,0,0,0
3258,3258,,456,56,0,56
3259,3259,,455,0,0,0
3260,3260,,456,0,25,25
3261,3261,,456,27,0,27
3262,3262,,456,0,36,36
3263,3263,,456,247,0,247
3264,3264,,467,0,130,130
3265,3265,,456,0,64,64
3266,3266,,456,115,0,115
3267,3267,,456,171,0,171
3268,3268,,427,8,3,11
3269,3269,,467,811,0,811
3270,3270,,456,0,21,21
3271,3271,,456,53,0,53
3272,3272,,467,0,113,113
3273,3273,,467,0,4,4
3274,3274,,456,0,35,35
3275,3275,,467,0,300,300
3276,3276,,467,0,216,216
3277,3277,,456,0,81,81
3278,3278,,467,0,159,159
3279,3279,,456,0,51,51
3280,3280,,456,77,0,77
3281,3281,,456,0,89,89
3282,3282,,456,0,66,66
3283,3283,,467,0,223,223
3284,3284,,456,0,36,36
3285,3285,,456,0,51,51
3286,3286,,456,0,16,16
3287,3287,,467,0,11,11
3288,3288,,456,0,36,36
3289,3289,,456,0,67,67
3290,3290,,456,0,63,63
3291,3291,,456,0,23,23
3292,3292,,456,0,49,49
3293,3293,,458,0,132,132
3294,3294,,458,193,0,193
3295,3295,,467,0,143,143
3296,3296,,467,0,126,126
3297,3297,,456,0,68,68
3298,3298,,456,0,120,120
3299,3299,,456,0,2,2
3300,3300,,467,0,38,38
3301,3301,,456,0,31,31
3302,3302,,456,0,54,54
3303,3303,,456,0,25,25
3304,3304,,467,0,18,18
3305,3305,,467,0,163,163
3306,3306,,456,0,91,91
3307,3307,,456,0,14,14
3308,3308,,456,56,0,56
3309,3309,,467,0,81,81
3310,3310,,456,0,96,96
3311,3311,,456,0,38,38
3312,3312,,467,0,112,112
3313,3313,,456,0,4,4
3314,3314,,456,3,0,3
3315,3315,,456,0,9,9
3316,3316,,456,0,44,44
3317,3317,,456,0,54,54
3318,3318,,467,0,223,223
3319,3319,,467,0,77,77
3320,3320,,456,0,68,68
3321,3321,,467,0,50,50
3322,3322,,457,0,0,0
3323,3323,,467,0,4,4
3324,3324,,456,0,73,73
3325,3325,,458,0,184,184
3326,3326,,458,193,0,193
3327,3327,,456,0,37,37
3328,3328,,467,0,75,75
3329,3329,,467,0,141,141
3330,3330,,456,0,92,92
3331,3331,,467,0,19,19
3332,3332,,456,0,34,34
3333,3333,,456,72,0,72
3334,3334,,456,0,133,133
3335,3335,,459,0,22,22
3336,3336,,459,22,0,22
3337,3337,,456,0,62,62
3338,3338,,467,0,11,11
3339,3339,,467,0,144,144
3340,3340,,467,0,46,46
3341,3341,,456,0,45,45
3342,3342,,456,0,35,35
3343,3343,,460,0,0,0
3344,3344,,467,0,126,126
3345,3345,,461,0,0,0
3346,3346,,467,0,4,4
3347,3347,,456,0,64,64
3348,3348,,456,0,46,46
3349,3349,,462,0,0,0
3350,3350,,456,0,60,60
3351,3351,,467,0,7,7
3352,3352,,467,0,16,16
3353,3353,,456,0,8,8
3354,3354,,467,0,91,91
3355,3355,,456,0,54,54
3356,3356,,463,0,0,0
3357,3357,,467,0,306,306
3358,3358,,464,0,0,0
3359,3359,,456,0,66,66
3360,3360,,467,0,60,60
3361,3361,,467,0,59,59
3362,3362,,467,0,112,112
3363,3363,,456,0,70,70
3364,3364,,465,0,0,0
3365,3365,,468,86,0,86
3366,3366,,466,0,0,0
3367,3367,,456,0,26,26
3368,3368,,456,0,29,29
3369,3369,,456,0,33,33
3370,3370,,456,0,26,26
3371,3371,,467,0,159,159
3372,3372,,456,0,21,21
3373,3373,,458,0,70,70
3374,3374,,467,0,395,395
3375,3375,,467,0,88,88
3376,3376,,467,0,20,20
3377,3377,,467,0,14,14
3378,3378,,456,0,62,62
3379,3379,,467,0,151,151
3380,3380,,467,0,220,220
3381,3381,,467,0,28,28
3382,3382,,467,0,15,15
3383,3383,,456,0,55,55
3384,3384,,456,28,0,28
3385,3385,,467,0,169,169
3386,3386,,456,0,65,65
3387,3387,,456,0,68,68
3388,3388,,467,0,3,3
3389,3389,,468,0,23,23
3390,3390,,467,0,201,201
3391,3391,,456,0,22,22
3392,3392,,467,0,400,400
3393,3393,,456,0,9,9
3394,3394,,456,0,68,68
3395,3395,,456,0,39,39
3396,3396,,456,0,33,33
3397,3397,,467,0,14,14
3398,3398,,467,0,4,4
3399,3399,,456,0,63,63
3400,3400,,456,0,24,24
3401,3401,,468,0,63,63
3402,3402,,456,0,8,8
3403,3403,,467,0,7,7
3404,3404,,456,0,48,48
3405,3405,,456,0,35,35
3406,3406,,467,0,206,206
3407,3407,,469,0,0,0
3408,3408,,470,0,0,0
3409,3409,,456,0,179,179
3410,3410,,456,0,50,50
3411,3411,,467,0,128,128
3412,3412,,467,0,42,42
3413,3413,,456,0,40,40
3414,3414,,1214,0,14,14
3415,3415,,1214,31,0,31
3416,3416,,1214,5,0,5
3417,3417,,471,0,0,0
3418,3418,,472,0,0,0
3419,3419,,568,4,0,4
3420,3420,,760,0,167,167
3421,3421,,760,47,0,47
3422,3422,,760,25,0,25
3423,3423,,760,311,0,311
3424,3424,,760,10,0,10
3425,3425,,261,0,18,18
3426,3426,,261,16,0,16
3427,3427,,261,21,0,21
3428,3428,,261,11,0,11
3429,3429,,261,3,0,3
3430,3430,,261,5,0,5
3431,3431,,427,585,0,585
3432,3432,,473,0,0,0
3433,3433,,1214,12,0,12
3434,3434,,509,0,46,46
3435,3435,,509,28,0,28
3436,3436,,509,22,0,22
3437,3437,,509,1198,0,1198
3438,3438,,509,8,0,8
3439,3439,,509,15,0,15
3440,3440,,474,0,0,0
3441,3441,,1214,26,0,26
3442,3442,,509,2,0,2
3443,3443,,46,0,13,13
3444,3444,,46,352,0,352
3445,3445,,475,0,0,0
3446,3446,,2096,4,0,4
3447,3447,,2096,460,0,460
3448,3448,,1203,34,0,34
3449,3449,,1203,3,0,3
3450,3450,,807,319,0,319
3451,3451,,476,0,0,0
3452,3452,,509,8,0,8
3453,3453,,477,0,0,0
3454,3454,,478,0,0,0
3455,3455,,479,0,0,0
3456,3456,,480,0,0,0
3457,3457,,481,0,0,0
3458,3458,,482,0,0,0
3459,3459,,509,0,18,18
3460,3460,,509,2,0,2
3461,3461,,509,4,0,4
3462,3462,,509,10,0,10
3463,3463,,509,19,0,19
3464,3464,,509,3,0,3
3465,3465,,964,0,16,16
3466,3466,,964,13,0,13
3467,3467,,964,8,0,8
3468,3468,,46,34,0,34
3469,3469,,46,8,0,8
3470,3470,,427,6,0,6
3471,3471,,483,0,0,0
3472,3472,,509,2,0,2
3473,3473,,484,0,0,0
3474,3474,,1502,0,18,18
3475,3475,,1502,117,0,117
3476,3476,,1502,21,0,21
3477,3477,,760,0,11,11
3478,3478,,760,3,0,3
3479,3479,,760,16,0,16
3480,3480,,485,0,0,0
3481,3481,,509,130,0,130
3482,3482,,486,0,0,0
3483,3483,,487,0,211,211
3484,3484,,487,211,0,211
3485,3485,,488,0,0,0
3486,3486,,489,0,0,0
3487,3487,,1502,147,0,147
3488,3488,,723,0,17,17
3489,3489,,723,27,0,27
3490,3490,,509,0,9,9
3491,3491,,509,38,0,38
3492,3492,,509,5,0,5
3493,3493,,427,8,0,8
3494,3494,,1214,0,2,2
3495,3495,,1214,627,0,627
3496,3496,,1214,411,0,411
3497,3497,,490,0,0,0
3498,3498,,427,372,0,372
3499,3499,,1499,0,10,10
3500,3500,,1499,11,0,11
3501,3501,,1499,9,0,9
3502,3502,,491,0,0,0
3503,3503,,492,0,0,0
3504,3504,,509,16,0,16
3505,3505,,509,11,0,11
3506,3506,,509,3,0,3
3507,3507,,509,7,0,7
3508,3508,,509,0,16,16
3509,3509,,509,59,0,59
3510,3510,,509,13,0,13
3511,3511,,509,0,49,49
3512,3512,,509,26,0,26
3513,3513,,509,21,0,21
3514,3514,,509,11,0,11
3515,3515,,509,5,0,5
3516,3516,,509,8,0,8
3517,3517,,509,0,59,59
3518,3518,,509,13,0,13
3519,3519,,509,24,0,24
3520,3520,,509,3,0,3
3521,3521,,509,0,23,23
3522,3522,,509,0,5,5
3523,3523,,509,14,0,14
3524,3524,,509,13,0,13
3525,3525,,509,0,37,37
3526,3526,,509,17,0,17
3527,3527,,509,0,5,5
3528,3528,,509,0,33,33
3529,3529,,509,5,0,5
3530,3530,,509,4,0,4
3531,3531,,509,0,25,25
3532,3532,,509,6,0,6
3533,3533,,493,0,0,0
3534,3534,,509,0,23,23
3535,3535,,494,0,0,0
3536,3536,,509,0,23,23
3537,3537,,509,10,0,10
3538,3538,,509,0,27,27
3539,3539,,509,4,0,4
3540,3540,,509,0,36,36
3541,3541,,495,0,0,0
3542,3542,,496,0,0,0
3543,3543,,520,2,0,2
3544,3544,,509,33,0,33
3545,3545,,509,13,0,13
3546,3546,,509,23,0,23
3547,3547,,509,0,28,28
3548,3548,,509,7,0,7
3549,3549,,497,0,0,0
3550,3550,,498,0,0,0
3551,3551,,499,0,0,0
3552,3552,,500,0,0,0
3553,3553,,509,0,11,11
3554,3554,,509,0,18,18
3555,3555,,509,11,0,11
3556,3556,,509,0,31,31
3557,3557,,509,3,0,3
3558,3558,,509,4,0,4
3559,3559,,509,2,0,2
3560,3560,,509,0,49,49
3561,3561,,509,9,0,9
3562,3562,,509,0,5,5
3563,3563,,501,0,0,0
3564,3564,,1218,0,10,10
3565,3565,,1218,17,0,17
3566,3566,,1218,0,9,9
3567,3567,,509,0,10,10
3568,3568,,502,0,0,0
3569,3569,,1218,0,2,2
3570,3570,,503,0,0,0
3571,3571,,504,0,0,0
3572,3572,,505,0,0,0
3573,3573,,506,0,0,0
3574,3574,,507,0,0,0
3575,3575,,509,0,7,7
3576,3576,,508,0,0,0
3577,3577,,509,0,211,211
3578,3578,,510,0,0,0
3579,3579,,509,0,32,32
3580,3580,,509,17,0,17
3581,3581,,509,0,5,5
3582,3582,,509,0,63,63
3583,3583,,509,2,0,2
3584,3584,,964,0,33,33
3585,3585,,964,16,0,16
3586,3586,,964,16,0,16
3587,3587,,964,283,0,283
3588,3588,,964,2,0,2
3589,3589,,511,0,0,0
3590,3590,,509,0,7,7
3591,3591,,509,4,0,4
3592,3592,,509,4,0,4
3593,3593,,509,0,7,7
3594,3594,,509,0,10,10
3595,3595,,509,6,0,6
3596,3596,,509,5,0,5
3597,3597,,509,0,14,14
3598,3598,,512,0,0,0
3599,3599,,513,0,0,0
3600,3600,,509,0,47,47
3601,3601,,509,26,0,26
3602,3602,,514,0,0,0
3603,3603,,509,0,18,18
3604,3604,,509,2,0,2
3605,3605,,509,4,0,4
3606,3606,,515,0,0,0
3607,3607,,760,0,45,45
3608,3608,,760,4,0,4
3609,3609,,760,23,0,23
3610,3610,,760,21,0,21
3611,3611,,1974,0,12,12
3612,3612,,1974,12,0,12
3613,3613,,509,0,25,25
3614,3614,,516,0,0,0
3615,3615,,517,0,0,0
3616,3616,,760,0,9,9
3617,3617,,509,0,25,25
3618,3618,,509,4,0,4
3619,3619,,509,17,0,17
3620,3620,,760,0,181,181
3621,3621,,509,0,28,28
3622,3622,,509,0,5,5
3623,3623,,1499,239,0,239
3624,3624,,509,0,54,54
3625,3625,,509,5,0,5
3626,3626,,509,0,42,42
3627,3627,,518,0,0,0
3628,3628,,519,0,0,0
3629,3629,,509,0,2,2
3630,3630,,520,0,4,4
3631,3631,,521,0,0,0
3632,3632,,509,0,10,10
3633,3633,,509,0,28,28
3634,3634,,2096,7,0,7
3635,3635,,427,0,8,8
3636,3636,,427,45,0,45
3637,3637,,427,0,11,11
3638,3638,,2101,0,3,3
3639,3639,,2101,25,0,25
3640,3640,,427,0,10,10
3641,3641,,427,7,0,7
3642,3642,,1214,0,13,13
3643,3643,,509,0,8,8
3644,3644,,1214,0,24,24
3645,3645,,1214,30,0,30
3646,3646,,1214,16,0,16
3647,3647,,2072,0,13,13
3648,3648,,2072,31,0,31
3649,3649,,2072,14,0,14
3650,3650,,509,0,58,58
3651,3651,,522,0,0,0
3652,3652,,523,0,0,0
3653,3653,,524,0,0,0
3654,3654,,509,0,7,7
3655,3655,,525,0,0,0
3656,3656,,509,2,0,2
3657,3657,,526,0,0,0
3658,3658,,527,0,0,0
3659,3659,,528,0,0,0
3660,3660,,529,0,2,2
3661,3661,,529,2,0,2
3662,3662,,1214,0,22,22
3663,3663,,509,0,3,3
3664,3664,,807,0,62,62
3665,3665,,1214,6,0,6
3666,3666,,807,43,0,43
3667,3667,,1602,17,0,17
3668,3668,,807,3,0,3
3669,3669,,807,28,0,28
3670,3670,,509,0,3,3
3671,3671,,1214,0,8,8
3672,3672,,1502,0,6,6
3673,3673,,1502,35,0,35
3674,3674,,804,0,4,4
3675,3675,,804,11,0,11
3676,3676,,804,8,0,8
3677,3677,,530,0,0,0
3678,3678,,509,0,44,44
3679,3679,,2101,0,27,27
3680,3680,,2101,51,0,51
3681,3681,,2101,47,0,47
3682,3682,,531,0,0,0
3683,3683,,532,0,0,0
3684,3684,,509,0,5,5
3685,3685,,509,3,0,3
3686,3686,,533,0,0,0
3687,3687,,534,0,0,0
3688,3688,,535,0,0,0
3689,3689,,536,0,0,0
3690,3690,,2072,45,0,45
3691,3691,,1499,0,22,22
3692,3692,,1499,23,0,23
3693,3693,,1499,37,0,37
3694,3694,,1499,24,0,24
3695,3695,,1946,0,31,31
3696,3696,,1946,250,0,250
3697,3697,,1946,24,0,24
3698,3698,,537,0,0,0
3699,3699,,538,0,0,0
3700,3700,,539,0,0,0
3701,3701,,3912,0,1,1
3702,3702,,540,0,0,0
3703,3703,,541,0,0,0
3704,3704,,542,0,0,0
3705,3705,,427,0,8,8
3706,3706,,2110,0,39,39
3707,3707,,2110,214,0,214
3708,3708,,2110,10,0,10
3709,3709,,2096,0,8,8
3710,3710,,2096,869,0,869
3711,3711,,427,44,0,44
3712,3712,,427,5,0,5
3713,3713,,1214,0,18,18
3714,3714,,1214,5,0,5
3715,3715,,1214,39,0,39
3716,3716,,1214,0,23,23
3717,3717,,1214,27,0,27
3718,3718,,1214,0,26,26
3719,3719,,1214,22,0,22
3720,3720,,543,0,0,0
3721,3721,,1214,11,0,11
3722,3722,,544,0,0,0
3723,3723,,545,0,0,0
3724,3724,,546,0,0,0
3725,3725,,547,0,0,0
3726,3726,,825,47,0,47
3727,3727,,1214,0,17,17
3728,3728,,1214,10,0,10
3729,3729,,1214,17,0,17
3730,3730,,548,0,0,0
3731,3731,,1214,7,0,7
3732,3732,,1214,0,4,4
3733,3733,,1214,21,0,21
3734,3734,,1214,11,0,11
3735,3735,,1214,0,4,4
3736,3736,,1214,5,0,5
3737,3737,,1214,31,0,31
3738,3738,,549,0,0,0
3739,3739,,1214,0,23,23
3740,3740,,1214,0,16,16
3741,3741,,1214,13,0,13
3742,3742,,1214,12,0,12
3743,3743,,1214,0,9,9
3744,3744,,1214,0,5,5
3745,3745,,1214,9,0,9
3746,3746,,1214,0,33,33
3747,3747,,1214,11,0,11
3748,3748,,2072,0,4,4
3749,3749,,46,0,4,4
3750,3750,,1214,3,0,3
3751,3751,,1214,0,17,17
3752,3752,,1214,10,0,10
3753,3753,,1214,0,8,8
3754,3754,,1214,0,18,18
3755,3755,,1214,0,29,29
3756,3756,,1214,0,18,18
3757,3757,,1214,27,0,27
3758,3758,,1214,0,5,5
3759,3759,,1214,0,9,9
3760,3760,,1214,7,0,7
3761,3761,,1214,0,7,7
3762,3762,,1214,25,0,25
3763,3763,,1214,0,4,4
3764,3764,,1214,7,0,7
3765,3765,,1214,11,0,11
3766,3766,,1214,0,19,19
3767,3767,,1214,4,0,4
3768,3768,,1214,31,0,31
3769,3769,,1214,0,15,15
3770,3770,,1214,0,13,13
3771,3771,,1214,16,0,16
3772,3772,,2072,0,2,2
3773,3773,,1214,0,5,5
3774,3774,,1214,10,0,10
3775,3775,,550,0,0,0
3776,3776,,551,0,0,0
3777,3777,,552,0,0,0
3778,3778,,1214,0,6,6
3779,3779,,1214,12,0,12
3780,3780,,1214,0,7,7
3781,3781,,1502,35,0,35
3782,3782,,3289,0,19,19
3783,3783,,553,0,0,0
3784,3784,,1214,0,18,18
3785,3785,,1214,111,0,111
3786,3786,,1214,9,0,9
3787,3787,,554,0,4,4
3788,3788,,554,3,0,3
3789,3789,,554,2,0,2
3790,3790,,699,0,422,422
3791,3791,,699,1041,0,1041
3792,3792,,509,0,34,34
3793,3793,,509,56,0,56
3794,3794,,509,186,0,186
3795,3795,,1214,0,24,24
3796,3796,,1214,8,0,8
3797,3797,,1214,22,0,22
3798,3798,,1214,0,10,10
3799,3799,,1214,0,9,9
3800,3800,,1214,16,0,16
3801,3801,,555,0,2,2
3802,3802,,555,7,0,7
3803,3803,,556,0,0,0
3804,3804,,582,2,0,2
3805,3805,,557,0,0,0
3806,3806,,1214,0,10,10
3807,3807,,1214,0,15,15
3808,3808,,427,0,6,6
3809,3809,,1214,0,23,23
3810,3810,,1214,63,0,63
3811,3811,,1214,37,0,37
3812,3812,,427,0,66,66
3813,3813,,558,0,0,0
3814,3814,,509,0,19,19
3815,3815,,1214,0,21,21
3816,3816,,1985,0,1,1
3817,3817,,626,2,0,2
3818,3818,,559,0,9,9
3819,3819,,559,9,0,9
3820,3820,,560,0,0,0
3821,3821,,755,21,0,21
3822,3822,,755,88,0,88
3823,3823,,561,0,0,0
3824,3824,,2062,25,0,25
3825,3825,,2062,1,0,1
3826,3826,,1214,0,182,182
3827,3827,,1214,0,6,6
3828,3828,,1214,0,11,11
3829,3829,,1214,0,5,5
3830,3830,,1214,0,3,3
3831,3831,,1214,0,8,8
3832,3832,,1214,5,0,5
3833,3833,,1214,0,23,23
3834,3834,,1214,0,14,14
3835,3835,,1214,36,0,36
3836,3836,,562,0,0,0
3837,3837,,881,4,0,4
3838,3838,,881,2,0,2
3839,3839,,1214,0,10,10
3840,3840,,579,0,1,1
3841,3841,,579,11,0,11
3842,3842,,563,0,0,0
3843,3843,,699,0,211,211
3844,3844,,1214,0,8,8
3845,3845,,1214,0,22,22
3846,3846,,1214,12,0,12
3847,3847,,1214,15,0,15
3848,3848,,1214,0,11,11
3849,3849,,964,0,5,5
3850,3850,,564,0,0,0
3851,3851,,565,0,0,0
3852,3852,,2072,0,6,6
3853,3853,,2072,4,0,4
3854,3854,,723,25,0,25
3855,3855,,723,20,0,20
3856,3856,,427,0,5,5
3857,3857,,566,0,26,26
3858,3858,,566,26,0,26
3859,3859,,1214,0,8,8
3860,3860,,1214,12,0,12
3861,3861,,1214,13,0,13
3862,3862,,1214,0,6,6
3863,3863,,1214,7,0,7
3864,3864,,1499,2,1,3
3865,3865,,1499,5,0,5
3866,3866,,1502,0,151,151
3867,3867,,1214,0,24,24
3868,3868,,1214,0,8,8
3869,3869,,1214,24,0,24
3870,3870,,981,5,0,5
3871,3871,,567,0,0,0
3872,3872,,981,5,0,5
3873,3873,,981,4,0,4
3874,3874,,568,0,4,4
3875,3875,,807,10,0,10
3876,3876,,569,0,0,0
3877,3877,,839,15,0,15
3878,3878,,1214,0,26,26
3879,3879,,570,0,0,0
3880,3880,,1214,0,19,19
3881,3881,,509,0,31,31
3882,3882,,571,0,0,0
3883,3883,,1985,3,0,3
3884,3884,,572,0,0,0
3885,3885,,573,0,0,0
3886,3886,,574,0,0,0
3887,3887,,575,0,0,0
3888,3888,,1214,0,20,20
3889,3889,,509,0,27,27
3890,3890,,1214,0,21,21
3891,3891,,1214,2,0,2
3892,3892,,576,0,4,4
3893,3893,,576,4,0,4
3894,3894,,1214,0,30,30
3895,3895,,1214,11,0,11
3896,3896,,1214,27,0,27
3897,3897,,645,1,0,1
3898,3898,,645,9,0,9
3899,3899,,577,0,0,0
3900,3900,,1946,0,54,54
3901,3901,,1946,17,0,17
3902,3902,,1946,2,0,2
3903,3903,,1499,0,24,24
3904,3904,,578,0,0,0
3905,3905,,1214,0,17,17
3906,3906,,427,2,0,2
3907,3907,,579,0,5,5
3908,3908,,579,4,0,4
3909,3909,,2096,0,19,19
3910,3910,,2096,13,0,13
3911,3911,,580,0,0,0
3912,3912,,581,0,0,0
3913,3913,,1214,0,18,18
3914,3914,,1214,0,8,8
3915,3915,,1998,0,19,19
3916,3916,,1998,56,0,56
3917,3917,,582,0,4,4
3918,3918,,582,2,0,2
3919,3919,,583,0,0,0
3920,3920,,584,0,0,0
3921,3921,,585,0,0,0
3922,3922,,1502,56,0,56
3923,3923,,3912,0,201,201
3924,3924,,1214,0,8,8
3925,3925,,1214,16,0,16
3926,3926,,869,0,174,174
3927,3927,,869,14,0,14
3928,3928,,869,187,0,187
3929,3929,,755,0,36,36
3930,3930,,427,0,34,34
3931,3931,,1214,0,4,4
3932,3932,,1214,9,0,9
3933,3933,,586,0,0,0
3934,3934,,587,0,0,0
3935,3935,,2096,0,19,19
3936,3936,,1214,0,8,8
3937,3937,,1214,46,0,46
3938,3938,,588,0,4,4
3939,3939,,588,4,0,4
3940,3940,,2072,0,2,2
3941,3941,,1214,0,6,6
3942,3942,,1946,0,13,13
3943,3943,,1946,0,36,36
3944,3944,,1946,0,42,42
3945,3945,,1946,7,0,7
3946,3946,,1214,0,16,16
3947,3947,,869,0,12,12
3948,3948,,869,23,0,23
3949,3949,,1214,7,0,7
3950,3950,,1214,14,0,14
3951,3951,,964,0,31,31
3952,3952,,964,20,0,20
3953,3953,,964,6,0,6
3954,3954,,964,0,9,9
3955,3955,,2110,0,1,1
3956,3956,,2110,222,0,222
3957,3957,,589,0,0,0
3958,3958,,590,0,0,0
3959,3959,,591,0,0,0
3960,3960,,592,0,10,10
3961,3961,,592,10,0,10
3962,3962,,869,0,51,51
3963,3963,,869,57,0,57
3964,3964,,427,0,4,4
3965,3965,,593,0,4,4
3966,3966,,593,4,0,4
3967,3967,,594,0,0,0
3968,3968,,595,0,0,0
3969,3969,,1214,0,4,4
3970,3970,,2110,0,27,27
3971,3971,,2110,15,0,15
3972,3972,,2110,18,0,18
3973,3973,,2110,5,0,5
3974,3974,,596,0,0,0
3975,3975,,807,6,0,6
3976,3976,,807,6,0,6
3977,3977,,807,2,0,2
3978,3978,,807,1,0,1
3979,3979,,2110,0,16,16
3980,3980,,2110,5,0,5
3981,3981,,2110,3,0,3
3982,3982,,2110,7,0,7
3983,3983,,2110,3,0,3
3984,3984,,46,0,2,2
3985,3985,,46,10,0,10
3986,3986,,46,7,0,7
3987,3987,,597,0,0,0
3988,3988,,598,0,0,0
3989,3989,,599,0,0,0
3990,3990,,509,0,5,5
3991,3991,,600,0,0,0
3992,3992,,601,0,0,0
3993,3993,,602,0,0,0
3994,3994,,603,0,0,0
3995,3995,,509,0,14,14
3996,3996,,604,0,0,0
3997,3997,,605,0,0,0
3998,3998,,606,0,0,0
3999,3999,,607,0,0,0
4000,4000,,608,0,0,0
4001,4001,,609,0,0,0
4002,4002,,610,0,0,0
4003,4003,,1214,0,14,14
4004,4004,,611,0,0,0
4005,4005,,612,0,16,16
4006,4006,,612,8,0,8
4007,4007,,612,8,0,8
4008,4008,,613,0,0,0
4009,4009,,614,0,0,0
4010,4010,,746,0,12,12
4011,4011,,746,61,0,61
4012,4012,,615,0,0,0
4013,4013,,964,0,20,20
4014,4014,,964,5,0,5
4015,4015,,616,0,29,29
4016,4016,,616,24,0,24
4017,4017,,964,6,0,6
4018,4018,,617,0,0,0
4019,4019,,618,0,19,19
4020,4020,,618,19,0,19
4021,4021,,2063,0,3,3
4022,4022,,2063,7,0,7
4023,4023,,1214,7,0,7
4024,4024,,619,0,0,0
4025,4025,,2101,0,11,11
4026,4026,,2101,5,0,5
4027,4027,,2101,2,0,2
4028,4028,,427,0,30,30
4029,4029,,626,0,9,9
4030,4030,,626,11,0,11
4031,4031,,1214,0,13,13
4032,4032,,1214,11,0,11
4033,4033,,1499,0,14,14
4034,4034,,1499,254,0,254
4035,4035,,1499,12,0,12
4036,4036,,427,0,221,221
4037,4037,,276,0,10,10
4038,4038,,620,0,0,0
4039,4039,,1499,1,0,1
4040,4040,,621,0,0,0
4041,4041,,1214,0,22,22
4042,4042,,1214,16,0,16
4043,4043,,1214,0,15,15
4044,4044,,1214,33,0,33
4045,4045,,622,0,0,0
4046,4046,,1214,0,20,20
4047,4047,,1499,0,6,6
4048,4048,,699,0,188,188
4049,4049,,699,33,0,33
4050,4050,,699,0,86,86
4051,4051,,699,32,0,32
4052,4052,,46,0,21,21
4053,4053,,46,18,0,18
4054,4054,,1499,0,57,57
4055,4055,,1499,13,0,13
4056,4056,,1499,7,0,7
4057,4057,,1214,0,9,9
4058,4058,,1952,0,1,1
4059,4059,,623,0,0,0
4060,4060,,624,0,0,0
4061,4061,,46,0,18,18
4062,4062,,1602,9,0,9
4063,4063,,1602,20,0,20
4064,4064,,760,9,0,9
4065,4065,,625,0,2,2
4066,4066,,625,2,0,2
4067,4067,,427,0,15,15
4068,4068,,1214,0,42,42
4069,4069,,626,0,34,34
4070,4070,,626,30,0,30
4071,4071,,627,0,0,0
4072,4072,,427,5,0,5
4073,4073,,427,0,13,13
4074,4074,,699,0,203,203
4075,4075,,629,0,2,2
4076,4076,,628,0,0,0
4077,4077,,629,2,0,2
4078,4078,,630,0,0,0
4079,4079,,631,0,0,0
4080,4080,,632,0,0,0
4081,4081,,1218,2,0,2
4082,4082,,1214,0,30,30
4083,4083,,2110,0,18,18
4084,4084,,633,0,0,0
4085,4085,,634,0,0,0
4086,4086,,635,0,0,0
4087,4087,,427,3,0,3
4088,4088,,636,0,0,0
4089,4089,,1214,12,0,12
4090,4090,,1499,0,1,1
4091,4091,,810,403,0,403
4092,4092,,2101,0,16,16
4093,4093,,637,0,0,0
4094,4094,,638,0,2,2
4095,4095,,638,1,0,1
4096,4096,,638,1,0,1
4097,4097,,639,0,0,0
4098,4098,,640,0,0,0
4099,4099,,641,0,0,0
4100,4100,,2101,5,0,5
4101,4101,,46,0,20,20
4102,4102,,1214,0,2,2
4103,4103,,1214,212,0,212
4104,4104,,2072,0,4,4
4105,4105,,760,0,20,20
4106,4106,,642,0,0,0
4107,4107,,1974,4,0,4
4108,4108,,643,0,0,0
4109,4109,,1985,0,5,5
4110,4110,,1214,0,9,9
4111,4111,,1214,0,8,8
4112,4112,,1214,8,0,8
4113,4113,,1499,1,0,1
4114,4114,,1214,0,23,23
4115,4115,,1502,0,24,24
4116,4116,,1502,7,0,7
4117,4117,,1502,169,0,169
4118,4118,,1214,0,24,24
4119,4119,,644,0,0,0
4120,4120,,645,0,5,5
4121,4121,,1946,0,39,39
4122,4122,,1946,6,0,6
4123,4123,,1946,3,0,3
4124,4124,,1974,6,0,6
4125,4125,,964,0,5,5
4126,4126,,964,0,4,4
4127,4127,,964,23,0,23
4128,4128,,964,5,0,5
4129,4129,,646,0,0,0
4130,4130,,2101,3,0,3
4131,4131,,1214,0,7,7
4132,4132,,1214,24,0,24
4133,4133,,760,0,2,2
4134,4134,,647,0,14,14
4135,4135,,647,24,0,24
4136,4136,,1499,2,1,3
4137,4137,,1214,0,26,26
4138,4138,,1214,7,0,7
4139,4139,,648,0,0,0
4140,4140,,649,0,0,0
4141,4141,,810,0,11,11
4142,4142,,810,24,0,24
4143,4143,,647,0,9,9
4144,4144,,647,0,1,1
4145,4145,,650,0,0,0
4146,4146,,651,0,0,0
4147,4147,,1602,0,30,30
4148,4148,,1508,0,1,1
4149,4149,,652,0,0,0
4150,4150,,680,0,5,5
4151,4151,,680,9,0,9
4152,4152,,680,3,0,3
4153,4153,,653,0,0,0
4154,4154,,1214,0,8,8
4155,4155,,1214,18,0,18
4156,4156,,1214,8,0,8
4157,4157,,654,0,0,0
4158,4158,,699,211,0,211
4159,4159,,804,0,5,5
4160,4160,,1214,0,9,9
4161,4161,,655,0,0,0
4162,4162,,657,0,16,16
4163,4163,,657,6,0,6
4164,4164,,656,0,0,0
4165,4165,,657,32,0,32
4166,4166,,657,6,0,6
4167,4167,,658,0,4,4
4168,4168,,658,4,0,4
4169,4169,,659,0,6,6
4170,4170,,659,6,0,6
4171,4171,,46,21,0,21
4172,4172,,46,10,0,10
4173,4173,,46,16,0,16
4174,4174,,46,7,0,7
4175,4175,,46,10,0,10
4176,4176,,46,9,0,9
4177,4177,,660,0,0,0
4178,4178,,661,0,0,0
4179,4179,,662,0,0,0
4180,4180,,663,0,0,0
4181,4181,,664,0,0,0
4182,4182,,665,0,0,0
4183,4183,,849,5,0,5
4184,4184,,776,0,5,5
4185,4185,,682,3,0,3
4186,4186,,776,6,0,6
4187,4187,,666,0,0,0
4188,4188,,667,0,0,0
4189,4189,,668,0,0,0
4190,4190,,669,0,0,0
4191,4191,,670,0,0,0
4192,4192,,671,0,0,0
4193,4193,,672,0,0,0
4194,4194,,673,0,0,0
4195,4195,,1974,0,8,8
4196,4196,,1974,3,0,3
4197,4197,,674,0,0,0
4198,4198,,1499,0,23,23
4199,4199,,1499,3,0,3
4200,4200,,675,0,0,0
4201,4201,,676,0,0,0
4202,4202,,677,0,0,0
4203,4203,,678,0,0,0
4204,4204,,509,0,10,10
4205,4205,,723,0,22,22
4206,4206,,2110,0,12,12
4207,4207,,427,21,0,21
4208,4208,,679,0,0,0
4209,4209,,680,0,7,7
4210,4210,,681,0,0,0
4211,4211,,682,0,3,3
4212,4212,,1214,0,23,23
4213,4213,,825,0,13,13
4214,4214,,825,18,0,18
4215,4215,,46,0,30,30
4216,4216,,964,0,11,11
4217,4217,,683,0,0,0
4218,4218,,1214,0,4,4
4219,4219,,684,0,0,0
4220,4220,,685,0,0,0
4221,4221,,964,0,14,14
4222,4222,,686,0,10,10
4223,4223,,686,10,0,10
4224,4224,,981,35,0,35
4225,4225,,981,16,0,16
4226,4226,,687,0,0,0
4227,4227,,1214,0,20,20
4228,4228,,1214,12,0,12
4229,4229,,427,0,4,4
4230,4230,,1214,0,13,13
4231,4231,,1502,22,0,22
4232,4232,,807,9,0,9
4233,4233,,688,0,0,0
4234,4234,,807,2,0,2
4235,4235,,2101,0,20,20
4236,4236,,689,0,0,0
4237,4237,,2101,3,0,3
4238,4238,,690,0,0,0
4239,4239,,1214,0,33,33
4240,4240,,1998,0,6,6
4241,4241,,1998,33,0,33
4242,4242,,1998,8,0,8
4243,4243,,807,0,7,7
4244,4244,,691,0,0,0
4245,4245,,692,0,0,0
4246,4246,,1502,0,10,10
4247,4247,,693,0,0,0
4248,4248,,694,0,0,0
4249,4249,,807,16,0,16
4250,4250,,695,0,0,0
4251,4251,,509,0,2,2
4252,4252,,696,0,0,0
4253,4253,,697,0,0,0
4254,4254,,698,0,0,0
4255,4255,,760,0,8,8
4256,4256,,1214,0,3,3
4257,4257,,1946,0,35,35
4258,4258,,1946,12,0,12
4259,4259,,1214,0,10,10
4260,4260,,699,0,844,844
4261,4261,,699,442,0,442
4262,4262,,699,422,0,422
4263,4263,,700,0,0,0
4264,4264,,443,10,0,10
4265,4265,,427,0,7,7
4266,4266,,701,0,0,0
4267,4267,,702,0,0,0
4268,4268,,703,0,0,0
4269,4269,,1502,0,372,372
4270,4270,,1502,331,0,331
4271,4271,,1602,0,33,33
4272,4272,,1602,40,0,40
4273,4273,,1602,10,0,10
4274,4274,,807,23,0,23
4275,4275,,704,0,22,22
4276,4276,,704,22,0,22
4277,4277,,1214,0,7,7
4278,4278,,1602,0,10,10
4279,4279,,1214,0,18,18
4280,4280,,705,0,0,0
4281,4281,,1214,0,31,31
4282,4282,,1214,3,0,3
4283,4283,,1214,14,0,14
4284,4284,,706,0,0,0
4285,4285,,707,0,0,0
4286,4286,,708,0,0,0
4287,4287,,2101,7,0,7
4288,4288,,1602,5,0,5
4289,4289,,2110,1,0,1
4290,4290,,1499,0,13,13
4291,4291,,709,0,0,0
4292,4292,,710,0,0,0
4293,4293,,711,0,0,0
4294,4294,,2020,17,0,17
4295,4295,,46,0,6,6
4296,4296,,807,5,0,5
4297,4297,,1974,0,7,7
4298,4298,,712,0,0,0
4299,4299,,1974,0,1,1
4300,4300,,807,0,11,11
4301,4301,,2062,0,1,1
4302,4302,,1214,0,21,21
4303,4303,,2101,0,2,2
4304,4304,,713,0,0,0
4305,4305,,3912,0,7,7
4306,4306,,714,0,0,0
4307,4307,,760,0,8,8
4308,4308,,760,8,0,8
4309,4309,,715,0,61,61
4310,4310,,715,17,0,17
4311,4311,,715,44,0,44
4312,4312,,1502,215,0,215
4313,4313,,427,7,0,7
4314,4314,,804,0,4,4
4315,4315,,1998,0,7,7
4316,4316,,1998,19,0,19
4317,4317,,716,0,0,0
4318,4318,,717,0,0,0
4319,4319,,718,0,0,0
4320,4320,,719,0,0,0
4321,4321,,616,5,0,5
4322,4322,,881,0,7,7
4323,4323,,881,4,0,4
4324,4324,,720,0,0,0
4325,4325,,964,0,11,11
4326,4326,,721,0,0,0
4327,4327,,722,0,0,0
4328,4328,,723,0,33,33
4329,4329,,2110,3,0,3
4330,4330,,724,0,0,0
4331,4331,,2110,0,3,3
4332,4332,,1203,6,0,6
4333,4333,,1998,0,40,40
4334,4334,,725,0,0,0
4335,4335,,509,0,11,11
4336,4336,,981,0,33,33
4337,4337,,981,14,0,14
4338,4338,,981,10,0,10
4339,4339,,981,11,0,11
4340,4340,,964,0,11,11
4341,4341,,261,0,3,3
4342,4342,,261,7,0,7
4343,4343,,726,0,0,0
4344,4344,,727,0,0,0
4345,4345,,728,0,0,0
4346,4346,,729,0,0,0
4347,4347,,1502,0,72,72
4348,4348,,825,0,16,16
4349,4349,,825,13,0,13
4350,4350,,261,11,0,11
4351,4351,,807,7,0,7
4352,4352,,730,0,0,0
4353,4353,,731,0,0,0
4354,4354,,1214,0,14,14
4355,4355,,427,0,2,2
4356,4356,,2110,0,12,12
4357,4357,,2110,4,0,4
4358,4358,,1998,99,0,99
4359,4359,,443,0,11,11
4360,4360,,732,0,0,0
4361,4361,,2072,0,17,17
4362,4362,,2072,23,0,23
4363,4363,,261,5,0,5
4364,4364,,733,0,0,0
4365,4365,,778,0,40,40
4366,4366,,778,45,0,45
4367,4367,,778,40,0,40
4368,4368,,509,25,0,25
4369,4369,,509,0,12,12
4370,4370,,2096,0,422,422
4371,4371,,734,0,0,0
4372,4372,,735,0,0,0
4373,4373,,736,0,0,0
4374,4374,,737,0,0,0
4375,4375,,738,0,0,0
4376,4376,,739,0,0,0
4377,4377,,740,0,0,0
4378,4378,,741,0,4,4
4379,4379,,741,4,0,4
4380,4380,,742,0,0,0
4381,4381,,427,0,21,21
4382,4382,,743,0,0,0
4383,4383,,833,3,0,3
4384,4384,,807,9,0,9
4385,4385,,744,0,6,6
4386,4386,,744,6,0,6
4387,4387,,509,0,18,18
4388,4388,,745,0,0,0
4389,4389,,746,0,20,20
4390,4390,,747,0,0,0
4391,4391,,748,0,0,0
4392,4392,,579,0,12,12
4393,4393,,1214,0,19,19
4394,4394,,699,0,226,226
4395,4395,,1214,0,14,14
4396,4396,,1214,0,17,17
4397,4397,,869,0,5,5
4398,4398,,869,5,0,5
4399,4399,,869,41,0,41
4400,4400,,2096,0,24,24
4401,4401,,749,0,0,0
4402,4402,,1214,0,15,15
4403,4403,,750,0,0,0
4404,4404,,1214,0,19,19
4405,4405,,833,0,5,5
4406,4406,,833,3,0,3
4407,4407,,833,5,0,5
4408,4408,,833,6,0,6
4409,4409,,751,0,0,0
4410,4410,,752,0,0,0
4411,4411,,753,0,0,0
4412,4412,,754,0,0,0
4413,4413,,1502,0,6,6
4414,4414,,1502,5,0,5
4415,4415,,746,0,15,15
4416,4416,,2110,0,10,10
4417,4417,,1214,0,14,14
4418,4418,,1214,0,9,9
4419,4419,,1214,0,17,17
4420,4420,,1214,19,0,19
4421,4421,,869,0,8,8
4422,4422,,869,12,0,12
4423,4423,,755,0,18,18
4424,4424,,755,8,0,8
4425,4425,,755,1,0,1
4426,4426,,755,0,22,22
4427,4427,,755,0,24,24
4428,4428,,2110,0,92,92
4429,4429,,1214,0,6,6
4430,4430,,1214,4,0,4
4431,4431,,1214,0,15,15
4432,4432,,756,0,0,0
4433,4433,,757,0,0,0
4434,4434,,1214,0,15,15
4435,4435,,427,0,9,9
4436,4436,,1602,0,18,18
4437,4437,,1602,9,0,9
4438,4438,,758,0,0,0
4439,4439,,2062,20,0,20
4440,4440,,760,0,11,11
4441,4441,,2096,0,211,211
4442,4442,,1499,0,134,134
4443,4443,,1499,34,0,34
4444,4444,,759,0,0,0
4445,4445,,760,0,10,10
4446,4446,,755,0,2,2
4447,4447,,761,0,0,0
4448,4448,,762,0,0,0
4449,4449,,763,0,0,0
4450,4450,,764,0,0,0
4451,4451,,765,0,0,0
4452,4452,,766,0,0,0
4453,4453,,767,0,0,0
4454,4454,,768,0,0,0
4455,4455,,769,0,0,0
4456,4456,,770,0,0,0
4457,4457,,1214,4,0,4
4458,4458,,771,0,0,0
4459,4459,,772,0,0,0
4460,4460,,773,0,0,0
4461,4461,,774,0,170,170
4462,4462,,774,170,0,170
4463,4463,,775,0,0,0
4464,4464,,776,0,5,5
4465,4465,,776,4,0,4
4466,4466,,46,0,13,13
4467,4467,,755,0,10,10
4468,4468,,2062,0,10,10
4469,4469,,2062,23,0,23
4470,4470,,2062,4,0,4
4471,4471,,1214,0,11,11
4472,4472,,555,0,3,3
4473,4473,,980,0,1,1
4474,4474,,980,3,0,3
4475,4475,,980,4,0,4
4476,4476,,777,0,0,0
4477,4477,,869,0,8,8
4478,4478,,869,4,0,4
4479,4479,,869,0,40,40
4480,4480,,869,8,0,8
4481,4481,,869,19,0,19
4482,4482,,1214,0,5,5
4483,4483,,1985,0,1,1
4484,4484,,778,0,45,45
4485,4485,,779,0,0,0
4486,4486,,780,0,0,0
4487,4487,,2101,0,25,25
4488,4488,,1214,0,27,27
4489,4489,,1214,0,8,8
4490,4490,,1214,26,0,26
4491,4491,,1214,6,0,6
4492,4492,,509,0,20,20
4493,4493,,509,4,0,4
4494,4494,,781,0,0,0
4495,4495,,782,0,0,0
4496,4496,,783,0,0,0
4497,4497,,784,0,0,0
4498,4498,,1502,0,9,9
4499,4499,,1502,19,0,19
4500,4500,,785,0,0,0
4501,4501,,786,0,0,0
4502,4502,,787,0,0,0
4503,4503,,1214,0,9,9
4504,4504,,1214,0,9,9
4505,4505,,1214,3,0,3
4506,4506,,1214,6,0,6
4507,4507,,1214,0,5,5
4508,4508,,509,0,11,11
4509,4509,,788,0,0,0
4510,4510,,789,0,0,0
4511,4511,,790,0,0,0
4512,4512,,791,0,0,0
4513,4513,,792,0,0,0
4514,4514,,964,0,7,7
4515,4515,,964,2,0,2
4516,4516,,793,0,0,0
4517,4517,,2072,0,26,26
4518,4518,,1214,0,11,11
4519,4519,,794,0,0,0
4520,4520,,1214,0,10,10
4521,4521,,795,0,0,0
4522,4522,,796,0,0,0
4523,4523,,797,0,0,0
4524,4524,,1239,0,1,1
4525,4525,,427,0,6,6
4526,4526,,1214,5,0,5
4527,4527,,798,0,0,0
4528,4528,,2072,0,8,8
4529,4529,,46,0,7,7
4530,4530,,799,0,0,0
4531,4531,,800,0,0,0
4532,4532,,801,0,0,0
4533,4533,,858,4,0,4
4534,4534,,427,0,25,25
4535,4535,,427,164,0,164
4536,4536,,2062,0,38,38
4537,4537,,2062,35,0,35
4538,4538,,802,0,0,0
4539,4539,,46,0,7,7
4540,4540,,803,0,2,2
4541,4541,,803,2,0,2
4542,4542,,1214,0,4,4
4543,4543,,804,0,6,6
4544,4544,,805,0,0,0
4545,4545,,806,0,0,0
4546,4546,,983,19,0,19
4547,4547,,807,0,171,171
4548,4548,,808,0,0,0
4549,4549,,809,0,0,0
4550,4550,,810,0,416,416
4551,4551,,1214,0,8,8
4552,4552,,1946,0,4,4
4553,4553,,811,0,211,211
4554,4554,,811,211,0,211
4555,4555,,2062,0,37,37
4556,4556,,509,0,16,16
4557,4557,,509,0,6,6
4558,4558,,427,0,6,6
4559,4559,,2072,0,23,23
4560,4560,,2072,14,0,14
4561,4561,,2072,6,0,6
4562,4562,,1214,0,1,1
4563,4563,,812,0,0,0
4564,4564,,760,0,5,5
4565,4565,,579,0,1,1
4566,4566,,807,0,15,15
4567,4567,,813,0,0,0
4568,4568,,1499,0,193,193
4569,4569,,1499,0,13,13
4570,4570,,1499,1,0,1
4571,4571,,814,0,0,0
4572,4572,,815,0,0,0
4573,4573,,427,0,33,33
4574,4574,,427,4,0,4
4575,4575,,1998,0,31,31
4576,4576,,2110,0,45,45
4577,4577,,816,0,0,0
4578,4578,,1998,0,11,11
4579,4579,,817,0,0,0
4580,4580,,818,0,0,0
4581,4581,,819,0,0,0
4582,4582,,509,0,175,175
4583,4583,,1502,0,5,5
4584,4584,,1214,0,6,6
4585,4585,,825,0,10,10
4586,4586,,2072,0,373,373
4587,4587,,2072,33,0,33
4588,4588,,820,0,0,0
4589,4589,,509,0,9,9
4590,4590,,821,0,0,0
4591,4591,,822,0,0,0
4592,4592,,427,0,10,10
4593,4593,,823,0,3,3
4594,4594,,823,3,0,3
4595,4595,,1214,0,30,30
4596,4596,,964,0,3,3
4597,4597,,824,0,0,0
4598,4598,,2096,0,211,211
4599,4599,,825,0,19,19
4600,4600,,825,6,0,6
4601,4601,,2020,0,18,18
4602,4602,,1214,0,16,16
4603,4603,,46,0,5,5
4604,4604,,579,0,1,1
4605,4605,,826,0,0,0
4606,4606,,509,0,10,10
4607,4607,,2096,0,9,9
4608,4608,,1214,0,5,5
4609,4609,,827,0,0,0
4610,4610,,828,0,0,0
4611,4611,,829,0,0,0
4612,4612,,830,0,0,0
4613,4613,,1214,0,21,21
4614,4614,,831,0,0,0
4615,4615,,1214,0,8,8
4616,4616,,832,0,0,0
4617,4617,,833,0,12,12
4618,4618,,834,0,0,0
4619,4619,,835,0,0,0
4620,4620,,836,0,0,0
4621,4621,,837,0,0,0
4622,4622,,838,0,0,0
4623,4623,,509,0,46,46
4624,4624,,509,10,0,10
4625,4625,,2101,0,14,14
4626,4626,,2101,7,0,7
4627,4627,,839,0,15,15
4628,4628,,755,0,6,6
4629,4629,,840,0,0,0
4630,4630,,1214,0,3,3
4631,4631,,1214,0,10,10
4632,4632,,1502,0,10,10
4633,4633,,841,0,0,0
4634,4634,,842,0,0,0
4635,4635,,46,0,30,30
4636,4636,,1214,0,7,7
4637,4637,,843,0,29,29
4638,4638,,843,29,0,29
4639,4639,,844,0,0,0
4640,4640,,1214,0,8,8
4641,4641,,1214,0,17,17
4642,4642,,845,0,0,0
4643,4643,,1499,0,5,5
4644,4644,,509,0,12,12
4645,4645,,846,0,0,0
4646,4646,,509,0,15,15
4647,4647,,847,0,0,0
4648,4648,,848,0,0,0
4649,4649,,1214,0,22,22
4650,4650,,1214,21,0,21
4651,4651,,1214,0,5,5
4652,4652,,849,0,5,5
4653,4653,,509,0,9,9
4654,4654,,1214,0,12,12
4655,4655,,1214,6,0,6
4656,4656,,427,0,54,54
4657,4657,,427,35,0,35
4658,4658,,1214,0,12,12
4659,4659,,509,0,23,23
4660,4660,,850,0,30,30
4661,4661,,850,30,0,30
4662,4662,,657,0,28,28
4663,4663,,1214,0,35,35
4664,4664,,1499,0,12,12
4665,4665,,760,0,2,2
4666,4666,,851,0,0,0
4667,4667,,1214,0,24,24
4668,4668,,852,0,0,0
4669,4669,,2062,0,4,4
4670,4670,,853,0,0,0
4671,4671,,1974,7,0,7
4672,4672,,1502,0,11,11
4673,4673,,1214,0,8,8
4674,4674,,869,0,7,7
4675,4675,,1499,0,21,21
4676,4676,,854,0,17,17
4677,4677,,854,17,0,17
4678,4678,,1214,0,32,32
4679,4679,,1998,0,2,2
4680,4680,,46,0,28,28
4681,4681,,855,0,0,0
4682,4682,,856,0,0,0
4683,4683,,427,0,2,2
4684,4684,,2110,0,16,16
4685,4685,,1214,0,3,3
4686,4686,,1998,0,1,1
4687,4687,,857,0,12,12
4688,4688,,857,12,0,12
4689,4689,,427,0,5,5
4690,4690,,858,0,4,4
4691,4691,,1214,0,18,18
4692,4692,,859,0,0,0
4693,4693,,1203,7,0,7
4694,4694,,860,0,0,0
4695,4695,,2062,0,7,7
4696,4696,,427,0,3,3
4697,4697,,1998,3,0,3
4698,4698,,861,0,0,0
4699,4699,,1998,10,0,10
4700,4700,,1998,7,0,7
4701,4701,,1998,0,13,13
4702,4702,,869,0,10,10
4703,4703,,862,0,0,0
4704,4704,,863,0,0,0
4705,4705,,864,0,0,0
4706,4706,,807,24,0,24
4707,4707,,1998,0,19,19
4708,4708,,1998,10,0,10
4709,4709,,865,0,0,0
4710,4710,,1998,0,11,11
4711,4711,,866,0,0,0
4712,4712,,46,0,14,14
4713,4713,,981,0,12,12
4714,4714,,867,0,0,0
4715,4715,,427,0,209,209
4716,4716,,2096,0,211,211
4717,4717,,1214,0,15,15
4718,4718,,868,0,0,0
4719,4719,,1998,0,10,10
4720,4720,,1214,0,11,11
4721,4721,,869,0,31,31
4722,4722,,1214,0,8,8
4723,4723,,1214,0,10,10
4724,4724,,870,0,0,0
4725,4725,,2110,0,8,8
4726,4726,,871,0,0,0
4727,4727,,872,0,0,0
4728,4728,,1214,0,15,15
4729,4729,,1214,0,22,22
4730,4730,,1214,0,20,20
4731,4731,,873,0,0,0
4732,4732,,874,0,0,0
4733,4733,,1214,0,9,9
4734,4734,,1214,19,0,19
4735,4735,,1214,0,10,10
4736,4736,,1214,0,21,21
4737,4737,,875,0,0,0
4738,4738,,46,0,5,5
4739,4739,,261,5,0,5
4740,4740,,427,0,2,2
4741,4741,,1214,0,4,4
4742,4742,,876,0,0,0
4743,4743,,877,0,0,0
4744,4744,,878,0,0,0
4745,4745,,1214,0,4,4
4746,4746,,1214,14,0,14
4747,4747,,879,0,0,0
4748,4748,,554,0,1,1
4749,4749,,509,0,29,29
4750,4750,,1602,0,1,1
4751,4751,,1214,0,10,10
4752,4752,,880,0,0,0
4753,4753,,881,0,3,3
4754,4754,,1946,0,45,45
4755,4755,,882,0,0,0
4756,4756,,883,0,0,0
4757,4757,,884,0,0,0
4758,4758,,885,0,0,0
4759,4759,,886,0,0,0
4760,4760,,509,0,10,10
4761,4761,,509,0,8,8
4762,4762,,887,0,0,0
4763,4763,,888,0,0,0
4764,4764,,1214,0,315,315
4765,4765,,889,0,14,14
4766,4766,,889,3,0,3
4767,4767,,889,4,0,4
4768,4768,,889,3,0,3
4769,4769,,889,4,0,4
4770,4770,,890,0,0,0
4771,4771,,891,0,0,0
4772,4772,,892,0,0,0
4773,4773,,893,0,0,0
4774,4774,,427,0,29,29
4775,4775,,1214,0,10,10
4776,4776,,1214,0,12,12
4777,4777,,1214,0,7,7
4778,4778,,894,0,0,0
4779,4779,,895,0,0,0
4780,4780,,896,0,0,0
4781,4781,,897,0,0,0
4782,4782,,898,0,0,0
4783,4783,,1998,0,3,3
4784,4784,,899,0,0,0
4785,4785,,509,0,5,5
4786,4786,,900,0,0,0
4787,4787,,509,0,10,10
4788,4788,,901,0,0,0
4789,4789,,902,0,0,0
4790,4790,,903,0,0,0
4791,4791,,904,0,0,0
4792,4792,,905,0,0,0
4793,4793,,906,0,0,0
4794,4794,,907,0,0,0
4795,4795,,908,0,0,0
4796,4796,,909,0,0,0
4797,4797,,910,0,0,0
4798,4798,,911,0,0,0
4799,4799,,509,0,7,7
4800,4800,,912,0,0,0
4801,4801,,913,0,0,0
4802,4802,,509,0,10,10
4803,4803,,509,0,5,5
4804,4804,,46,0,13,13
4805,4805,,427,0,12,12
4806,4806,,914,0,0,0
4807,4807,,915,0,0,0
4808,4808,,916,0,0,0
4809,4809,,917,0,0,0
4810,4810,,1499,0,23,23
4811,4811,,918,0,0,0
4812,4812,,919,0,0,0
4813,4813,,920,0,0,0
4814,4814,,509,0,15,15
4815,4815,,921,0,0,0
4816,4816,,922,0,0,0
4817,4817,,923,0,0,0
4818,4818,,924,0,0,0
4819,4819,,925,0,0,0
4820,4820,,46,0,34,34
4821,4821,,926,0,0,0
4822,4822,,927,0,0,0
4823,4823,,1214,0,21,21
4824,4824,,2096,0,211,211
4825,4825,,928,0,0,0
4826,4826,,427,0,5,5
4827,4827,,929,0,0,0
4828,4828,,1998,0,1,1
4829,4829,,1214,0,6,6
4830,4830,,1214,0,4,4
4831,4831,,930,0,0,0
4832,4832,,1214,0,20,20
4833,4833,,1214,0,14,14
4834,4834,,1214,0,14,14
4835,4835,,931,0,0,0
4836,4836,,932,0,0,0
4837,4837,,933,0,4,4
4838,4838,,933,4,0,4
4839,4839,,934,0,0,0
4840,4840,,935,0,0,0
4841,4841,,936,0,0,0
4842,4842,,937,0,0,0
4843,4843,,938,0,0,0
4844,4844,,939,0,0,0
4845,4845,,940,0,0,0
4846,4846,,941,0,0,0
4847,4847,,942,0,0,0
4848,4848,,943,0,0,0
4849,4849,,1214,0,5,5
4850,4850,,1214,0,21,21
4851,4851,,944,0,0,0
4852,4852,,427,0,3,3
4853,4853,,945,0,42,42
4854,4854,,945,42,0,42
4855,4855,,946,0,0,0
4856,4856,,947,0,0,0
4857,4857,,1974,0,4,4
4858,4858,,825,0,2,2
4859,4859,,948,0,0,0
4860,4860,,949,0,3,3
4861,4861,,949,3,0,3
4862,4862,,1214,0,6,6
4863,4863,,950,0,0,0
4864,4864,,951,0,0,0
4865,4865,,952,0,0,0
4866,4866,,953,0,0,0
4867,4867,,954,0,4,4
4868,4868,,954,4,0,4
4869,4869,,1214,0,16,16
4870,4870,,955,0,0,0
4871,4871,,956,0,0,0
4872,4872,,427,0,13,13
4873,4873,,1214,0,14,14
4874,4874,,957,0,0,0
4875,4875,,958,0,0,0
4876,4876,,959,0,0,0
4877,4877,,1214,0,3,3
4878,4878,,1214,14,0,14
4879,4879,,746,0,14,14
4880,4880,,427,4,0,4
4881,4881,,807,0,2,2
4882,4882,,1214,0,211,211
4883,4883,,960,0,0,0
4884,4884,,1214,0,10,10
4885,4885,,2072,0,206,206
4886,4886,,2072,0,20,20
4887,4887,,2062,0,20,20
4888,4888,,509,0,45,45
4889,4889,,1214,0,10,10
4890,4890,,1214,0,9,9
4891,4891,,1502,0,11,11
4892,4892,,2101,0,7,7
4893,4893,,961,0,0,0
4894,4894,,962,0,0,0
4895,4895,,509,0,5,5
4896,4896,,427,0,8,8
4897,4897,,427,3,0,3
4898,4898,,427,4,0,4
4899,4899,,1499,0,46,46
4900,4900,,1499,5,0,5
4901,4901,,1214,0,12,12
4902,4902,,1214,11,0,11
4903,4903,,1214,2,0,2
4904,4904,,963,0,0,0
4905,4905,,964,0,215,215
4906,4906,,965,0,0,0
4907,4907,,966,0,0,0
4908,4908,,967,0,0,0
4909,4909,,968,0,0,0
4910,4910,,969,0,0,0
4911,4911,,1502,0,150,150
4912,4912,,1203,15,0,15
4913,4913,,970,0,0,0
4914,4914,,1214,0,13,13
4915,4915,,869,0,47,47
4916,4916,,869,7,0,7
4917,4917,,869,24,0,24
4918,4918,,427,0,248,248
4919,4919,,869,0,32,32
4920,4920,,869,26,0,26
4921,4921,,645,0,3,3
4922,4922,,427,0,5,5
4923,4923,,971,0,13,13
4924,4924,,971,13,0,13
4925,4925,,1214,0,11,11
4926,4926,,509,0,26,26
4927,4927,,1214,0,10,10
4928,4928,,46,0,36,36
4929,4929,,1214,0,26,26
4930,4930,,972,0,0,0
4931,4931,,973,0,0,0
4932,4932,,509,0,16,16
4933,4933,,509,0,4,4
4934,4934,,974,0,0,0
4935,4935,,975,0,0,0
4936,4936,,976,0,0,0
4937,4937,,977,0,0,0
4938,4938,,509,0,14,14
4939,4939,,978,0,0,0
4940,4940,,261,0,17,17
4941,4941,,979,0,0,0
4942,4942,,1214,0,4,4
4943,4943,,1946,0,23,23
4944,4944,,980,0,6,6
4945,4945,,981,0,59,59
4946,4946,,981,33,0,33
4947,4947,,982,0,0,0
4948,4948,,2101,0,6,6
4949,4949,,2101,0,8,8
4950,4950,,2101,0,6,6
4951,4951,,1214,0,8,8
4952,4952,,983,0,19,19
4953,4953,,509,0,7,7
4954,4954,,984,0,0,0
4955,4955,,985,0,5,5
4956,4956,,985,5,0,5
4957,4957,,986,0,8,8
4958,4958,,986,8,0,8
4959,4959,,1499,0,7,7
4960,4960,,987,0,0,0
4961,4961,,869,0,20,20
4962,4962,,869,15,0,15
4963,4963,,1502,0,240,240
4964,4964,,988,0,0,0
4965,4965,,989,0,0,0
4966,4966,,1214,0,1,1
4967,4967,,2101,0,15,15
4968,4968,,825,0,9,9
4969,4969,,1203,1207,0,1207
4970,4970,,991,0,211,211
4971,4971,,990,0,0,0
4972,4972,,991,0,211,211
4973,4973,,991,60909,0,60909
4974,4974,,991,0,211,211
4975,4975,,991,0,211,211
4976,4976,,991,0,211,211
4977,4977,,46,844,0,844
4978,4978,,991,0,211,211
4979,4979,,991,0,211,211
4980,4980,,991,0,211,211
4981,4981,,1203,91,0,91
4982,4982,,99,10128,0,10128
4983,4983,,99,11605,0,11605
4984,4984,,1602,0,211,211
4985,4985,,1602,255,0,255
4986,4986,,1602,2147,0,2147
4987,4987,,1012,122,0,122
4988,4988,,261,552,0,552
4989,4989,,991,0,211,211
4990,4990,,46,1737,0,1737
4991,4991,,991,0,211,211
4992,4992,,991,0,211,211
4993,4993,,991,0,211,211
4994,4994,,991,0,211,211
4995,4995,,1203,64,0,64
4996,4996,,991,0,211,211
4997,4997,,991,0,211,211
4998,4998,,991,0,211,211
4999,4999,,992,0,0,0
5000,5000,,993,0,0,0
5001,5001,,251,1,0,1
5002,5002,,994,0,0,0
5003,5003,,991,0,211,211
5004,5004,,991,0,211,211
5005,5005,,991,0,211,211
5006,5006,,1602,0,211,211
5007,5007,,991,0,211,211
5008,5008,,991,0,211,211
5009,5009,,991,0,211,211
5010,5010,,995,0,0,0
5011,5011,,991,0,211,211
5012,5012,,991,0,211,211
5013,5013,,991,0,211,211
5014,5014,,991,0,211,211
5015,5015,,991,0,211,211
5016,5016,,991,0,211,211
5017,5017,,991,0,211,211
5018,5018,,991,0,211,211
5019,5019,,991,0,211,211
5020,5020,,996,0,0,0
5021,5021,,1030,48,0,48
5022,5022,,997,0,0,0
5023,5023,,991,0,211,211
5024,5024,,1602,905,0,905
5025,5025,,991,0,211,211
5026,5026,,991,0,211,211
5027,5027,,991,0,211,211
5028,5028,,136,633,0,633
5029,5029,,998,0,0,0
5030,5030,,991,0,211,211
5031,5031,,991,0,211,211
5032,5032,,991,0,211,211
5033,5033,,991,0,211,211
5034,5034,,999,0,0,0
5035,5035,,991,0,211,211
5036,5036,,1000,0,211,211
5037,5037,,1000,422,0,422
5038,5038,,1001,0,0,0
5039,5039,,991,0,211,211
5040,5040,,991,0,211,211
5041,5041,,1602,0,211,211
5042,5042,,991,0,211,211
5043,5043,,1602,92,0,92
5044,5044,,991,0,211,211
5045,5045,,991,0,211,211
5046,5046,,1023,0,2,2
5047,5047,,1023,219,0,219
5048,5048,,1023,86,0,86
5049,5049,,1602,9,0,9
5050,5050,,991,0,211,211
5051,5051,,991,0,211,211
5052,5052,,991,0,211,211
5053,5053,,991,0,211,211
5054,5054,,991,0,211,211
5055,5055,,991,0,211,211
5056,5056,,991,0,211,211
5057,5057,,261,685,0,685
5058,5058,,1002,0,211,211
5059,5059,,1002,440,0,440
5060,5060,,1003,0,0,0
5061,5061,,991,0,211,211
5062,5062,,991,0,211,211
5063,5063,,991,0,211,211
5064,5064,,991,0,211,211
5065,5065,,991,0,211,211
5066,5066,,991,0,211,211
5067,5067,,46,218,0,218
5068,5068,,991,0,211,211
5069,5069,,991,0,211,211
5070,5070,,991,0,211,211
5071,5071,,991,0,211,211
5072,5072,,991,0,211,211
5073,5073,,991,0,211,211
5074,5074,,991,0,211,211
5075,5075,,1004,0,0,0
5076,5076,,1005,0,0,0
5077,5077,,991,0,211,211
5078,5078,,991,0,211,211
5079,5079,,1006,0,0,0
5080,5080,,991,0,211,211
5081,5081,,991,0,211,211
5082,5082,,991,0,211,211
5083,5083,,991,0,211,211
5084,5084,,991,0,211,211
5085,5085,,991,0,211,211
5086,5086,,991,0,211,211
5087,5087,,991,0,211,211
5088,5088,,1012,4060,0,4060
5089,5089,,991,0,211,211
5090,5090,,991,0,211,211
5091,5091,,991,0,211,211
5092,5092,,99,844,0,844
5093,5093,,1007,0,212,212
5094,5094,,1007,213,0,213
5095,5095,,1007,254,0,254
5096,5096,,1008,0,16,16
5097,5097,,1008,16,0,16
5098,5098,,1602,0,211,211
5099,5099,,991,0,211,211
5100,5100,,1602,62,0,62
5101,5101,,991,0,211,211
5102,5102,,991,0,211,211
5103,5103,,1009,0,0,0
5104,5104,,46,26,0,26
5105,5105,,991,0,211,211
5106,5106,,99,0,422,422
5107,5107,,991,0,211,211
5108,5108,,1012,0,76,76
5109,5109,,3289,9,108,117
5110,5110,,3289,177,0,177
5111,5111,,991,0,211,211
5112,5112,,1017,0,3,3
5113,5113,,1017,135,0,135
5114,5114,,991,0,211,211
5115,5115,,991,0,211,211
5116,5116,,991,0,211,211
5117,5117,,991,0,211,211
5118,5118,,991,0,211,211
5119,5119,,1602,0,211,211
5120,5120,,46,366,0,366
5121,5121,,991,0,211,211
5122,5122,,991,0,211,211
5123,5123,,1010,0,0,0
5124,5124,,1011,0,0,0
5125,5125,,991,0,211,211
5126,5126,,991,0,211,211
5127,5127,,991,0,211,211
5128,5128,,991,0,211,211
5129,5129,,991,0,211,211
5130,5130,,991,0,211,211
5131,5131,,991,0,211,211
5132,5132,,991,0,211,211
5133,5133,,1012,0,211,211
5134,5134,,991,0,211,211
5135,5135,,46,48,147,195
5136,5136,,991,0,211,211
5137,5137,,991,0,211,211
5138,5138,,991,0,211,211
5139,5139,,1998,10,0,10
5140,5140,,991,0,211,211
5141,5141,,1012,0,101,101
5142,5142,,991,0,211,211
5143,5143,,991,0,211,211
5144,5144,,261,0,17,17
5145,5145,,261,39,0,39
5146,5146,,991,0,211,211
5147,5147,,991,0,211,211
5148,5148,,1012,0,130,130
5149,5149,,1013,0,0,0
5150,5150,,1014,0,0,0
5151,5151,,1025,62,0,62
5152,5152,,991,0,211,211
5153,5153,,991,0,211,211
5154,5154,,991,0,211,211
5155,5155,,1015,0,0,0
5156,5156,,1002,0,18,18
5157,5157,,3289,1,69,70
5158,5158,,1012,0,128,128
5159,5159,,1012,0,129,129
5160,5160,,1012,0,130,130
5161,5161,,991,0,211,211
5162,5162,,1016,0,0,0
5163,5163,,1602,0,3,3
5164,5164,,991,0,211,211
5165,5165,,991,0,211,211
5166,5166,,991,0,211,211
5167,5167,,991,0,211,211
5168,5168,,1012,0,130,130
5169,5169,,991,0,211,211
5170,5170,,991,0,211,211
5171,5171,,991,0,211,211
5172,5172,,991,0,211,211
5173,5173,,991,0,211,211
5174,5174,,991,0,211,211
5175,5175,,991,0,211,211
5176,5176,,991,0,211,211
5177,5177,,261,1,10,11
5178,5178,,1012,0,125,125
5179,5179,,991,0,211,211
5180,5180,,991,0,211,211
5181,5181,,1000,0,211,211
5182,5182,,991,0,211,211
5183,5183,,991,0,211,211
5184,5184,,1017,0,35,35
5185,5185,,1017,58,0,58
5186,5186,,991,0,211,211
5187,5187,,1017,0,23,23
5188,5188,,991,0,211,211
5189,5189,,991,49,0,49
5190,5190,,1017,0,2,2
5191,5191,,1017,0,17,17
5192,5192,,1017,0,29,29
5193,5193,,1017,0,23,23
5194,5194,,1017,0,1,1
5195,5195,,1017,0,28,28
5196,5196,,1018,0,0,0
5197,5197,,1017,0,1,1
5198,5198,,1017,0,28,28
5199,5199,,1017,0,3,3
5200,5200,,991,0,211,211
5201,5201,,991,0,211,211
5202,5202,,991,0,211,211
5203,5203,,1023,0,8,8
5204,5204,,991,0,211,211
5205,5205,,991,0,211,211
5206,5206,,991,0,211,211
5207,5207,,991,0,211,211
5208,5208,,991,0,211,211
5209,5209,,991,0,211,211
5210,5210,,991,0,211,211
5211,5211,,991,0,211,211
5212,5212,,991,0,211,211
5213,5213,,991,0,211,211
5214,5214,,1012,0,211,211
5215,5215,,991,0,211,211
5216,5216,,991,0,211,211
5217,5217,,991,0,211,211
5218,5218,,1019,0,0,0
5219,5219,,991,0,211,211
5220,5220,,991,0,211,211
5221,5221,,991,0,211,211
5222,5222,,991,0,211,211
5223,5223,,991,0,211,211
5224,5224,,991,0,211,211
5225,5225,,991,0,211,211
5226,5226,,991,0,211,211
5227,5227,,991,0,211,211
5228,5228,,991,0,211,211
5229,5229,,991,0,211,211
5230,5230,,991,0,211,211
5231,5231,,991,0,211,211
5232,5232,,991,0,211,211
5233,5233,,991,0,211,211
5234,5234,,1002,0,211,211
5235,5235,,991,0,211,211
5236,5236,,991,0,211,211
5237,5237,,991,0,211,211
5238,5238,,1012,0,211,211
5239,5239,,991,0,211,211
5240,5240,,991,0,211,211
5241,5241,,991,0,211,211
5242,5242,,991,0,211,211
5243,5243,,991,0,211,211
5244,5244,,991,0,211,211
5245,5245,,991,0,211,211
5246,5246,,991,0,211,211
5247,5247,,991,0,211,211
5248,5248,,991,0,211,211
5249,5249,,991,0,211,211
5250,5250,,991,0,211,211
5251,5251,,991,0,211,211
5252,5252,,1012,0,83,83
5253,5253,,991,0,211,211
5254,5254,,991,0,211,211
5255,5255,,991,0,211,211
5256,5256,,991,0,211,211
5257,5257,,991,0,211,211
5258,5258,,991,0,211,211
5259,5259,,991,0,211,211
5260,5260,,991,0,211,211
5261,5261,,991,0,211,211
5262,5262,,991,0,211,211
5263,5263,,991,0,211,211
5264,5264,,991,0,211,211
5265,5265,,991,0,211,211
5266,5266,,991,0,211,211
5267,5267,,991,0,211,211
5268,5268,,991,0,211,211
5269,5269,,991,0,211,211
5270,5270,,991,0,211,211
5271,5271,,991,0,211,211
5272,5272,,991,0,211,211
5273,5273,,991,0,211,211
5274,5274,,991,0,211,211
5275,5275,,991,0,211,211
5276,5276,,991,0,211,211
5277,5277,,991,0,211,211
5278,5278,,1602,0,112,112
5279,5279,,991,0,211,211
5280,5280,,991,0,211,211
5281,5281,,991,0,211,211
5282,5282,,991,0,211,211
5283,5283,,991,0,211,211
5284,5284,,991,0,211,211
5285,5285,,991,0,105,105
5286,5286,,991,0,211,211
5287,5287,,991,0,211,211
5288,5288,,991,0,211,211
5289,5289,,991,0,211,211
5290,5290,,991,0,211,211
5291,5291,,991,0,211,211
5292,5292,,991,0,211,211
5293,5293,,991,0,211,211
5294,5294,,991,0,211,211
5295,5295,,991,0,211,211
5296,5296,,991,0,211,211
5297,5297,,991,0,211,211
5298,5298,,991,0,211,211
5299,5299,,991,0,211,211
5300,5300,,991,0,211,211
5301,5301,,991,0,211,211
5302,5302,,991,0,211,211
5303,5303,,991,0,211,211
5304,5304,,991,0,211,211
5305,5305,,1020,0,0,0
5306,5306,,1021,0,0,0
5307,5307,,1022,0,0,0
5308,5308,,1012,0,211,211
5309,5309,,1023,0,211,211
5310,5310,,991,0,211,211
5311,5311,,991,0,211,211
5312,5312,,991,0,211,211
5313,5313,,991,0,211,211
5314,5314,,1024,0,0,0
5315,5315,,991,0,212,212
5316,5316,,991,0,211,211
5317,5317,,991,0,211,211
5318,5318,,991,0,211,211
5319,5319,,991,0,211,211
5320,5320,,991,0,211,211
5321,5321,,991,0,211,211
5322,5322,,1602,0,211,211
5323,5323,,991,0,211,211
5324,5324,,1012,0,132,132
5325,5325,,1025,0,62,62
5326,5326,,991,0,211,211
5327,5327,,991,0,211,211
5328,5328,,991,0,211,211
5329,5329,,991,0,211,211
5330,5330,,991,0,211,211
5331,5331,,991,0,211,211
5332,5332,,1027,0,211,211
5333,5333,,1026,0,0,0
5334,5334,,1027,408,0,408
5335,5335,,991,0,211,211
5336,5336,,991,0,211,211
5337,5337,,1027,0,197,197
5338,5338,,991,0,211,211
5339,5339,,991,0,211,211
5340,5340,,991,0,211,211
5341,5341,,991,0,211,211
5342,5342,,991,0,211,211
5343,5343,,991,0,211,211
5344,5344,,991,0,211,211
5345,5345,,991,0,211,211
5346,5346,,1602,0,177,177
5347,5347,,1028,0,0,0
5348,5348,,1012,0,211,211
5349,5349,,1029,0,0,0
5350,5350,,991,0,211,211
5351,5351,,991,0,211,211
5352,5352,,991,0,211,211
5353,5353,,991,0,211,211
5354,5354,,99,0,422,422
5355,5355,,991,0,211,211
5356,5356,,991,0,211,211
5357,5357,,991,0,211,211
5358,5358,,991,0,211,211
5359,5359,,991,0,211,211
5360,5360,,991,0,211,211
5361,5361,,991,0,211,211
5362,5362,,991,0,211,211
5363,5363,,1030,0,48,48
5364,5364,,991,0,211,211
5365,5365,,1031,0,0,0
5366,5366,,1032,0,0,0
5367,5367,,1033,0,0,0
5368,5368,,1034,0,0,0
5369,5369,,1035,0,0,0
5370,5370,,1036,0,30,30
5371,5371,,1036,2,0,2
5372,5372,,1036,4,0,4
5373,5373,,1036,5,0,5
5374,5374,,1036,3,0,3
5375,5375,,1036,1,0,1
5376,5376,,1036,2,0,2
5377,5377,,1036,3,0,3
5378,5378,,1036,4,0,4
5379,5379,,1036,2,0,2
5380,5380,,1036,2,0,2
5381,5381,,1036,1,0,1
5382,5382,,1036,1,0,1
5383,5383,,1037,0,0,0
5384,5384,,1038,0,0,0
5385,5385,,1039,0,0,0
5386,5386,,1040,0,0,0
5387,5387,,1041,0,0,0
5388,5388,,1042,0,0,0
5389,5389,,1043,0,0,0
5390,5390,,1044,0,0,0
5391,5391,,1045,0,0,0
5392,5392,,1046,0,0,0
5393,5393,,1047,0,0,0
5394,5394,,1048,0,0,0
5395,5395,,2208,0,1,1
5396,5396,,1049,0,0,0
5397,5397,,1050,0,0,0
5398,5398,,1051,0,0,0
5399,5399,,1052,0,0,0
5400,5400,,1053,0,0,0
5401,5401,,1054,0,0,0
5402,5402,,1952,1,11,12
5403,5403,,1952,1,4,5
5404,5404,,1952,2,0,2
5405,5405,,1952,2,0,2
5406,5406,,1952,2,0,2
5407,5407,,1952,2,0,2
5408,5408,,1952,3,0,3
5409,5409,,1952,0,3,3
5410,5410,,427,10,8,18
5411,5411,,1985,11,42,53
5412,5412,,1985,2,0,2
5413,5413,,1055,0,0,0
5414,5414,,427,1,1,2
5415,5415,,427,1,1,2
5416,5416,,1502,1,3,4
5417,5417,,1056,0,0,0
5418,5418,,1998,1,4,5
5419,5419,,427,1,1,2
5420,5420,,2063,4,5,9
5421,5421,,2063,1,2,3
5422,5422,,1057,0,2,2
5423,5423,,1057,2,0,2
5424,5424,,2063,1,5,6
5425,5425,,2063,1,6,7
5426,5426,,1203,1,1,2
5427,5427,,2063,1,3,4
5428,5428,,1058,0,0,0
5429,5429,,1059,0,0,0
5430,5430,,1060,0,0,0
5431,5431,,1078,0,10,10
5432,5432,,1078,2,0,2
5433,5433,,1078,1,0,1
5434,5434,,1061,0,0,0
5435,5435,,1974,0,5,5
5436,5436,,1974,2,0,2
5437,5437,,1974,4,0,4
5438,5438,,1974,1,2,3
5439,5439,,1062,0,0,0
5440,5440,,1063,0,0,0
5441,5441,,1064,0,0,0
5442,5442,,1065,0,0,0
5443,5443,,1066,0,0,0
5444,5444,,1067,0,0,0
5445,5445,,1068,0,0,0
5446,5446,,1974,0,6,6
5447,5447,,1069,0,0,0
5448,5448,,1070,0,0,0
5449,5449,,1071,0,0,0
5450,5450,,1974,1,0,1
5451,5451,,1072,0,0,0
5452,5452,,1073,0,0,0
5453,5453,,1952,12,0,12
5454,5454,,1074,0,0,0
5455,5455,,1974,2,6,8
5456,5456,,1974,2,0,2
5457,5457,,1974,2,0,2
5458,5458,,1974,3,0,3
5459,5459,,1974,1,0,1
5460,5460,,1075,0,0,0
5461,5461,,1076,0,0,0
5462,5462,,1077,0,0,0
5463,5463,,1078,2,0,2
5464,5464,,1078,3,0,3
5465,5465,,1078,2,0,2
5466,5466,,1082,0,2,2
5467,5467,,1079,0,0,0
5468,5468,,1080,0,0,0
5469,5469,,3289,4,0,4
5470,5470,,3289,3,0,3
5471,5471,,1081,0,0,0
5472,5472,,1082,1,0,1
5473,5473,,1082,1,0,1
5474,5474,,1083,0,0,0
5475,5475,,1084,0,0,0
5476,5476,,1085,0,0,0
5477,5477,,1086,0,0,0
5478,5478,,3289,18,0,18
5479,5479,,1952,20,25,45
5480,5480,,1087,0,0,0
5481,5481,,1088,0,0,0
5482,5482,,1089,0,0,0
5483,5483,,1952,1,0,1
5484,5484,,1952,2,0,2
5485,5485,,1090,0,0,0
5486,5486,,1952,2,0,2
5487,5487,,1952,2,0,2
5488,5488,,1952,1,4,5
5489,5489,,1952,2,0,2
5490,5490,,1952,3,2,5
5491,5491,,1952,3,0,3
5492,5492,,1952,4,0,4
5493,5493,,3289,4,8,12
5494,5494,,3289,1,39,40
5495,5495,,3289,1,33,34
5496,5496,,3289,1,30,31
5497,5497,,3289,1,0,1
5498,5498,,3289,1,40,41
5499,5499,,3289,0,1,1
5500,5500,,3289,0,11,11
5501,5501,,3289,0,21,21
5502,5502,,3289,0,25,25
5503,5503,,261,1,23,24
5504,5504,,1091,0,0,0
5505,5505,,3289,6,43,49
5506,5506,,3289,1,36,37
5507,5507,,1985,2,0,2
5508,5508,,1985,2,0,2
5509,5509,,1985,2,0,2
5510,5510,,1985,1,0,1
5511,5511,,1985,1,0,1
5512,5512,,1985,2,0,2
5513,5513,,1985,1,0,1
5514,5514,,1985,2,1,3
5515,5515,,1985,1,0,1
5516,5516,,1985,1,0,1
5517,5517,,1985,2,2,4
5518,5518,,1985,1,1,2
5519,5519,,1985,1,1,2
5520,5520,,1985,1,0,1
5521,5521,,1985,1,0,1
5522,5522,,1985,1,1,2
5523,5523,,1985,1,0,1
5524,5524,,1985,1,1,2
5525,5525,,1985,1,2,3
5526,5526,,1985,1,0,1
5527,5527,,1985,1,0,1
5528,5528,,1985,1,1,2
5529,5529,,1985,1,0,1
5530,5530,,1985,1,0,1
5531,5531,,1985,1,3,4
5532,5532,,1985,1,0,1
5533,5533,,1985,1,0,1
5534,5534,,1985,1,0,1
5535,5535,,1985,1,0,1
5536,5536,,1985,1,0,1
5537,5537,,1985,1,0,1
5538,5538,,1985,1,0,1
5539,5539,,1985,1,1,2
5540,5540,,1985,1,1,2
5541,5541,,2096,0,3,3
5542,5542,,2008,0,1,1
5543,5543,,1092,0,0,0
5544,5544,,1093,0,0,0
5545,5545,,1502,0,1,1
5546,5546,,1094,0,0,0
5547,5547,,1095,0,0,0
5548,5548,,1952,11,14,25
5549,5549,,1952,2,0,2
5550,5550,,1096,0,0,0
5551,5551,,1296,2,9,11
5552,5552,,1296,1,1,2
5553,5553,,1952,0,10,10
5554,5554,,1952,2,5,7
5555,5555,,1952,2,0,2
5556,5556,,1952,2,0,2
5557,5557,,1952,2,0,2
5558,5558,,1952,3,0,3
5559,5559,,1952,1,1,2
5560,5560,,1952,2,0,2
5561,5561,,1952,2,0,2
5562,5562,,1952,1,0,1
5563,5563,,1952,0,2,2
5564,5564,,1097,0,0,0
5565,5565,,1098,0,0,0
5566,5566,,1099,0,0,0
5567,5567,,1100,0,0,0
5568,5568,,1952,0,1,1
5569,5569,,1101,0,0,0
5570,5570,,1296,2,0,2
5571,5571,,1102,0,0,0
5572,5572,,1952,14,10,24
5573,5573,,1952,2,18,20
5574,5574,,1952,1,4,5
5575,5575,,1952,3,0,3
5576,5576,,1952,2,0,2
5577,5577,,1952,1,0,1
5578,5578,,1952,1,2,3
5579,5579,,1103,0,0,0
5580,5580,,1104,0,0,0
5581,5581,,3289,0,7,7
5582,5582,,1105,0,0,0
5583,5583,,3289,1,0,1
5584,5584,,3289,11,0,11
5585,5585,,3289,1,0,1
5586,5586,,3289,1,0,1
5587,5587,,3289,1,0,1
5588,5588,,3289,4,0,4
5589,5589,,3289,10,0,10
5590,5590,,3289,7,0,7
5591,5591,,3289,5,0,5
5592,5592,,3289,13,0,13
5593,5593,,1106,0,0,0
5594,5594,,1974,2,0,2
5595,5595,,1974,2,0,2
5596,5596,,1952,6,11,17
5597,5597,,1952,2,2,4
5598,5598,,1952,3,0,3
5599,5599,,1952,2,0,2
5600,5600,,1952,2,0,2
5601,5601,,1952,1,0,1
5602,5602,,1107,0,0,0
5603,5603,,1108,0,0,0
5604,5604,,1109,0,0,0
5605,5605,,1110,0,0,0
5606,5606,,1111,0,0,0
5607,5607,,1112,0,0,0
5608,5608,,1113,0,0,0
5609,5609,,1114,0,0,0
5610,5610,,1115,0,0,0
5611,5611,,1116,7,14,21
5612,5612,,1116,1,1,2
5613,5613,,1116,1,1,2
5614,5614,,1116,2,0,2
5615,5615,,1116,2,0,2
5616,5616,,1116,1,1,2
5617,5617,,1116,2,2,4
5618,5618,,1116,3,0,3
5619,5619,,1116,2,2,4
5620,5620,,1952,0,1,1
5621,5621,,1117,0,0,0
5622,5622,,1118,0,0,0
5623,5623,,1952,0,1,1
5624,5624,,1119,0,0,0
5625,5625,,1120,0,0,0
5626,5626,,1974,2,5,7
5627,5627,,1974,1,6,7
5628,5628,,1974,1,9,10
5629,5629,,1121,0,0,0
5630,5630,,1122,0,0,0
5631,5631,,1123,0,0,0
5632,5632,,1124,0,0,0
5633,5633,,1125,0,0,0
5634,5634,,1126,0,0,0
5635,5635,,1502,0,3,3
5636,5636,,1502,2,0,2
5637,5637,,1502,2,0,2
5638,5638,,1502,0,7,7
5639,5639,,1127,0,0,0
5640,5640,,1128,0,0,0
5641,5641,,1129,0,0,0
5642,5642,,1130,0,0,0
5643,5643,,1131,0,0,0
5644,5644,,1132,0,0,0
5645,5645,,1952,0,1,1
5646,5646,,1133,0,0,0
5647,5647,,3289,0,1,1
5648,5648,,3289,97,0,97
5649,5649,,3289,70,0,70
5650,5650,,3289,8,0,8
5651,5651,,3289,32,0,32
5652,5652,,3289,28,0,28
5653,5653,,3289,37,0,37
5654,5654,,3289,35,0,35
5655,5655,,3289,29,0,29
5656,5656,,3289,16,0,16
5657,5657,,3289,15,0,15
5658,5658,,1296,2,0,2
5659,5659,,1296,2,0,2
5660,5660,,1296,4,0,4
5661,5661,,1134,0,0,0
5662,5662,,1135,0,0,0
5663,5663,,1136,0,0,0
5664,5664,,1296,1,1,2
5665,5665,,2063,19,17,36
5666,5666,,2063,2,0,2
5667,5667,,2063,1,34,35
5668,5668,,2063,2,0,2
5669,5669,,2063,2,0,2
5670,5670,,2063,2,0,2
5671,5671,,2063,2,16,18
5672,5672,,2063,2,0,2
5673,5673,,2063,1,0,1
5674,5674,,2063,2,0,2
5675,5675,,1137,0,0,0
5676,5676,,1138,0,0,0
5677,5677,,1139,0,0,0
5678,5678,,3289,5,47,52
5679,5679,,3289,2,0,2
5680,5680,,3289,1,9,10
5681,5681,,3289,3,0,3
5682,5682,,3289,2,0,2
5683,5683,,3289,6,0,6
5684,5684,,3289,2,0,2
5685,5685,,3289,1,27,28
5686,5686,,3289,4,36,40
5687,5687,,3289,1,19,20
5688,5688,,3289,2,0,2
5689,5689,,3289,3,0,3
5690,5690,,3289,1,36,37
5691,5691,,3289,5,28,33
5692,5692,,3289,2,0,2
5693,5693,,3289,1,28,29
5694,5694,,3289,5,0,5
5695,5695,,3289,1,18,19
5696,5696,,1140,0,0,0
5697,5697,,1141,0,0,0
5698,5698,,3289,0,1,1
5699,5699,,1142,0,0,0
5700,5700,,1952,1,10,11
5701,5701,,1952,3,0,3
5702,5702,,1952,2,0,2
5703,5703,,1952,3,0,3
5704,5704,,1952,2,0,2
5705,5705,,1143,0,0,0
5706,5706,,1144,0,0,0
5707,5707,,1145,0,0,0
5708,5708,,1146,0,0,0
5709,5709,,1147,0,0,0
5710,5710,,1148,0,0,0
5711,5711,,261,2,3,5
5712,5712,,1502,2,4,6
5713,5713,,1502,1,5,6
5714,5714,,1502,1,4,5
5715,5715,,1646,0,1,1
5716,5716,,1149,0,0,0
5717,5717,,1952,2,0,2
5718,5718,,1952,2,0,2
5719,5719,,1952,4,0,4
5720,5720,,1952,2,14,16
5721,5721,,1150,0,0,0
5722,5722,,1952,39,18,57
5723,5723,,1952,1,2,3
5724,5724,,1952,1,1,2
5725,5725,,1952,1,2,3
5726,5726,,1952,2,0,2
5727,5727,,1952,1,13,14
5728,5728,,1952,1,2,3
5729,5729,,1151,0,0,0
5730,5730,,2008,0,5,5
5731,5731,,1152,0,0,0
5732,5732,,1153,0,0,0
5733,5733,,1296,2,0,2
5734,5734,,261,2,0,2
5735,5735,,261,3,0,3
5736,5736,,261,1,1,2
5737,5737,,261,1,1,2
5738,5738,,261,1,1,2
5739,5739,,261,1,1,2
5740,5740,,1154,0,20,20
5741,5741,,1154,4,0,4
5742,5742,,1154,2,0,2
5743,5743,,1154,2,0,2
5744,5744,,1154,3,0,3
5745,5745,,1154,3,0,3
5746,5746,,1154,5,0,5
5747,5747,,1154,1,0,1
5748,5748,,1155,0,0,0
5749,5749,,1156,0,0,0
5750,5750,,1157,0,0,0
5751,5751,,261,0,1,1
5752,5752,,1158,0,0,0
5753,5753,,1952,1,0,1
5754,5754,,1159,0,0,0
5755,5755,,1952,1,5,6
5756,5756,,1952,0,40,40
5757,5757,,1952,1,1,2
5758,5758,,1952,0,1,1
5759,5759,,1952,1,0,1
5760,5760,,1952,0,3,3
5761,5761,,1952,1,1,2
5762,5762,,1998,306,1,307
5763,5763,,1160,0,0,0
5764,5764,,261,1,374,375
5765,5765,,1161,0,0,0
5766,5766,,1162,0,0,0
5767,5767,,1323,0,1,1
5768,5768,,1163,0,0,0
5769,5769,,261,1,3,4
5770,5770,,1164,0,0,0
5771,5771,,1165,0,0,0
5772,5772,,1166,0,0,0
5773,5773,,360,0,1,1
5774,5774,,1499,7,22,29
5775,5775,,1499,2,0,2
5776,5776,,1499,2,0,2
5777,5777,,1499,2,0,2
5778,5778,,1499,2,0,2
5779,5779,,1499,2,7,9
5780,5780,,1499,1,0,1
5781,5781,,1499,1,0,1
5782,5782,,1499,2,1,3
5783,5783,,1499,2,0,2
5784,5784,,1499,1,0,1
5785,5785,,1499,1,0,1
5786,5786,,1167,0,0,0
5787,5787,,1168,0,0,0
5788,5788,,1296,2,11,13
5789,5789,,1296,1,16,17
5790,5790,,1296,1,3,4
5791,5791,,1296,2,0,2
5792,5792,,1296,1,0,1
5793,5793,,1169,0,0,0
5794,5794,,1170,0,0,0
5795,5795,,1171,0,0,0
5796,5796,,1172,0,0,0
5797,5797,,1952,0,2,2
5798,5798,,1952,27,0,27
5799,5799,,1952,4,0,4
5800,5800,,2011,3,0,3
5801,5801,,2011,1,0,1
5802,5802,,1974,0,1,1
5803,5803,,2096,2,0,2
5804,5804,,1974,7,0,7
5805,5805,,1173,0,0,0
5806,5806,,2063,2,0,2
5807,5807,,1174,0,0,0
5808,5808,,3289,2,0,2
5809,5809,,2096,1,0,1
5810,5810,,1175,0,0,0
5811,5811,,1176,0,0,0
5812,5812,,2063,0,2,2
5813,5813,,2063,3,0,3
5814,5814,,1952,0,2,2
5815,5815,,1952,40,0,40
5816,5816,,2072,392,0,392
5817,5817,,2072,528,0,528
5818,5818,,2072,887,0,887
5819,5819,,1502,11,0,11
5820,5820,,427,2,0,2
5821,5821,,1502,7,0,7
5822,5822,,1214,2,0,2
5823,5823,,1177,0,0,0
5824,5824,,1178,0,0,0
5825,5825,,1179,0,0,0
5826,5826,,1502,0,5,5
5827,5827,,1502,4,0,4
5828,5828,,1502,0,5,5
5829,5829,,1502,6,0,6
5830,5830,,1214,0,1,1
5831,5831,,1214,6,0,6
5832,5832,,1214,7,0,7
5833,5833,,2062,3,0,3
5834,5834,,1502,0,2,2
5835,5835,,1502,7,0,7
5836,5836,,1502,59,0,59
5837,5837,,1502,0,2,2
5838,5838,,1180,0,0,0
5839,5839,,1502,2,0,2
5840,5840,,2063,0,29,29
5841,5841,,2063,19,0,19
5842,5842,,2063,3,0,3
5843,5843,,2101,0,2,2
5844,5844,,2101,8,0,8
5845,5845,,1181,0,0,0
5846,5846,,1182,0,0,0
5847,5847,,1952,4,0,4
5848,5848,,1952,3,0,3
5849,5849,,1952,1,0,1
5850,5850,,1183,0,0,0
5851,5851,,1184,0,0,0
5852,5852,,1998,0,7,7
5853,5853,,1998,13,0,13
5854,5854,,1998,0,9,9
5855,5855,,1998,2,0,2
5856,5856,,1998,3,0,3
5857,5857,,1998,20,0,20
5858,5858,,1502,1,0,1
5859,5859,,1502,1,0,1
5860,5860,,1502,4,0,4
5861,5861,,1502,1,0,1
5862,5862,,1502,9,0,9
5863,5863,,1185,0,0,0
5864,5864,,1502,0,4,4
5865,5865,,1502,0,1,1
5866,5866,,1502,5,0,5
5867,5867,,2072,1,0,1
5868,5868,,1998,8,0,8
5869,5869,,1502,1,0,1
5870,5870,,1998,4,0,4
5871,5871,,1502,0,4,4
5872,5872,,1502,5,0,5
5873,5873,,1502,29,0,29
5874,5874,,1502,15,0,15
5875,5875,,427,3,0,3
5876,5876,,1502,3,0,3
5877,5877,,1502,4,0,4
5878,5878,,427,1,0,1
5879,5879,,1186,0,0,0
5880,5880,,1187,0,0,0
5881,5881,,1188,0,0,0
5882,5882,,2021,0,2,2
5883,5883,,2021,3,0,3
5884,5884,,1189,0,0,0
5885,5885,,1190,0,0,0
5886,5886,,1191,0,0,0
5887,5887,,1214,1,0,1
5888,5888,,1192,0,0,0
5889,5889,,1495,0,2,2
5890,5890,,1495,2,0,2
5891,5891,,1495,1,0,1
5892,5892,,1736,1,0,1
5893,5893,,2110,0,2,2
5894,5894,,2110,2,0,2
5895,5895,,427,0,1,1
5896,5896,,1502,7,0,7
5897,5897,,427,7,0,7
5898,5898,,2064,4,0,4
5899,5899,,2064,2,0,2
5900,5900,,1193,0,0,0
5901,5901,,1194,0,0,0
5902,5902,,1195,0,0,0
5903,5903,,1196,0,0,0
5904,5904,,1197,0,0,0
5905,5905,,1198,0,0,0
5906,5906,,1199,0,0,0
5907,5907,,1200,0,0,0
5908,5908,,1201,0,0,0
5909,5909,,1202,0,0,0
5910,5910,,1502,1,0,1
5911,5911,,1974,0,2,2
5912,5912,,427,11,0,11
5913,5913,,1974,2,0,2
5914,5914,,1502,0,1,1
5915,5915,,1502,7,0,7
5916,5916,,1502,16,0,16
5917,5917,,1502,0,2,2
5918,5918,,1502,4,0,4
5919,5919,,2048,0,18,18
5920,5920,,2048,4,0,4
5921,5921,,2048,20,0,20
5922,5922,,2048,22,0,22
5923,5923,,2048,5,0,5
5924,5924,,2048,4,0,4
5925,5925,,1203,4,0,4
5926,5926,,1204,0,0,0
5927,5927,,1952,1,0,1
5928,5928,,2013,0,2,2
5929,5929,,2013,3,0,3
5930,5930,,1998,0,3,3
5931,5931,,1998,12,0,12
5932,5932,,1985,0,2,2
5933,5933,,427,4,0,4
5934,5934,,1985,4,0,4
5935,5935,,2072,340,0,340
5936,5936,,1985,2,0,2
5937,5937,,1998,1,0,1
5938,5938,,1974,0,1,1
5939,5939,,1974,18,0,18
5940,5940,,1998,0,3,3
5941,5941,,1998,3,0,3
5942,5942,,1998,6,0,6
5943,5943,,1998,2,0,2
5944,5944,,1502,0,1,1
5945,5945,,1502,2,0,2
5946,5946,,1974,5,0,5
5947,5947,,1974,92,0,92
5948,5948,,1974,24,0,24
5949,5949,,1974,24,0,24
5950,5950,,1974,29,0,29
5951,5951,,1974,3,0,3
5952,5952,,46,2,0,2
5953,5953,,1974,8,0,8
5954,5954,,1974,5,0,5
5955,5955,,46,1,0,1
5956,5956,,1974,3,0,3
5957,5957,,46,3,0,3
5958,5958,,1998,0,11,11
5959,5959,,1998,4,0,4
5960,5960,,1205,0,0,0
5961,5961,,1206,0,0,0
5962,5962,,1952,0,32,32
5963,5963,,1207,0,0,0
5964,5964,,1952,8,0,8
5965,5965,,1952,2,0,2
5966,5966,,1952,2,0,2
5967,5967,,1602,8,0,8
5968,5968,,1208,0,0,0
5969,5969,,1209,0,0,0
5970,5970,,1952,8,0,8
5971,5971,,1952,2,0,2
5972,5972,,1952,7,0,7
5973,5973,,1210,0,0,0
5974,5974,,2110,0,2,2
5975,5975,,2072,6,0,6
5976,5976,,2110,2,0,2
5977,5977,,1998,0,3,3
5978,5978,,1998,4,0,4
5979,5979,,1211,0,0,0
5980,5980,,1998,2,0,2
5981,5981,,1212,0,0,0
5982,5982,,2063,1,0,1
5983,5983,,1952,2,0,2
5984,5984,,2063,13,0,13
5985,5985,,1974,0,1,1
5986,5986,,1974,2,0,2
5987,5987,,1502,4,0,4
5988,5988,,1502,3,0,3
5989,5989,,3046,0,4,4
5990,5990,,3046,1,0,1
5991,5991,,1502,0,2,2
5992,5992,,1502,5,0,5
5993,5993,,2110,0,4,4
5994,5994,,2110,4,0,4
5995,5995,,2110,2,0,2
5996,5996,,2110,3,0,3
5997,5997,,2110,3,0,3
5998,5998,,1502,0,1,1
5999,5999,,1502,5,0,5
6000,6000,,1213,0,0,0
6001,6001,,1502,12,0,12
6002,6002,,1502,3,0,3
6003,6003,,1974,11,0,11
6004,6004,,2072,0,1,1
6005,6005,,2072,6,0,6
6006,6006,,2072,0,176,176
6007,6007,,158,2,0,2
6008,6008,,1502,13,0,13
6009,6009,,2074,4,0,4
6010,6010,,1974,0,12,12
6011,6011,,1974,26,0,26
6012,6012,,1214,196,0,196
6013,6013,,1985,8,0,8
6014,6014,,1974,1,0,1
6015,6015,,427,4,0,4
6016,6016,,1502,2,0,2
6017,6017,,1502,5,0,5
6018,6018,,1502,0,2,2
6019,6019,,1998,0,1,1
6020,6020,,1215,0,0,0
6021,6021,,1502,0,2,2
6022,6022,,1502,5,0,5
6023,6023,,1502,9,0,9
6024,6024,,1502,0,2,2
6025,6025,,1998,4,0,4
6026,6026,,1502,5,0,5
6027,6027,,1952,0,2,2
6028,6028,,1952,11,0,11
6029,6029,,1216,0,0,0
6030,6030,,1217,0,0,0
6031,6031,,1218,2,0,2
6032,6032,,1985,0,16,16
6033,6033,,1219,0,0,0
6034,6034,,2048,1,0,1
6035,6035,,1985,1,0,1
6036,6036,,1504,1,0,1
6037,6037,,1985,3,0,3
6038,6038,,2048,11,0,11
6039,6039,,2048,14,0,14
6040,6040,,1220,0,0,0
6041,6041,,1221,0,0,0
6042,6042,,1222,0,0,0
6043,6043,,1223,0,0,0
6044,6044,,1224,0,0,0
6045,6045,,1225,0,0,0
6046,6046,,1226,0,0,0
6047,6047,,1227,0,0,0
6048,6048,,2062,3,0,3
6049,6049,,760,1,0,1
6050,6050,,520,1,0,1
6051,6051,,520,1,0,1
6052,6052,,1228,0,0,0
6053,6053,,1952,0,94,94
6054,6054,,1952,15,0,15
6055,6055,,1998,4,0,4
6056,6056,,1502,0,1,1
6057,6057,,1502,3,0,3
6058,6058,,1985,1,0,1
6059,6059,,1214,10,0,10
6060,6060,,1229,0,0,0
6061,6061,,1230,0,0,0
6062,6062,,1231,0,0,0
6063,6063,,1232,0,0,0
6064,6064,,1502,4,0,4
6065,6065,,1502,9,0,9
6066,6066,,1502,33,0,33
6067,6067,,1502,10,0,10
6068,6068,,1502,16,0,16
6069,6069,,1502,1,0,1
6070,6070,,1233,0,0,0
6071,6071,,1234,0,0,0
6072,6072,,1502,0,2,2
6073,6073,,1502,2,0,2
6074,6074,,1502,5,0,5
6075,6075,,1235,0,0,0
6076,6076,,1236,0,0,0
6077,6077,,1237,0,0,0
6078,6078,,1602,3,0,3
6079,6079,,1363,2,0,2
6080,6080,,1839,0,2,2
6081,6081,,1839,4,0,4
6082,6082,,1502,0,2,2
6083,6083,,1502,4,0,4
6084,6084,,2008,0,3,3
6085,6085,,2008,3,0,3
6086,6086,,2008,4,0,4
6087,6087,,2008,2,0,2
6088,6088,,1238,0,0,0
6089,6089,,807,2,0,2
6090,6090,,1998,5,0,5
6091,6091,,2063,0,4,4
6092,6092,,2063,1,0,1
6093,6093,,1214,5,0,5
6094,6094,,1214,1,0,1
6095,6095,,2063,3,0,3
6096,6096,,2063,8,0,8
6097,6097,,1974,0,1,1
6098,6098,,2048,1,0,1
6099,6099,,2190,2,0,2
6100,6100,,3914,0,403,403
6101,6101,,1602,3,0,3
6102,6102,,1239,1,0,1
6103,6103,,1952,0,2,2
6104,6104,,1998,0,2,2
6105,6105,,1998,2,0,2
6106,6106,,2063,4,0,4
6107,6107,,2063,1,0,1
6108,6108,,1502,0,8,8
6109,6109,,1985,3,0,3
6110,6110,,1502,8,0,8
6111,6111,,1240,0,0,0
6112,6112,,1901,1,0,1
6113,6113,,1241,0,0,0
6114,6114,,2101,0,2,2
6115,6115,,2101,6,0,6
6116,6116,,2101,3,0,3
6117,6117,,2101,3,0,3
6118,6118,,1242,0,0,0
6119,6119,,1839,0,10,10
6120,6120,,1974,7,0,7
6121,6121,,2048,0,9,9
6122,6122,,2048,6,0,6
6123,6123,,1974,2,0,2
6124,6124,,1214,2,0,2
6125,6125,,1243,0,0,0
6126,6126,,1244,0,0,0
6127,6127,,1245,0,0,0
6128,6128,,1502,0,1,1
6129,6129,,1952,0,211,211
6130,6130,,1246,0,0,0
6131,6131,,1952,11,0,11
6132,6132,,1952,0,3,3
6133,6133,,3912,3,0,3
6134,6134,,1247,0,0,0
6135,6135,,2096,0,3,3
6136,6136,,2096,6,0,6
6137,6137,,1248,0,0,0
6138,6138,,1249,0,0,0
6139,6139,,1250,0,0,0
6140,6140,,1251,0,0,0
6141,6141,,1252,0,0,0
6142,6142,,1253,0,0,0
6143,6143,,3289,5,0,5
6144,6144,,1502,3,0,3
6145,6145,,1254,0,0,0
6146,6146,,1256,0,1,1
6147,6147,,1255,0,0,0
6148,6148,,1256,1,0,1
6149,6149,,1952,0,17,17
6150,6150,,1952,27,0,27
6151,6151,,1952,11,0,11
6152,6152,,1952,3,0,3
6153,6153,,1952,5,0,5
6154,6154,,1952,3,0,3
6155,6155,,1952,2,0,2
6156,6156,,1952,7,0,7
6157,6157,,1952,2,0,2
6158,6158,,1952,2,0,2
6159,6159,,1952,8,0,8
6160,6160,,1952,3,0,3
6161,6161,,1257,0,0,0
6162,6162,,1258,0,0,0
6163,6163,,1952,4,0,4
6164,6164,,1502,0,3,3
6165,6165,,1259,0,0,0
6166,6166,,1260,0,0,0
6167,6167,,2072,0,2,2
6168,6168,,2072,0,77,77
6169,6169,,1502,15,0,15
6170,6170,,2110,0,3,3
6171,6171,,2110,3,0,3
6172,6172,,1502,2,0,2
6173,6173,,1502,3,0,3
6174,6174,,1502,0,2,2
6175,6175,,1502,18,0,18
6176,6176,,2096,0,101,101
6177,6177,,2096,3,0,3
6178,6178,,1261,0,0,0
6179,6179,,1262,0,0,0
6180,6180,,2048,9,0,9
6181,6181,,1502,0,2,2
6182,6182,,1502,2,0,2
6183,6183,,1263,0,0,0
6184,6184,,1264,0,0,0
6185,6185,,869,1,0,1
6186,6186,,1502,0,2,2
6187,6187,,1502,4,0,4
6188,6188,,1502,6,0,6
6189,6189,,1502,4,0,4
6190,6190,,2072,371,0,371
6191,6191,,1998,0,3,3
6192,6192,,1998,9,0,9
6193,6193,,1998,2,0,2
6194,6194,,2110,2,0,2
6195,6195,,1602,0,49,49
6196,6196,,1602,2,0,2
6197,6197,,2048,5,0,5
6198,6198,,1974,9,0,9
6199,6199,,1265,0,0,0
6200,6200,,1952,5,0,5
6201,6201,,1952,9,0,9
6202,6202,,1952,8,0,8
6203,6203,,1266,0,0,0
6204,6204,,2101,1,0,1
6205,6205,,1952,0,2,2
6206,6206,,1985,0,3,3
6207,6207,,1985,11,0,11
6208,6208,,1998,0,4,4
6209,6209,,427,7,0,7
6210,6210,,1998,7,0,7
6211,6211,,1998,6,0,6
6212,6212,,1502,0,2,2
6213,6213,,1502,13,0,13
6214,6214,,1502,1,0,1
6215,6215,,1502,0,1,1
6216,6216,,1502,5,0,5
6217,6217,,1267,0,0,0
6218,6218,,1268,0,0,0
6219,6219,,1269,0,0,0
6220,6220,,1270,0,0,0
6221,6221,,1839,2,0,2
6222,6222,,1271,0,0,0
6223,6223,,1502,0,2,2
6224,6224,,1502,6,0,6
6225,6225,,1272,0,1,1
6226,6226,,1272,1,0,1
6227,6227,,1273,0,0,0
6228,6228,,1502,0,1,1
6229,6229,,1274,0,0,0
6230,6230,,1502,2,0,2
6231,6231,,1952,0,7,7
6232,6232,,1952,1,0,1
6233,6233,,1952,7,0,7
6234,6234,,2096,0,7,7
6235,6235,,2096,2,0,2
6236,6236,,2096,2,0,2
6237,6237,,2096,1,0,1
6238,6238,,1502,3,0,3
6239,6239,,1952,0,6,6
6240,6240,,1952,34,0,34
6241,6241,,1502,0,3,3
6242,6242,,1502,7,0,7
6243,6243,,1998,0,3,3
6244,6244,,1998,2,0,2
6245,6245,,1998,5,0,5
6246,6246,,1974,0,18,18
6247,6247,,1985,0,729,729
6248,6248,,1985,2,0,2
6249,6249,,2110,7,0,7
6250,6250,,1998,0,2,2
6251,6251,,1998,3,0,3
6252,6252,,1952,0,5,5
6253,6253,,1952,12,0,12
6254,6254,,1952,4,0,4
6255,6255,,1952,0,19,19
6256,6256,,1952,8,0,8
6257,6257,,1952,8,0,8
6258,6258,,1502,0,2,2
6259,6259,,1502,3,0,3
6260,6260,,427,1,0,1
6261,6261,,1275,0,0,0
6262,6262,,1502,28,0,28
6263,6263,,1276,0,0,0
6264,6264,,1277,0,0,0
6265,6265,,1502,2,0,2
6266,6266,,1502,0,6,6
6267,6267,,1502,10,0,10
6268,6268,,1502,8,0,8
6269,6269,,2048,0,2,2
6270,6270,,1447,1,0,1
6271,6271,,1998,0,6,6
6272,6272,,1998,9,0,9
6273,6273,,1998,2,0,2
6274,6274,,1998,6,0,6
6275,6275,,1998,8,0,8
6276,6276,,1998,8,0,8
6277,6277,,1998,2,0,2
6278,6278,,2020,2,0,2
6279,6279,,1278,0,0,0
6280,6280,,1279,0,0,0
6281,6281,,1280,0,0,0
6282,6282,,1502,0,2,2
6283,6283,,1502,1,0,1
6284,6284,,1502,5,0,5
6285,6285,,1502,7,0,7
6286,6286,,1502,1,0,1
6287,6287,,1502,6,0,6
6288,6288,,1502,15,0,15
6289,6289,,1952,0,12,12
6290,6290,,1952,23,0,23
6291,6291,,1502,0,3,3
6292,6292,,1502,7,0,7
6293,6293,,1281,0,0,0
6294,6294,,555,1,0,1
6295,6295,,1282,0,0,0
6296,6296,,1283,0,0,0
6297,6297,,1284,0,0,0
6298,6298,,1285,0,0,0
6299,6299,,1502,2,0,2
6300,6300,,1214,0,1,1
6301,6301,,1286,0,0,0
6302,6302,,1287,0,0,0
6303,6303,,1974,0,6,6
6304,6304,,1974,10,0,10
6305,6305,,2063,0,2,2
6306,6306,,2063,18,0,18
6307,6307,,2063,2,0,2
6308,6308,,1974,12,0,12
6309,6309,,1288,0,0,0
6310,6310,,1998,2,0,2
6311,6311,,427,1,0,1
6312,6312,,3289,0,17,17
6313,6313,,1502,2,0,2
6314,6314,,1289,0,0,0
6315,6315,,3289,1,0,1
6316,6316,,1290,0,0,0
6317,6317,,1291,0,0,0
6318,6318,,1292,0,0,0
6319,6319,,1293,0,0,0
6320,6320,,1294,0,0,0
6321,6321,,1295,0,0,0
6322,6322,,1296,16,0,16
6323,6323,,1974,0,1,1
6324,6324,,1297,0,0,0
6325,6325,,1502,0,4,4
6326,6326,,2048,10,0,10
6327,6327,,1214,0,2,2
6328,6328,,1952,13,0,13
6329,6329,,1985,3,0,3
6330,6330,,1502,0,2,2
6331,6331,,1502,11,0,11
6332,6332,,1298,0,4,4
6333,6333,,1298,4,0,4
6334,6334,,1502,0,2,2
6335,6335,,1299,0,0,0
6336,6336,,2074,1,0,1
6337,6337,,1502,2,0,2
6338,6338,,1502,3,0,3
6339,6339,,1502,3,0,3
6340,6340,,2063,0,10,10
6341,6341,,2063,4,0,4
6342,6342,,2063,1,0,1
6343,6343,,1985,0,4,4
6344,6344,,1985,3,0,3
6345,6345,,1985,2,0,2
6346,6346,,1952,1,0,1
6347,6347,,1985,2,0,2
6348,6348,,1502,0,3,3
6349,6349,,427,6,0,6
6350,6350,,1974,0,21,21
6351,6351,,1974,4,0,4
6352,6352,,1974,4,0,4
6353,6353,,1974,2,0,2
6354,6354,,1974,3,0,3
6355,6355,,1974,2,0,2
6356,6356,,2048,0,4,4
6357,6357,,1974,15,0,15
6358,6358,,1974,4,0,4
6359,6359,,1214,2,0,2
6360,6360,,1214,5,0,5
6361,6361,,2063,0,5,5
6362,6362,,2063,6,0,6
6363,6363,,2063,6,0,6
6364,6364,,2063,10,0,10
6365,6365,,1300,0,0,0
6366,6366,,1774,1,0,1
6367,6367,,1301,0,0,0
6368,6368,,1985,1,0,1
6369,6369,,46,1,0,1
6370,6370,,1302,0,0,0
6371,6371,,1985,0,360,360
6372,6372,,1502,4,0,4
6373,6373,,1502,6,0,6
6374,6374,,1502,3,0,3
6375,6375,,1985,7,0,7
6376,6376,,1985,4,0,4
6377,6377,,1303,0,0,0
6378,6378,,1304,0,0,0
6379,6379,,1305,0,0,0
6380,6380,,1306,0,0,0
6381,6381,,1307,0,0,0
6382,6382,,1308,0,0,0
6383,6383,,1309,0,0,0
6384,6384,,2048,6,0,6
6385,6385,,2048,6,0,6
6386,6386,,2048,3,0,3
6387,6387,,2048,8,0,8
6388,6388,,1502,0,2,2
6389,6389,,1502,3,0,3
6390,6390,,1310,0,0,0
6391,6391,,1952,14,0,14
6392,6392,,1952,27,0,27
6393,6393,,1952,14,0,14
6394,6394,,1311,0,0,0
6395,6395,,1312,0,0,0
6396,6396,,1313,0,0,0
6397,6397,,1314,0,0,0
6398,6398,,1315,0,0,0
6399,6399,,1502,8,0,8
6400,6400,,1214,0,39,39
6401,6401,,1502,0,3,3
6402,6402,,1502,0,4,4
6403,6403,,1502,12,0,12
6404,6404,,1502,2,0,2
6405,6405,,1502,0,3,3
6406,6406,,1502,3,0,3
6407,6407,,1502,0,1,1
6408,6408,,1502,10,0,10
6409,6409,,1316,0,0,0
6410,6410,,1502,3,0,3
6411,6411,,1502,0,3,3
6412,6412,,1502,6,0,6
6413,6413,,1502,2,0,2
6414,6414,,1985,0,305,305
6415,6415,,1502,6,0,6
6416,6416,,1502,4,0,4
6417,6417,,1985,4,0,4
6418,6418,,1985,2,0,2
6419,6419,,1317,0,1,1
6420,6420,,1317,1,0,1
6421,6421,,1502,0,4,4
6422,6422,,1318,0,0,0
6423,6423,,1319,0,0,0
6424,6424,,1320,0,0,0
6425,6425,,1502,0,4,4
6426,6426,,1502,7,0,7
6427,6427,,1502,0,1,1
6428,6428,,1321,0,0,0
6429,6429,,1322,0,0,0
6430,6430,,2157,2,0,2
6431,6431,,1502,0,4,4
6432,6432,,1502,4,0,4
6433,6433,,1502,5,0,5
6434,6434,,1502,3,0,3
6435,6435,,1502,0,4,4
6436,6436,,1502,5,0,5
6437,6437,,1952,0,1,1
6438,6438,,1499,1,0,1
6439,6439,,2074,0,354,354
6440,6440,,2074,2,0,2
6441,6441,,1502,0,2,2
6442,6442,,1502,2,0,2
6443,6443,,1985,0,2,2
6444,6444,,1985,7,0,7
6445,6445,,1985,1,0,1
6446,6446,,1323,1,0,1
6447,6447,,1324,0,0,0
6448,6448,,2096,0,2,2
6449,6449,,2096,3,0,3
6450,6450,,1985,0,2,2
6451,6451,,1325,0,0,0
6452,6452,,699,2,0,2
6453,6453,,1214,0,2,2
6454,6454,,1974,0,2,2
6455,6455,,1974,0,7,7
6456,6456,,1946,1,0,1
6457,6457,,1974,3,0,3
6458,6458,,1974,3,0,3
6459,6459,,1326,0,0,0
6460,6460,,1327,0,0,0
6461,6461,,1502,3,0,3
6462,6462,,1502,0,4,4
6463,6463,,1502,0,1,1
6464,6464,,1502,0,3,3
6465,6465,,1502,16,0,16
6466,6466,,1502,3,0,3
6467,6467,,1328,0,0,0
6468,6468,,1952,3,0,3
6469,6469,,1952,4,0,4
6470,6470,,1214,4,0,4
6471,6471,,1329,0,0,0
6472,6472,,1330,0,0,0
6473,6473,,2048,1,0,1
6474,6474,,1331,0,0,0
6475,6475,,1998,0,6,6
6476,6476,,1998,10,0,10
6477,6477,,2096,0,2,2
6478,6478,,1332,0,0,0
6479,6479,,2096,1,0,1
6480,6480,,1502,0,5,5
6481,6481,,1502,3,0,3
6482,6482,,1333,0,0,0
6483,6483,,1334,0,0,0
6484,6484,,1952,0,7,7
6485,6485,,1952,1,0,1
6486,6486,,2008,8,0,8
6487,6487,,1952,0,3,3
6488,6488,,1952,6,0,6
6489,6489,,1502,0,2,2
6490,6490,,1502,0,2,2
6491,6491,,1502,11,0,11
6492,6492,,1502,5,0,5
6493,6493,,1985,0,1,1
6494,6494,,1502,0,1,1
6495,6495,,427,1,0,1
6496,6496,,1952,0,2,2
6497,6497,,1952,4,0,4
6498,6498,,1952,2,0,2
6499,6499,,1335,0,0,0
6500,6500,,1336,0,0,0
6501,6501,,1337,0,0,0
6502,6502,,1338,0,0,0
6503,6503,,1502,2,0,2
6504,6504,,1998,7,0,7
6505,6505,,2063,1,0,1
6506,6506,,2062,1,0,1
6507,6507,,1339,0,0,0
6508,6508,,1998,0,2,2
6509,6509,,1502,0,2,2
6510,6510,,1340,0,0,0
6511,6511,,1214,0,3,3
6512,6512,,1985,8,0,8
6513,6513,,1341,0,0,0
6514,6514,,1985,7,0,7
6515,6515,,1342,0,0,0
6516,6516,,1343,0,0,0
6517,6517,,3289,61,1,62
6518,6518,,3289,1,0,1
6519,6519,,1998,0,2,2
6520,6520,,1344,0,0,0
6521,6521,,1998,1,0,1
6522,6522,,1502,0,1,1
6523,6523,,2063,0,4,4
6524,6524,,1502,0,3,3
6525,6525,,3289,0,19,19
6526,6526,,3289,1,0,1
6527,6527,,1502,5,0,5
6528,6528,,1345,0,0,0
6529,6529,,1985,0,399,399
6530,6530,,1985,3,0,3
6531,6531,,1346,0,0,0
6532,6532,,1347,0,0,0
6533,6533,,1348,0,0,0
6534,6534,,1502,0,2,2
6535,6535,,1349,0,0,0
6536,6536,,2110,1,0,1
6537,6537,,2063,0,2,2
6538,6538,,2063,6,0,6
6539,6539,,1502,0,2,2
6540,6540,,1998,0,5,5
6541,6541,,1998,1,0,1
6542,6542,,2063,2,0,2
6543,6543,,1998,5,0,5
6544,6544,,1839,0,13,13
6545,6545,,1946,2,0,2
6546,6546,,1952,0,25,25
6547,6547,,1952,22,0,22
6548,6548,,1350,0,0,0
6549,6549,,1351,0,0,0
6550,6550,,1352,0,0,0
6551,6551,,1353,0,0,0
6552,6552,,2072,1,0,1
6553,6553,,1504,1,0,1
6554,6554,,1998,1,0,1
6555,6555,,1502,0,3,3
6556,6556,,1502,5,0,5
6557,6557,,1502,2,0,2
6558,6558,,1998,0,2,2
6559,6559,,1998,1,0,1
6560,6560,,3289,0,8,8
6561,6561,,1354,0,0,0
6562,6562,,1502,0,2,2
6563,6563,,1998,0,2,2
6564,6564,,1998,10,0,10
6565,6565,,1998,6,0,6
6566,6566,,1502,13,0,13
6567,6567,,3289,0,19,19
6568,6568,,1998,1,0,1
6569,6569,,1355,0,0,0
6570,6570,,3289,1,0,1
6571,6571,,3289,1,0,1
6572,6572,,1356,0,0,0
6573,6573,,1357,0,0,0
6574,6574,,2110,0,2,2
6575,6575,,1974,0,17,17
6576,6576,,1502,0,2,2
6577,6577,,1358,0,2,2
6578,6578,,1998,1,0,1
6579,6579,,1358,2,0,2
6580,6580,,1985,0,11,11
6581,6581,,1985,4,0,4
6582,6582,,1985,7,0,7
6583,6583,,2008,3,0,3
6584,6584,,1359,0,0,0
6585,6585,,2008,1,0,1
6586,6586,,427,2,0,2
6587,6587,,3289,0,3,3
6588,6588,,3289,1,0,1
6589,6589,,1360,0,0,0
6590,6590,,1986,1,0,1
6591,6591,,1361,0,0,0
6592,6592,,1998,0,2,2
6593,6593,,1502,11,0,11
6594,6594,,1502,0,2,2
6595,6595,,1502,0,2,2
6596,6596,,1502,4,0,4
6597,6597,,1362,0,0,0
6598,6598,,1363,0,2,2
6599,6599,,1952,0,267,267
6600,6600,,1952,5,0,5
6601,6601,,1974,43,0,43
6602,6602,,1502,0,5,5
6603,6603,,1502,15,0,15
6604,6604,,1502,3,0,3
6605,6605,,1502,2,0,2
6606,6606,,427,10,0,10
6607,6607,,1364,0,0,0
6608,6608,,1365,0,0,0
6609,6609,,1366,0,0,0
6610,6610,,1367,0,0,0
6611,6611,,1368,0,0,0
6612,6612,,427,1,0,1
6613,6613,,427,0,2,2
6614,6614,,427,5,0,5
6615,6615,,427,1,0,1
6616,6616,,1369,0,0,0
6617,6617,,1974,6,0,6
6618,6618,,1370,0,0,0
6619,6619,,1998,2,0,2
6620,6620,,1974,1,0,1
6621,6621,,427,0,2,2
6622,6622,,427,3,0,3
6623,6623,,427,6,0,6
6624,6624,,1371,0,0,0
6625,6625,,1372,0,0,0
6626,6626,,2048,8,0,8
6627,6627,,1998,0,1,1
6628,6628,,1998,4,0,4
6629,6629,,1373,0,0,0
6630,6630,,1374,0,0,0
6631,6631,,1502,0,1,1
6632,6632,,1375,0,0,0
6633,6633,,2062,0,3,3
6634,6634,,2062,3,0,3
6635,6635,,2062,3,0,3
6636,6636,,1502,0,8,8
6637,6637,,1502,5,0,5
6638,6638,,1502,5,0,5
6639,6639,,1502,7,0,7
6640,6640,,1502,7,0,7
6641,6641,,1376,0,0,0
6642,6642,,1377,0,0,0
6643,6643,,1378,0,0,0
6644,6644,,1974,1,0,1
6645,6645,,1502,3,0,3
6646,6646,,1839,2,0,2
6647,6647,,1839,2,0,2
6648,6648,,1379,0,0,0
6649,6649,,1985,0,7,7
6650,6650,,1380,0,0,0
6651,6651,,1952,0,1,1
6652,6652,,1998,0,3,3
6653,6653,,1998,13,0,13
6654,6654,,1998,1,0,1
6655,6655,,1998,1,0,1
6656,6656,,2048,0,7,7
6657,6657,,1381,0,0,0
6658,6658,,2048,0,1,1
6659,6659,,1502,0,2,2
6660,6660,,1502,5,0,5
6661,6661,,1998,0,22,22
6662,6662,,1998,4,0,4
6663,6663,,1382,0,0,0
6664,6664,,1952,4,0,4
6665,6665,,1952,2,0,2
6666,6666,,1383,0,0,0
6667,6667,,1952,14,0,14
6668,6668,,1952,6,0,6
6669,6669,,1952,2,0,2
6670,6670,,1952,10,0,10
6671,6671,,1952,12,0,12
6672,6672,,1384,0,0,0
6673,6673,,1385,0,0,0
6674,6674,,1952,12,0,12
6675,6675,,1952,10,0,10
6676,6676,,1386,0,0,0
6677,6677,,1952,4,0,4
6678,6678,,1387,0,0,0
6679,6679,,1388,0,0,0
6680,6680,,1389,0,0,0
6681,6681,,1390,0,0,0
6682,6682,,1391,0,0,0
6683,6683,,1998,0,4,4
6684,6684,,1502,0,4,4
6685,6685,,1502,11,0,11
6686,6686,,1392,0,0,0
6687,6687,,1393,0,0,0
6688,6688,,1394,0,0,0
6689,6689,,1952,0,2,2
6690,6690,,1974,0,2,2
6691,6691,,1974,2,0,2
6692,6692,,1974,3,0,3
6693,6693,,1395,0,0,0
6694,6694,,1396,0,2,2
6695,6695,,1396,2,0,2
6696,6696,,2101,0,2,2
6697,6697,,1985,4,0,4
6698,6698,,1998,0,10,10
6699,6699,,1998,2,0,2
6700,6700,,1998,12,0,12
6701,6701,,1839,0,2,2
6702,6702,,1839,3,0,3
6703,6703,,1974,0,3,3
6704,6704,,1974,7,0,7
6705,6705,,1397,0,0,0
6706,6706,,1502,314,0,314
6707,6707,,1398,0,0,0
6708,6708,,1502,7,0,7
6709,6709,,1502,2,0,2
6710,6710,,1399,0,0,0
6711,6711,,1502,2,0,2
6712,6712,,1400,0,0,0
6713,6713,,2074,3,0,3
6714,6714,,1401,0,0,0
6715,6715,,2063,2,0,2
6716,6716,,1952,0,11,11
6717,6717,,1952,12,0,12
6718,6718,,1502,0,1,1
6719,6719,,1502,3,0,3
6720,6720,,1502,2,0,2
6721,6721,,1974,0,2,2
6722,6722,,1974,7,0,7
6723,6723,,1402,0,0,0
6724,6724,,1502,0,3,3
6725,6725,,1502,6,0,6
6726,6726,,1985,0,210,210
6727,6727,,1502,3,0,3
6728,6728,,1403,0,0,0
6729,6729,,1404,0,0,0
6730,6730,,1405,0,0,0
6731,6731,,1502,0,3,3
6732,6732,,1499,0,1,1
6733,6733,,1499,3,0,3
6734,6734,,1952,6,0,6
6735,6735,,1406,0,0,0
6736,6736,,1407,0,0,0
6737,6737,,1408,0,0,0
6738,6738,,1409,0,0,0
6739,6739,,1410,0,0,0
6740,6740,,1411,0,0,0
6741,6741,,2110,1,0,1
6742,6742,,1412,0,0,0
6743,6743,,1952,2,0,2
6744,6744,,1952,1,0,1
6745,6745,,1413,0,0,0
6746,6746,,1414,0,0,0
6747,6747,,1502,2,0,2
6748,6748,,1415,0,0,0
6749,6749,,1416,0,0,0
6750,6750,,1417,0,0,0
6751,6751,,1502,0,1,1
6752,6752,,1502,8,0,8
6753,6753,,1502,2,0,2
6754,6754,,206,1,0,1
6755,6755,,1418,0,0,0
6756,6756,,1214,0,2,2
6757,6757,,1419,0,0,0
6758,6758,,427,16,0,16
6759,6759,,1952,0,2,2
6760,6760,,1952,10,0,10
6761,6761,,1502,0,1,1
6762,6762,,2063,0,3,3
6763,6763,,2063,16,0,16
6764,6764,,2063,16,0,16
6765,6765,,2063,14,0,14
6766,6766,,1952,1,0,1
6767,6767,,1952,0,2,2
6768,6768,,1502,0,5,5
6769,6769,,1420,0,4,4
6770,6770,,1420,2,0,2
6771,6771,,1420,2,0,2
6772,6772,,2062,2,0,2
6773,6773,,1421,0,0,0
6774,6774,,1422,0,0,0
6775,6775,,1423,0,0,0
6776,6776,,1424,0,0,0
6777,6777,,1502,1,0,1
6778,6778,,1425,0,0,0
6779,6779,,1502,0,18,18
6780,6780,,1502,277,0,277
6781,6781,,1502,45,0,45
6782,6782,,1502,11,0,11
6783,6783,,1502,0,2,2
6784,6784,,1426,0,1,1
6785,6785,,1426,1,0,1
6786,6786,,1427,0,0,0
6787,6787,,1998,0,8,8
6788,6788,,1998,0,2,2
6789,6789,,1998,3,0,3
6790,6790,,1998,0,1,1
6791,6791,,158,9,0,9
6792,6792,,1502,0,6,6
6793,6793,,1502,3,0,3
6794,6794,,1502,9,0,9
6795,6795,,1502,2,0,2
6796,6796,,1428,0,0,0
6797,6797,,1952,6,0,6
6798,6798,,1952,6,0,6
6799,6799,,1429,0,0,0
6800,6800,,1952,9,0,9
6801,6801,,1430,0,0,0
6802,6802,,1431,0,0,0
6803,6803,,1432,0,0,0
6804,6804,,1433,0,0,0
6805,6805,,1952,2,0,2
6806,6806,,1434,0,2,2
6807,6807,,1434,4,0,4
6808,6808,,2101,0,2,2
6809,6809,,2101,6,0,6
6810,6810,,1435,0,0,0
6811,6811,,1502,2,0,2
6812,6812,,427,1,0,1
6813,6813,,2101,3,0,3
6814,6814,,1952,0,2,2
6815,6815,,1952,13,0,13
6816,6816,,1952,8,0,8
6817,6817,,1998,0,19,19
6818,6818,,1998,2,0,2
6819,6819,,1436,0,0,0
6820,6820,,2062,4,0,4
6821,6821,,1437,0,0,0
6822,6822,,1952,2,0,2
6823,6823,,1438,0,0,0
6824,6824,,1985,3,0,3
6825,6825,,1602,7,0,7
6826,6826,,1602,11,0,11
6827,6827,,1502,1,0,1
6828,6828,,1439,0,0,0
6829,6829,,1440,0,0,0
6830,6830,,1974,0,5,5
6831,6831,,1502,0,8,8
6832,6832,,1502,2,0,2
6833,6833,,1502,3,0,3
6834,6834,,1502,0,2,2
6835,6835,,1974,2,0,2
6836,6836,,1502,0,4,4
6837,6837,,1502,3,0,3
6838,6838,,1974,1,0,1
6839,6839,,1502,0,5,5
6840,6840,,1502,2,0,2
6841,6841,,1502,3,0,3
6842,6842,,1502,2,0,2
6843,6843,,1985,0,13,13
6844,6844,,1985,4,0,4
6845,6845,,1441,0,0,0
6846,6846,,1952,0,2,2
6847,6847,,1974,0,3,3
6848,6848,,1974,3,0,3
6849,6849,,1952,0,26,26
6850,6850,,1952,27,0,27
6851,6851,,1952,5,0,5
6852,6852,,1952,6,0,6
6853,6853,,1952,4,0,4
6854,6854,,261,3,0,3
6855,6855,,427,3,0,3
6856,6856,,1620,0,1,1
6857,6857,,1974,2,0,2
6858,6858,,2008,0,1,1
6859,6859,,1985,0,2,2
6860,6860,,1985,2,0,2
6861,6861,,1442,0,0,0
6862,6862,,1443,0,1,1
6863,6863,,1443,1,0,1
6864,6864,,1214,1,0,1
6865,6865,,1444,0,0,0
6866,6866,,1445,0,0,0
6867,6867,,1952,22,0,22
6868,6868,,1446,0,0,0
6869,6869,,1952,8,0,8
6870,6870,,1447,0,1,1
6871,6871,,1448,0,0,0
6872,6872,,1296,0,2,2
6873,6873,,1214,3,0,3
6874,6874,,1952,0,5,5
6875,6875,,1952,35,0,35
6876,6876,,1502,0,12,12
6877,6877,,1502,2,0,2
6878,6878,,1985,0,452,452
6879,6879,,1502,0,3,3
6880,6880,,1449,0,0,0
6881,6881,,1450,0,0,0
6882,6882,,1451,0,0,0
6883,6883,,1502,1,0,1
6884,6884,,2110,0,11,11
6885,6885,,1502,0,15,15
6886,6886,,1502,2,0,2
6887,6887,,1452,0,0,0
6888,6888,,1998,1,0,1
6889,6889,,1453,0,0,0
6890,6890,,1502,0,5,5
6891,6891,,2062,0,2,2
6892,6892,,1454,0,0,0
6893,6893,,2062,1,0,1
6894,6894,,1455,0,0,0
6895,6895,,825,1,0,1
6896,6896,,1456,0,0,0
6897,6897,,1502,7,0,7
6898,6898,,1985,0,3,3
6899,6899,,1985,2,0,2
6900,6900,,3289,0,44,44
6901,6901,,1457,0,0,0
6902,6902,,1458,0,0,0
6903,6903,,2063,2,0,2
6904,6904,,1459,0,0,0
6905,6905,,1602,5,0,5
6906,6906,,1602,2,0,2
6907,6907,,1602,2,0,2
6908,6908,,1998,0,5,5
6909,6909,,1998,9,0,9
6910,6910,,1998,3,0,3
6911,6911,,1602,0,3,3
6912,6912,,1602,1,0,1
6913,6913,,1998,1,0,1
6914,6914,,2063,0,4,4
6915,6915,,2063,3,0,3
6916,6916,,2063,3,0,3
6917,6917,,2063,2,0,2
6918,6918,,1460,0,0,0
6919,6919,,1461,0,0,0
6920,6920,,1462,0,0,0
6921,6921,,1463,0,0,0
6922,6922,,1464,0,0,0
6923,6923,,1465,0,0,0
6924,6924,,2048,1,0,1
6925,6925,,1466,0,0,0
6926,6926,,1467,0,0,0
6927,6927,,1468,0,0,0
6928,6928,,1502,0,3,3
6929,6929,,1502,0,11,11
6930,6930,,1502,3,0,3
6931,6931,,1469,0,0,0
6932,6932,,1985,3,0,3
6933,6933,,1502,6,0,6
6934,6934,,427,0,2,2
6935,6935,,427,2,0,2
6936,6936,,1952,0,190,190
6937,6937,,1952,22,0,22
6938,6938,,1985,0,166,166
6939,6939,,1998,3,0,3
6940,6940,,1998,0,2,2
6941,6941,,2170,1,0,1
6942,6942,,1998,2,0,2
6943,6943,,1998,5,0,5
6944,6944,,1998,0,4,4
6945,6945,,1998,2,0,2
6946,6946,,1998,1,0,1
6947,6947,,1998,2,0,2
6948,6948,,1998,2,0,2
6949,6949,,1998,0,1,1
6950,6950,,1470,0,0,0
6951,6951,,1471,0,0,0
6952,6952,,1998,4,0,4
6953,6953,,1845,0,2,2
6954,6954,,1472,0,0,0
6955,6955,,1952,0,3,3
6956,6956,,1952,2,0,2
6957,6957,,1473,0,0,0
6958,6958,,206,1,0,1
6959,6959,,1942,1,0,1
6960,6960,,1474,0,0,0
6961,6961,,1475,0,0,0
6962,6962,,1502,2,0,2
6963,6963,,2063,4,0,4
6964,6964,,1476,0,0,0
6965,6965,,1477,0,0,0
6966,6966,,1203,3,0,3
6967,6967,,2063,0,10,10
6968,6968,,1952,0,87,87
6969,6969,,1952,16,0,16
6970,6970,,1478,0,0,0
6971,6971,,2063,0,10,10
6972,6972,,2063,1,0,1
6973,6973,,1214,0,342,342
6974,6974,,1214,1,0,1
6975,6975,,1974,0,4,4
6976,6976,,1974,2,0,2
6977,6977,,1952,0,2,2
6978,6978,,1502,0,5,5
6979,6979,,1502,2,0,2
6980,6980,,1998,0,3,3
6981,6981,,1214,2,0,2
6982,6982,,2063,0,10,10
6983,6983,,2063,7,0,7
6984,6984,,2063,1,0,1
6985,6985,,1985,9,0,9
6986,6986,,1502,0,6,6
6987,6987,,1502,5,0,5
6988,6988,,1502,6,0,6
6989,6989,,1998,0,3,3
6990,6990,,1998,5,0,5
6991,6991,,1479,0,0,0
6992,6992,,2101,0,3,3
6993,6993,,2101,3,0,3
6994,6994,,1480,0,0,0
6995,6995,,1974,0,23,23
6996,6996,,1974,2,0,2
6997,6997,,1974,2,0,2
6998,6998,,1974,2,0,2
6999,6999,,1974,2,0,2
7000,7000,,1974,0,13,13
7001,7001,,427,2,0,2
7002,7002,,1974,2,0,2
7003,7003,,1481,0,0,0
7004,7004,,1482,0,0,0
7005,7005,,964,1,0,1
7006,7006,,1502,2,0,2
7007,7007,,1483,0,0,0
7008,7008,,1502,0,7,7
7009,7009,,1484,0,0,0
7010,7010,,1485,0,0,0
7011,7011,,1486,0,0,0
7012,7012,,1985,0,1,1
7013,7013,,2008,1,0,1
7014,7014,,1985,2,0,2
7015,7015,,1952,0,12,12
7016,7016,,1952,21,0,21
7017,7017,,1487,0,0,0
7018,7018,,1602,0,212,212
7019,7019,,1488,0,0,0
7020,7020,,1502,1,0,1
7021,7021,,1502,1,0,1
7022,7022,,1502,3,0,3
7023,7023,,2062,0,3,3
7024,7024,,2072,0,4,4
7025,7025,,1974,0,4,4
7026,7026,,1974,10,0,10
7027,7027,,1998,0,1,1
7028,7028,,1998,5,0,5
7029,7029,,1489,0,0,0
7030,7030,,1998,2,0,2
7031,7031,,1998,0,6,6
7032,7032,,1998,2,0,2
7033,7033,,1998,2,0,2
7034,7034,,1998,2,0,2
7035,7035,,1998,2,0,2
7036,7036,,1998,6,0,6
7037,7037,,1490,0,0,0
7038,7038,,1491,0,0,0
7039,7039,,1998,4,0,4
7040,7040,,1492,0,0,0
7041,7041,,427,2,0,2
7042,7042,,427,2,0,2
7043,7043,,1493,0,0,0
7044,7044,,1797,2,0,2
7045,7045,,1494,0,0,0
7046,7046,,1797,2,0,2
7047,7047,,1502,4,0,4
7048,7048,,1952,0,3,3
7049,7049,,1495,0,1,1
7050,7050,,1952,0,5,5
7051,7051,,1952,11,0,11
7052,7052,,1952,5,0,5
7053,7053,,1502,0,5,5
7054,7054,,1998,0,2,2
7055,7055,,1998,4,0,4
7056,7056,,1952,0,9,9
7057,7057,,1952,13,0,13
7058,7058,,1496,0,0,0
7059,7059,,1497,0,0,0
7060,7060,,1502,1,0,1
7061,7061,,2048,0,2,2
7062,7062,,1502,0,6,6
7063,7063,,1502,5,0,5
7064,7064,,1502,8,0,8
7065,7065,,1952,0,4,4
7066,7066,,1952,3,0,3
7067,7067,,1952,2,0,2
7068,7068,,1952,2,0,2
7069,7069,,1502,2,0,2
7070,7070,,1998,5,0,5
7071,7071,,1498,0,0,0
7072,7072,,1985,0,2,2
7073,7073,,1502,0,4,4
7074,7074,,1499,10,0,10
7075,7075,,2063,0,1,1
7076,7076,,1974,0,5,5
7077,7077,,1974,2,0,2
7078,7078,,1974,0,2,2
7079,7079,,1952,0,175,175
7080,7080,,1500,0,0,0
7081,7081,,1998,0,2,2
7082,7082,,1998,3,0,3
7083,7083,,1974,0,31,31
7084,7084,,1501,0,0,0
7085,7085,,1974,0,12,12
7086,7086,,1502,0,3,3
7087,7087,,1502,2,0,2
7088,7088,,1502,1,0,1
7089,7089,,2063,0,28,28
7090,7090,,2063,15,0,15
7091,7091,,2063,18,0,18
7092,7092,,1502,349,0,349
7093,7093,,1952,0,5,5
7094,7094,,1503,0,0,0
7095,7095,,1952,2,0,2
7096,7096,,1602,11,0,11
7097,7097,,1952,5,0,5
7098,7098,,1504,0,2,2
7099,7099,,1504,4,0,4
7100,7100,,1502,0,1,1
7101,7101,,1502,1,0,1
7102,7102,,1505,0,0,0
7103,7103,,1506,0,0,0
7104,7104,,1797,2,0,2
7105,7105,,1507,0,0,0
7106,7106,,1499,1,0,1
7107,7107,,1502,5,0,5
7108,7108,,1952,0,2,2
7109,7109,,1952,5,0,5
7110,7110,,1998,1,0,1
7111,7111,,1508,2,0,2
7112,7112,,1952,0,2,2
7113,7113,,1509,0,0,0
7114,7114,,1510,0,0,0
7115,7115,,1504,0,1,1
7116,7116,,1511,0,0,0
7117,7117,,2072,0,2,2
7118,7118,,1952,0,7,7
7119,7119,,1952,25,0,25
7120,7120,,1512,0,0,0
7121,7121,,1513,0,0,0
7122,7122,,2008,1,0,1
7123,7123,,1514,0,0,0
7124,7124,,1499,1,0,1
7125,7125,,1502,0,6,6
7126,7126,,1502,11,0,11
7127,7127,,1515,0,0,0
7128,7128,,1502,4,0,4
7129,7129,,1502,3,0,3
7130,7130,,2048,0,6,6
7131,7131,,2048,2,0,2
7132,7132,,2048,12,0,12
7133,7133,,1516,0,0,0
7134,7134,,1517,0,0,0
7135,7135,,1502,2,0,2
7136,7136,,1985,0,189,189
7137,7137,,1502,0,2,2
7138,7138,,1998,0,5,5
7139,7139,,1998,2,0,2
7140,7140,,1998,2,0,2
7141,7141,,1998,0,2,2
7142,7142,,1502,5,0,5
7143,7143,,1502,2,0,2
7144,7144,,2062,0,1,1
7145,7145,,1518,0,0,0
7146,7146,,1974,0,199,199
7147,7147,,1974,2,0,2
7148,7148,,1519,0,0,0
7149,7149,,1952,6,0,6
7150,7150,,1952,13,0,13
7151,7151,,1520,0,0,0
7152,7152,,1985,2,0,2
7153,7153,,1521,0,0,0
7154,7154,,1502,0,10,10
7155,7155,,1502,2,0,2
7156,7156,,1502,0,3,3
7157,7157,,1502,3,0,3
7158,7158,,2013,1,0,1
7159,7159,,1998,3,0,3
7160,7160,,1522,0,0,0
7161,7161,,1952,5,0,5
7162,7162,,1937,0,6,6
7163,7163,,1937,1,0,1
7164,7164,,1937,4,0,4
7165,7165,,1937,4,0,4
7166,7166,,1523,0,0,0
7167,7167,,1502,0,5,5
7168,7168,,1502,2,0,2
7169,7169,,1502,0,3,3
7170,7170,,1502,0,15,15
7171,7171,,427,1,0,1
7172,7172,,1502,2,0,2
7173,7173,,1952,0,4,4
7174,7174,,1524,0,0,0
7175,7175,,2110,2,0,2
7176,7176,,1525,0,0,0
7177,7177,,2064,0,2,2
7178,7178,,1952,0,176,176
7179,7179,,1502,0,2,2
7180,7180,,1526,0,0,0
7181,7181,,1214,1,0,1
7182,7182,,3289,0,25,25
7183,7183,,3289,2,0,2
7184,7184,,1502,0,8,8
7185,7185,,1502,3,0,3
7186,7186,,1502,3,0,3
7187,7187,,1528,0,2,2
7188,7188,,1527,0,0,0
7189,7189,,1974,1,0,1
7190,7190,,1528,2,0,2
7191,7191,,1529,0,0,0
7192,7192,,1998,5,0,5
7193,7193,,1530,0,0,0
7194,7194,,1502,4,0,4
7195,7195,,1502,0,189,189
7196,7196,,1502,16,0,16
7197,7197,,1502,8,0,8
7198,7198,,1502,2,0,2
7199,7199,,1502,4,0,4
7200,7200,,1502,1,0,1
7201,7201,,1531,0,0,0
7202,7202,,1532,0,0,0
7203,7203,,1502,0,3,3
7204,7204,,1998,2,0,2
7205,7205,,1502,0,2,2
7206,7206,,1502,0,2,2
7207,7207,,1502,0,4,4
7208,7208,,1502,0,2,2
7209,7209,,1502,4,0,4
7210,7210,,1998,0,8,8
7211,7211,,1998,2,0,2
7212,7212,,1998,4,0,4
7213,7213,,1998,1,0,1
7214,7214,,1998,0,2,2
7215,7215,,1985,0,2,2
7216,7216,,1534,0,4,4
7217,7217,,1534,2,0,2
7218,7218,,1533,0,0,0
7219,7219,,1534,2,0,2
7220,7220,,807,1,0,1
7221,7221,,1214,3,0,3
7222,7222,,1998,0,5,5
7223,7223,,1952,0,2,2
7224,7224,,1998,0,3,3
7225,7225,,1998,1,0,1
7226,7226,,1998,8,0,8
7227,7227,,1502,4,0,4
7228,7228,,1998,0,2,2
7229,7229,,1998,2,0,2
7230,7230,,1998,2,0,2
7231,7231,,1998,0,2,2
7232,7232,,1998,2,0,2
7233,7233,,46,4,0,4
7234,7234,,1998,1,0,1
7235,7235,,1535,0,0,0
7236,7236,,1502,0,2,2
7237,7237,,1952,0,6,6
7238,7238,,1952,3,0,3
7239,7239,,1998,0,1,1
7240,7240,,1536,0,0,0
7241,7241,,1998,7,0,7
7242,7242,,1998,1,0,1
7243,7243,,1952,0,2,2
7244,7244,,1952,5,0,5
7245,7245,,1537,0,0,0
7246,7246,,1538,0,0,0
7247,7247,,1539,0,0,0
7248,7248,,1952,0,2,2
7249,7249,,1502,0,2,2
7250,7250,,1502,0,8,8
7251,7251,,1502,3,0,3
7252,7252,,1540,0,0,0
7253,7253,,1952,1,0,1
7254,7254,,1952,7,0,7
7255,7255,,1541,0,0,0
7256,7256,,1952,3,0,3
7257,7257,,1542,0,2,2
7258,7258,,1542,4,0,4
7259,7259,,1998,3,0,3
7260,7260,,1502,0,4,4
7261,7261,,2101,0,2,2
7262,7262,,1543,0,148,148
7263,7263,,1543,148,0,148
7264,7264,,1998,0,2,2
7265,7265,,1998,1,0,1
7266,7266,,1998,0,4,4
7267,7267,,1998,2,0,2
7268,7268,,1998,2,0,2
7269,7269,,1502,0,14,14
7270,7270,,1502,8,0,8
7271,7271,,1544,0,0,0
7272,7272,,1545,0,0,0
7273,7273,,1502,0,3,3
7274,7274,,1502,1,0,1
7275,7275,,1546,0,0,0
7276,7276,,1502,2,0,2
7277,7277,,1952,0,8,8
7278,7278,,1952,5,0,5
7279,7279,,1952,12,0,12
7280,7280,,1952,5,0,5
7281,7281,,1952,4,0,4
7282,7282,,1952,4,0,4
7283,7283,,1952,3,0,3
7284,7284,,1547,0,0,0
7285,7285,,1502,0,2,2
7286,7286,,1502,2,0,2
7287,7287,,1548,0,0,0
7288,7288,,825,2,0,2
7289,7289,,1549,0,0,0
7290,7290,,1952,0,3,3
7291,7291,,1550,0,0,0
7292,7292,,1551,0,0,0
7293,7293,,1214,0,17,17
7294,7294,,1952,0,5,5
7295,7295,,1952,2,0,2
7296,7296,,1952,2,0,2
7297,7297,,1974,0,2,2
7298,7298,,1974,3,0,3
7299,7299,,1974,2,0,2
7300,7300,,1952,0,2,2
7301,7301,,1952,41,0,41
7302,7302,,1998,0,2,2
7303,7303,,1552,0,0,0
7304,7304,,1553,0,0,0
7305,7305,,1214,0,7,7
7306,7306,,1998,2,0,2
7307,7307,,1998,0,1,1
7308,7308,,1502,0,5,5
7309,7309,,1502,3,0,3
7310,7310,,1554,0,0,0
7311,7311,,2008,1,0,1
7312,7312,,1555,0,0,0
7313,7313,,1952,1,0,1
7314,7314,,1985,0,2,2
7315,7315,,1952,3,0,3
7316,7316,,1502,0,2,2
7317,7317,,1502,0,3,3
7318,7318,,1502,0,8,8
7319,7319,,427,4,0,4
7320,7320,,1952,0,19,19
7321,7321,,1502,0,2,2
7322,7322,,1502,0,4,4
7323,7323,,1502,5,0,5
7324,7324,,1556,0,0,0
7325,7325,,1557,0,0,0
7326,7326,,1502,3,0,3
7327,7327,,1558,0,0,0
7328,7328,,1559,0,0,0
7329,7329,,1560,0,15,15
7330,7330,,1560,15,0,15
7331,7331,,1502,0,1,1
7332,7332,,1561,0,0,0
7333,7333,,1502,3,0,3
7334,7334,,1985,2,0,2
7335,7335,,1562,0,0,0
7336,7336,,1998,0,3,3
7337,7337,,1998,2,0,2
7338,7338,,1998,3,0,3
7339,7339,,1952,0,19,19
7340,7340,,1499,3,0,3
7341,7341,,1952,5,0,5
7342,7342,,1499,6,0,6
7343,7343,,1952,6,0,6
7344,7344,,1974,0,2,2
7345,7345,,1502,0,6,6
7346,7346,,1998,0,3,3
7347,7347,,1998,2,0,2
7348,7348,,1998,1,0,1
7349,7349,,1563,0,0,0
7350,7350,,1998,1,0,1
7351,7351,,1564,0,0,0
7352,7352,,1565,0,0,0
7353,7353,,1952,0,3,3
7354,7354,,1952,5,0,5
7355,7355,,1502,0,18,18
7356,7356,,1502,1,0,1
7357,7357,,1985,0,2,2
7358,7358,,1566,0,0,0
7359,7359,,1567,0,0,0
7360,7360,,1998,0,2,2
7361,7361,,1568,0,0,0
7362,7362,,1569,0,0,0
7363,7363,,1998,4,0,4
7364,7364,,1998,0,2,2
7365,7365,,1998,2,0,2
7366,7366,,1998,2,0,2
7367,7367,,1502,0,1,1
7368,7368,,1998,0,7,7
7369,7369,,1998,3,0,3
7370,7370,,1570,0,0,0
7371,7371,,1571,0,0,0
7372,7372,,1502,0,12,12
7373,7373,,2048,0,6,6
7374,7374,,1998,0,3,3
7375,7375,,1502,0,10,10
7376,7376,,1952,0,2,2
7377,7377,,1952,5,0,5
7378,7378,,1572,0,0,0
7379,7379,,1573,0,0,0
7380,7380,,1502,0,2,2
7381,7381,,1502,2,0,2
7382,7382,,1502,0,9,9
7383,7383,,1502,2,0,2
7384,7384,,1998,0,3,3
7385,7385,,1998,1,0,1
7386,7386,,1574,0,0,0
7387,7387,,1575,0,0,0
7388,7388,,1576,0,0,0
7389,7389,,1577,0,0,0
7390,7390,,1578,0,0,0
7391,7391,,1579,0,0,0
7392,7392,,1580,0,0,0
7393,7393,,1985,0,4,4
7394,7394,,1952,6,0,6
7395,7395,,1581,0,0,0
7396,7396,,1502,0,2,2
7397,7397,,1998,0,4,4
7398,7398,,1998,4,0,4
7399,7399,,2110,2,0,2
7400,7400,,1952,25,0,25
7401,7401,,1952,3,0,3
7402,7402,,1582,0,0,0
7403,7403,,2072,0,155,155
7404,7404,,1583,0,0,0
7405,7405,,1952,5,0,5
7406,7406,,1985,0,176,176
7407,7407,,1584,0,0,0
7408,7408,,1585,0,0,0
7409,7409,,1586,0,0,0
7410,7410,,46,1,0,1
7411,7411,,1502,0,6,6
7412,7412,,1587,0,0,0
7413,7413,,1588,0,0,0
7414,7414,,1952,0,2,2
7415,7415,,1952,2,0,2
7416,7416,,1952,3,0,3
7417,7417,,1985,0,190,190
7418,7418,,1974,3,0,3
7419,7419,,1589,0,0,0
7420,7420,,1590,0,0,0
7421,7421,,3289,0,5,5
7422,7422,,2048,0,12,12
7423,7423,,2048,14,0,14
7424,7424,,1998,0,4,4
7425,7425,,1998,3,0,3
7426,7426,,1502,0,3,3
7427,7427,,1502,5,0,5
7428,7428,,1502,2,0,2
7429,7429,,1502,5,0,5
7430,7430,,1502,0,2,2
7431,7431,,1591,0,0,0
7432,7432,,1502,1,0,1
7433,7433,,1502,3,0,3
7434,7434,,1998,0,6,6
7435,7435,,1592,0,0,0
7436,7436,,2072,0,5,5
7437,7437,,1998,0,5,5
7438,7438,,1593,0,0,0
7439,7439,,1998,0,5,5
7440,7440,,1594,0,0,0
7441,7441,,1998,3,0,3
7442,7442,,1998,0,3,3
7443,7443,,1595,0,0,0
7444,7444,,1499,5,0,5
7445,7445,,1998,0,2,2
7446,7446,,1502,0,18,18
7447,7447,,1502,0,9,9
7448,7448,,1502,8,0,8
7449,7449,,1502,0,6,6
7450,7450,,1502,0,4,4
7451,7451,,1502,3,0,3
7452,7452,,1502,0,3,3
7453,7453,,1502,0,5,5
7454,7454,,1502,5,0,5
7455,7455,,1502,2,0,2
7456,7456,,1502,4,0,4
7457,7457,,1596,0,0,0
7458,7458,,1998,0,7,7
7459,7459,,1998,2,0,2
7460,7460,,1602,0,2,2
7461,7461,,1602,3,0,3
7462,7462,,1597,0,0,0
7463,7463,,1598,0,0,0
7464,7464,,1203,0,212,212
7465,7465,,1998,0,2,2
7466,7466,,1998,2,0,2
7467,7467,,1502,7,0,7
7468,7468,,1502,2,0,2
7469,7469,,1602,2,0,2
7470,7470,,2048,3,0,3
7471,7471,,1602,4,0,4
7472,7472,,2048,9,0,9
7473,7473,,2048,25,0,25
7474,7474,,2048,6,0,6
7475,7475,,1599,0,0,0
7476,7476,,1600,0,0,0
7477,7477,,1985,4,0,4
7478,7478,,2048,7,0,7
7479,7479,,2048,4,0,4
7480,7480,,1601,0,0,0
7481,7481,,1952,0,3,3
7482,7482,,1952,6,0,6
7483,7483,,1998,0,3,3
7484,7484,,1602,0,2,2
7485,7485,,1602,2,0,2
7486,7486,,1603,0,0,0
7487,7487,,1203,1,0,1
7488,7488,,1952,0,5,5
7489,7489,,1502,3,0,3
7490,7490,,1985,0,2,2
7491,7491,,1502,0,14,14
7492,7492,,1502,2,0,2
7493,7493,,1998,0,8,8
7494,7494,,1998,2,0,2
7495,7495,,1998,1,0,1
7496,7496,,1502,0,4,4
7497,7497,,1502,0,12,12
7498,7498,,1998,0,2,2
7499,7499,,1998,2,0,2
7500,7500,,1952,0,2,2
7501,7501,,1952,13,0,13
7502,7502,,1604,0,0,0
7503,7503,,1605,0,0,0
7504,7504,,1606,0,0,0
7505,7505,,1607,0,0,0
7506,7506,,1645,1,0,1
7507,7507,,1502,0,4,4
7508,7508,,1502,3,0,3
7509,7509,,1998,0,2,2
7510,7510,,1608,0,0,0
7511,7511,,1985,0,2,2
7512,7512,,1952,0,1,1
7513,7513,,2063,42,0,42
7514,7514,,1609,0,0,0
7515,7515,,1502,0,4,4
7516,7516,,1610,0,0,0
7517,7517,,1611,0,0,0
7518,7518,,1612,0,0,0
7519,7519,,1502,0,5,5
7520,7520,,1952,0,6,6
7521,7521,,1998,0,3,3
7522,7522,,1502,0,6,6
7523,7523,,1613,0,0,0
7524,7524,,1974,2,0,2
7525,7525,,1502,0,5,5
7526,7526,,2063,0,2,2
7527,7527,,1974,0,2,2
7528,7528,,1998,0,7,7
7529,7529,,2101,0,6,6
7530,7530,,2101,2,0,2
7531,7531,,1502,0,8,8
7532,7532,,1952,0,2,2
7533,7533,,1998,0,3,3
7534,7534,,1502,0,2,2
7535,7535,,1502,1,0,1
7536,7536,,1952,12,0,12
7537,7537,,1614,0,0,0
7538,7538,,427,4,0,4
7539,7539,,2048,0,4,4
7540,7540,,2048,2,0,2
7541,7541,,1615,0,0,0
7542,7542,,1616,0,0,0
7543,7543,,1617,0,0,0
7544,7544,,1618,0,0,0
7545,7545,,1619,0,2,2
7546,7546,,1619,2,0,2
7547,7547,,1952,0,66,66
7548,7548,,1797,2,0,2
7549,7549,,1620,1,0,1
7550,7550,,1499,0,5,5
7551,7551,,1499,4,0,4
7552,7552,,1621,0,0,0
7553,7553,,1998,0,3,3
7554,7554,,1952,3,0,3
7555,7555,,1952,0,4,4
7556,7556,,1952,7,0,7
7557,7557,,1797,0,10,10
7558,7558,,1797,6,0,6
7559,7559,,1952,0,5,5
7560,7560,,1622,0,0,0
7561,7561,,1623,0,0,0
7562,7562,,2063,0,2,2
7563,7563,,2063,3,0,3
7564,7564,,2101,0,4,4
7565,7565,,2101,2,0,2
7566,7566,,1499,0,17,17
7567,7567,,1624,0,0,0
7568,7568,,1625,0,0,0
7569,7569,,1626,0,0,0
7570,7570,,2008,0,173,173
7571,7571,,1627,0,0,0
7572,7572,,1628,0,0,0
7573,7573,,1502,0,10,10
7574,7574,,1502,0,2,2
7575,7575,,2063,0,8,8
7576,7576,,1629,0,0,0
7577,7577,,1883,1,0,1
7578,7578,,1630,0,0,0
7579,7579,,1631,0,0,0
7580,7580,,1632,0,0,0
7581,7581,,1633,0,0,0
7582,7582,,1634,0,0,0
7583,7583,,1635,0,0,0
7584,7584,,1602,0,14,14
7585,7585,,2063,0,1,1
7586,7586,,2063,5,0,5
7587,7587,,1636,0,0,0
7588,7588,,1998,0,2,2
7589,7589,,1998,0,4,4
7590,7590,,1502,0,3,3
7591,7591,,1502,1,0,1
7592,7592,,1637,0,0,0
7593,7593,,1502,0,2,2
7594,7594,,1502,2,0,2
7595,7595,,1502,3,0,3
7596,7596,,1998,0,2,2
7597,7597,,1638,0,0,0
7598,7598,,1502,0,2,2
7599,7599,,1639,0,0,0
7600,7600,,1502,2,0,2
7601,7601,,1640,0,0,0
7602,7602,,1641,0,0,0
7603,7603,,1296,0,2,2
7604,7604,,1998,0,1,1
7605,7605,,1952,28,0,28
7606,7606,,1642,0,0,0
7607,7607,,1952,3,0,3
7608,7608,,1643,0,0,0
7609,7609,,1499,6,0,6
7610,7610,,1998,0,2,2
7611,7611,,1998,2,0,2
7612,7612,,1502,0,3,3
7613,7613,,1502,2,0,2
7614,7614,,1644,0,0,0
7615,7615,,1645,0,1,1
7616,7616,,1502,0,3,3
7617,7617,,1998,0,1,1
7618,7618,,1502,2,0,2
7619,7619,,1646,1,0,1
7620,7620,,1952,0,2,2
7621,7621,,1502,0,7,7
7622,7622,,1998,0,2,2
7623,7623,,1647,0,0,0
7624,7624,,1648,0,0,0
7625,7625,,1952,1,0,1
7626,7626,,1998,0,2,2
7627,7627,,1998,2,0,2
7628,7628,,1952,2,0,2
7629,7629,,1502,0,1,1
7630,7630,,1502,0,3,3
7631,7631,,1649,0,0,0
7632,7632,,1502,0,1,1
7633,7633,,1502,3,0,3
7634,7634,,1502,0,2,2
7635,7635,,1502,0,3,3
7636,7636,,1502,4,0,4
7637,7637,,1952,4,0,4
7638,7638,,1998,0,3,3
7639,7639,,1650,0,1,1
7640,7640,,1650,2,0,2
7641,7641,,1998,0,2,2
7642,7642,,1651,0,0,0
7643,7643,,1652,0,0,0
7644,7644,,1653,0,0,0
7645,7645,,1654,0,0,0
7646,7646,,2048,7,0,7
7647,7647,,1502,0,4,4
7648,7648,,1502,2,0,2
7649,7649,,1502,4,0,4
7650,7650,,1502,0,1,1
7651,7651,,1502,2,0,2
7652,7652,,1502,0,3,3
7653,7653,,1502,2,0,2
7654,7654,,1655,0,0,0
7655,7655,,1502,0,1,1
7656,7656,,1502,0,1,1
7657,7657,,1502,0,2,2
7658,7658,,1656,0,0,0
7659,7659,,1657,0,0,0
7660,7660,,1658,0,0,0
7661,7661,,1659,0,0,0
7662,7662,,1502,0,2,2
7663,7663,,1660,0,0,0
7664,7664,,1661,0,0,0
7665,7665,,1985,0,1,1
7666,7666,,1662,0,0,0
7667,7667,,1502,0,1,1
7668,7668,,1985,0,1,1
7669,7669,,1663,0,0,0
7670,7670,,1502,0,2,2
7671,7671,,1664,0,0,0
7672,7672,,1665,0,0,0
7673,7673,,1666,0,0,0
7674,7674,,2074,0,3,3
7675,7675,,1985,2,0,2
7676,7676,,1667,0,0,0
7677,7677,,1502,0,3,3
7678,7678,,1502,4,0,4
7679,7679,,158,0,25,25
7680,7680,,1668,0,0,0
7681,7681,,1974,0,2,2
7682,7682,,427,2,0,2
7683,7683,,1669,0,0,0
7684,7684,,1670,0,0,0
7685,7685,,1671,0,0,0
7686,7686,,1672,0,0,0
7687,7687,,1952,0,129,129
7688,7688,,2063,2,0,2
7689,7689,,1502,0,2,2
7690,7690,,1673,0,0,0
7691,7691,,825,2,0,2
7692,7692,,1502,0,3,3
7693,7693,,1998,0,4,4
7694,7694,,1998,2,0,2
7695,7695,,1998,0,2,2
7696,7696,,1974,3,0,3
7697,7697,,1974,15,0,15
7698,7698,,1674,0,0,0
7699,7699,,1502,0,1,1
7700,7700,,1998,0,2,2
7701,7701,,1502,0,3,3
7702,7702,,1502,2,0,2
7703,7703,,1998,0,5,5
7704,7704,,1502,0,4,4
7705,7705,,1675,0,0,0
7706,7706,,1676,0,2,2
7707,7707,,1676,2,0,2
7708,7708,,1677,0,0,0
7709,7709,,2144,2,0,2
7710,7710,,1678,0,0,0
7711,7711,,1679,0,0,0
7712,7712,,1680,0,0,0
7713,7713,,1681,0,0,0
7714,7714,,1502,3,0,3
7715,7715,,1682,0,0,0
7716,7716,,1683,0,0,0
7717,7717,,1974,0,5,5
7718,7718,,1684,0,0,0
7719,7719,,1685,0,0,0
7720,7720,,1686,0,0,0
7721,7721,,1502,1,0,1
7722,7722,,1687,0,0,0
7723,7723,,1688,0,0,0
7724,7724,,1689,0,0,0
7725,7725,,1502,0,1,1
7726,7726,,1952,0,2,2
7727,7727,,1690,0,0,0
7728,7728,,1502,0,2,2
7729,7729,,1502,2,0,2
7730,7730,,1502,0,3,3
7731,7731,,1502,2,0,2
7732,7732,,1502,2,0,2
7733,7733,,1502,0,2,2
7734,7734,,1502,2,0,2
7735,7735,,1691,0,0,0
7736,7736,,1692,0,0,0
7737,7737,,1693,0,0,0
7738,7738,,1694,0,0,0
7739,7739,,1499,0,4,4
7740,7740,,1502,0,17,17
7741,7741,,1695,0,0,0
7742,7742,,1696,0,0,0
7743,7743,,1697,0,0,0
7744,7744,,1698,0,0,0
7745,7745,,1502,0,1,1
7746,7746,,1998,0,2,2
7747,7747,,1998,1,0,1
7748,7748,,1502,0,4,4
7749,7749,,1502,2,0,2
7750,7750,,1502,2,0,2
7751,7751,,2063,0,1,1
7752,7752,,1502,0,4,4
7753,7753,,1699,0,0,0
7754,7754,,1700,0,0,0
7755,7755,,1502,0,2,2
7756,7756,,1985,0,3,3
7757,7757,,1701,0,0,0
7758,7758,,1702,0,0,0
7759,7759,,1502,0,2,2
7760,7760,,1502,0,1,1
7761,7761,,46,0,2,2
7762,7762,,1703,0,0,0
7763,7763,,1502,0,3,3
7764,7764,,1998,0,2,2
7765,7765,,1974,0,1,1
7766,7766,,1952,0,17,17
7767,7767,,1952,2,0,2
7768,7768,,1952,2,0,2
7769,7769,,1952,2,0,2
7770,7770,,1952,7,0,7
7771,7771,,1704,0,0,0
7772,7772,,1705,0,0,0
7773,7773,,1706,0,0,0
7774,7774,,1707,0,0,0
7775,7775,,1708,0,0,0
7776,7776,,1709,0,0,0
7777,7777,,1502,0,5,5
7778,7778,,1710,0,0,0
7779,7779,,1711,0,0,0
7780,7780,,1952,6,0,6
7781,7781,,1712,0,0,0
7782,7782,,1713,0,0,0
7783,7783,,1714,0,0,0
7784,7784,,1715,0,0,0
7785,7785,,1952,0,30,30
7786,7786,,1952,1,0,1
7787,7787,,1952,2,0,2
7788,7788,,1952,1,0,1
7789,7789,,1974,0,176,176
7790,7790,,1952,0,168,168
7791,7791,,1952,15,0,15
7792,7792,,1952,4,0,4
7793,7793,,3289,0,21,21
7794,7794,,1716,0,0,0
7795,7795,,1952,2,0,2
7796,7796,,1952,5,0,5
7797,7797,,1952,2,0,2
7798,7798,,1717,0,0,0
7799,7799,,1502,2,0,2
7800,7800,,1952,0,18,18
7801,7801,,1952,4,0,4
7802,7802,,2048,3,0,3
7803,7803,,1952,4,0,4
7804,7804,,1952,4,0,4
7805,7805,,1718,0,0,0
7806,7806,,2074,1,0,1
7807,7807,,1502,1,0,1
7808,7808,,1602,8,0,8
7809,7809,,1974,0,5,5
7810,7810,,1502,0,2,2
7811,7811,,1502,1,0,1
7812,7812,,1502,0,3,3
7813,7813,,1719,0,0,0
7814,7814,,1720,0,0,0
7815,7815,,2110,1,0,1
7816,7816,,1721,0,0,0
7817,7817,,1722,0,0,0
7818,7818,,1502,0,2,2
7819,7819,,1952,0,9,9
7820,7820,,1952,2,0,2
7821,7821,,1502,0,2,2
7822,7822,,1723,0,0,0
7823,7823,,2048,0,5,5
7824,7824,,2048,2,0,2
7825,7825,,2048,0,6,6
7826,7826,,1502,0,4,4
7827,7827,,1502,2,0,2
7828,7828,,1952,0,6,6
7829,7829,,1724,0,0,0
7830,7830,,1725,0,0,0
7831,7831,,1726,0,0,0
7832,7832,,2141,2,0,2
7833,7833,,1502,0,2,2
7834,7834,,1998,0,5,5
7835,7835,,1727,0,0,0
7836,7836,,1728,0,0,0
7837,7837,,1952,2,0,2
7838,7838,,1952,2,0,2
7839,7839,,1729,0,0,0
7840,7840,,1502,2,0,2
7841,7841,,1998,2,0,2
7842,7842,,1998,0,3,3
7843,7843,,1998,2,0,2
7844,7844,,1998,0,3,3
7845,7845,,1502,0,2,2
7846,7846,,1952,0,2,2
7847,7847,,1985,0,187,187
7848,7848,,1502,2,0,2
7849,7849,,2048,0,10,10
7850,7850,,1502,0,1,1
7851,7851,,1730,0,0,0
7852,7852,,1731,0,0,0
7853,7853,,1732,0,0,0
7854,7854,,1733,0,0,0
7855,7855,,1734,0,0,0
7856,7856,,1735,0,0,0
7857,7857,,2038,0,1,1
7858,7858,,2038,2,0,2
7859,7859,,1952,0,2,2
7860,7860,,2063,15,0,15
7861,7861,,2063,3,0,3
7862,7862,,2063,29,0,29
7863,7863,,1502,0,2,2
7864,7864,,1502,0,12,12
7865,7865,,1985,0,10,10
7866,7866,,1985,1,0,1
7867,7867,,1985,1,0,1
7868,7868,,427,6,0,6
7869,7869,,1736,0,1,1
7870,7870,,1974,0,14,14
7871,7871,,1974,5,0,5
7872,7872,,1974,5,0,5
7873,7873,,1952,0,16,16
7874,7874,,1502,0,1,1
7875,7875,,1502,0,3,3
7876,7876,,1737,0,0,0
7877,7877,,1738,0,0,0
7878,7878,,1502,0,2,2
7879,7879,,1214,0,2,2
7880,7880,,1739,0,0,0
7881,7881,,1502,0,11,11
7882,7882,,1985,0,2,2
7883,7883,,1952,0,2,2
7884,7884,,1952,0,3,3
7885,7885,,1952,8,0,8
7886,7886,,1952,0,9,9
7887,7887,,1952,7,0,7
7888,7888,,1740,0,0,0
7889,7889,,1952,0,12,12
7890,7890,,1952,0,19,19
7891,7891,,1502,0,10,10
7892,7892,,1741,0,0,0
7893,7893,,1502,0,10,10
7894,7894,,1742,0,0,0
7895,7895,,1743,0,0,0
7896,7896,,1952,0,4,4
7897,7897,,1744,0,0,0
7898,7898,,1745,0,0,0
7899,7899,,1984,1,0,1
7900,7900,,1502,1,0,1
7901,7901,,1746,0,0,0
7902,7902,,1952,0,16,16
7903,7903,,1952,5,0,5
7904,7904,,1998,0,1,1
7905,7905,,1998,2,0,2
7906,7906,,1977,0,7,7
7907,7907,,1977,2,0,2
7908,7908,,1977,4,0,4
7909,7909,,1747,0,0,0
7910,7910,,1748,0,0,0
7911,7911,,1749,0,0,0
7912,7912,,1750,0,0,0
7913,7913,,1977,3,0,3
7914,7914,,1751,0,0,0
7915,7915,,1752,0,0,0
7916,7916,,1753,0,0,0
7917,7917,,1754,0,0,0
7918,7918,,1755,0,0,0
7919,7919,,2048,4,0,4
7920,7920,,1756,0,0,0
7921,7921,,1998,0,3,3
7922,7922,,1998,0,1,1
7923,7923,,1998,1,0,1
7924,7924,,1757,0,0,0
7925,7925,,1758,0,0,0
7926,7926,,1952,1,0,1
7927,7927,,1998,0,4,4
7928,7928,,1974,0,4,4
7929,7929,,1974,2,0,2
7930,7930,,2048,0,3,3
7931,7931,,1974,0,6,6
7932,7932,,1974,2,0,2
7933,7933,,1502,0,2,2
7934,7934,,1759,0,3,3
7935,7935,,1759,3,0,3
7936,7936,,1760,0,0,0
7937,7937,,1761,0,0,0
7938,7938,,1762,0,0,0
7939,7939,,2048,2,0,2
7940,7940,,1952,0,8,8
7941,7941,,1952,7,0,7
7942,7942,,1502,0,2,2
7943,7943,,1502,0,2,2
7944,7944,,1502,0,7,7
7945,7945,,1296,0,2,2
7946,7946,,1763,0,0,0
7947,7947,,1502,2,0,2
7948,7948,,1502,4,0,4
7949,7949,,1974,0,2,2
7950,7950,,1764,0,0,0
7951,7951,,1502,0,2,2
7952,7952,,1502,0,3,3
7953,7953,,1998,0,3,3
7954,7954,,1502,1,0,1
7955,7955,,1952,0,1,1
7956,7956,,1765,0,0,0
7957,7957,,1998,0,2,2
7958,7958,,1502,4,0,4
7959,7959,,1766,0,0,0
7960,7960,,1767,0,0,0
7961,7961,,1768,0,0,0
7962,7962,,1769,0,0,0
7963,7963,,1974,0,1,1
7964,7964,,1770,0,0,0
7965,7965,,1771,0,0,0
7966,7966,,1952,1,0,1
7967,7967,,1772,0,0,0
7968,7968,,1773,0,0,0
7969,7969,,1774,0,1,1
7970,7970,,1775,0,0,0
7971,7971,,1998,0,3,3
7972,7972,,1952,0,5,5
7973,7973,,1776,0,0,0
7974,7974,,1777,0,0,0
7975,7975,,1985,0,311,311
7976,7976,,1778,0,0,0
7977,7977,,1779,0,0,0
7978,7978,,1502,0,2,2
7979,7979,,2048,0,9,9
7980,7980,,2048,2,0,2
7981,7981,,2048,2,0,2
7982,7982,,2048,1,0,1
7983,7983,,1985,0,9,9
7984,7984,,1780,0,0,0
7985,7985,,1998,0,5,5
7986,7986,,1952,0,6,6
7987,7987,,1952,5,0,5
7988,7988,,1781,0,0,0
7989,7989,,1974,0,1,1
7990,7990,,1952,0,2,2
7991,7991,,1952,1,0,1
7992,7992,,1952,0,6,6
7993,7993,,1502,0,1,1
7994,7994,,1782,0,0,0
7995,7995,,1952,1,0,1
7996,7996,,1783,0,0,0
7997,7997,,1985,0,211,211
7998,7998,,1784,0,0,0
7999,7999,,1785,0,0,0
8000,8000,,1952,0,2,2
8001,8001,,1952,4,0,4
8002,8002,,1502,0,2,2
8003,8003,,1998,0,1,1
8004,8004,,1952,0,1,1
8005,8005,,1786,0,0,0
8006,8006,,1502,0,169,169
8007,8007,,1502,3,0,3
8008,8008,,1502,0,5,5
8009,8009,,2101,0,2,2
8010,8010,,2101,2,0,2
8011,8011,,1787,0,0,0
8012,8012,,1788,0,0,0
8013,8013,,1789,0,0,0
8014,8014,,1790,0,0,0
8015,8015,,1502,0,4,4
8016,8016,,1791,0,0,0
8017,8017,,1792,0,0,0
8018,8018,,1793,0,0,0
8019,8019,,1794,0,0,0
8020,8020,,1795,0,0,0
8021,8021,,1502,0,1,1
8022,8022,,1796,0,0,0
8023,8023,,1797,0,4,4
8024,8024,,2063,0,18,18
8025,8025,,1650,0,1,1
8026,8026,,1952,0,1,1
8027,8027,,1502,0,1,1
8028,8028,,1214,0,3,3
8029,8029,,1798,0,0,0
8030,8030,,1799,0,0,0
8031,8031,,1800,0,0,0
8032,8032,,1801,0,0,0
8033,8033,,1802,0,0,0
8034,8034,,2021,1,0,1
8035,8035,,1952,0,4,4
8036,8036,,1803,0,0,0
8037,8037,,1502,0,2,2
8038,8038,,1502,0,2,2
8039,8039,,1998,2,0,2
8040,8040,,1998,1,0,1
8041,8041,,1952,0,12,12
8042,8042,,1804,0,0,0
8043,8043,,1805,0,0,0
8044,8044,,1806,0,0,0
8045,8045,,1807,0,0,0
8046,8046,,1808,0,0,0
8047,8047,,1809,0,0,0
8048,8048,,1810,0,0,0
8049,8049,,1985,2,0,2
8050,8050,,1811,0,8,8
8051,8051,,1811,3,0,3
8052,8052,,1811,4,0,4
8053,8053,,427,0,2,2
8054,8054,,427,2,0,2
8055,8055,,1502,0,3,3
8056,8056,,1812,0,0,0
8057,8057,,1952,1,0,1
8058,8058,,1813,0,0,0
8059,8059,,1814,0,0,0
8060,8060,,2101,0,3,3
8061,8061,,2101,2,0,2
8062,8062,,1502,0,2,2
8063,8063,,1952,0,2,2
8064,8064,,1952,0,2,2
8065,8065,,1952,0,4,4
8066,8066,,1815,0,2,2
8067,8067,,1815,2,0,2
8068,8068,,1816,0,0,0
8069,8069,,1817,0,0,0
8070,8070,,1818,0,0,0
8071,8071,,1819,0,0,0
8072,8072,,1974,0,1,1
8073,8073,,1952,0,24,24
8074,8074,,1974,0,4,4
8075,8075,,1974,3,0,3
8076,8076,,1502,0,2,2
8077,8077,,427,0,2,2
8078,8078,,1985,0,2,2
8079,8079,,1952,11,0,11
8080,8080,,1952,6,0,6
8081,8081,,1820,0,0,0
8082,8082,,1821,0,0,0
8083,8083,,1822,0,0,0
8084,8084,,1823,0,0,0
8085,8085,,2048,2,0,2
8086,8086,,2038,1,0,1
8087,8087,,1824,0,0,0
8088,8088,,1952,2,0,2
8089,8089,,1825,0,0,0
8090,8090,,1826,0,0,0
8091,8091,,1827,0,0,0
8092,8092,,1828,0,0,0
8093,8093,,1952,1,0,1
8094,8094,,1829,0,0,0
8095,8095,,1952,1,0,1
8096,8096,,1952,12,0,12
8097,8097,,1952,8,0,8
8098,8098,,1985,2,0,2
8099,8099,,1952,3,0,3
8100,8100,,2048,7,0,7
8101,8101,,2048,18,0,18
8102,8102,,2048,2,0,2
8103,8103,,2048,2,0,2
8104,8104,,1974,4,0,4
8105,8105,,1952,0,20,20
8106,8106,,2048,0,9,9
8107,8107,,1502,0,2,2
8108,8108,,3289,0,19,19
8109,8109,,1985,0,6,6
8110,8110,,1830,0,0,0
8111,8111,,1831,0,0,0
8112,8112,,1832,0,0,0
8113,8113,,1502,0,4,4
8114,8114,,1952,0,3,3
8115,8115,,1952,7,0,7
8116,8116,,1833,0,0,0
8117,8117,,1834,0,0,0
8118,8118,,1835,0,0,0
8119,8119,,427,1,0,1
8120,8120,,1936,1,0,1
8121,8121,,1836,0,0,0
8122,8122,,1837,0,0,0
8123,8123,,2072,0,3,3
8124,8124,,2063,0,4,4
8125,8125,,1502,0,4,4
8126,8126,,1602,0,36,36
8127,8127,,1602,2,0,2
8128,8128,,1838,0,2,2
8129,8129,,1838,2,0,2
8130,8130,,1998,0,2,2
8131,8131,,1839,0,166,166
8132,8132,,1502,0,2,2
8133,8133,,1840,0,0,0
8134,8134,,1841,0,0,0
8135,8135,,1842,0,0,0
8136,8136,,1843,0,0,0
8137,8137,,1844,0,0,0
8138,8138,,1845,2,0,2
8139,8139,,1502,0,2,2
8140,8140,,1502,2,0,2
8141,8141,,1502,0,3,3
8142,8142,,1846,0,0,0
8143,8143,,2072,0,2,2
8144,8144,,1847,0,0,0
8145,8145,,1848,0,0,0
8146,8146,,1849,0,0,0
8147,8147,,1502,0,7,7
8148,8148,,1850,0,0,0
8149,8149,,1851,0,0,0
8150,8150,,1852,0,0,0
8151,8151,,1853,0,0,0
8152,8152,,2132,2,0,2
8153,8153,,1854,0,0,0
8154,8154,,1502,0,12,12
8155,8155,,1855,0,0,0
8156,8156,,1502,0,3,3
8157,8157,,1856,0,0,0
8158,8158,,1502,0,2,2
8159,8159,,1998,0,1,1
8160,8160,,1998,1,0,1
8161,8161,,1502,0,2,2
8162,8162,,1952,0,2,2
8163,8163,,1998,0,2,2
8164,8164,,1998,0,5,5
8165,8165,,1998,1,0,1
8166,8166,,1998,0,2,2
8167,8167,,1502,0,5,5
8168,8168,,1857,0,0,0
8169,8169,,1502,0,2,2
8170,8170,,1985,0,1,1
8171,8171,,1858,0,0,0
8172,8172,,1998,0,3,3
8173,8173,,1998,2,0,2
8174,8174,,1859,0,0,0
8175,8175,,1860,0,0,0
8176,8176,,1998,1,0,1
8177,8177,,1998,2,0,2
8178,8178,,1998,0,1,1
8179,8179,,1502,0,2,2
8180,8180,,1952,0,2,2
8181,8181,,1861,0,0,0
8182,8182,,1502,0,2,2
8183,8183,,1862,0,0,0
8184,8184,,1863,0,0,0
8185,8185,,2048,0,4,4
8186,8186,,2063,2,0,2
8187,8187,,1864,0,0,0
8188,8188,,1998,0,2,2
8189,8189,,1865,0,0,0
8190,8190,,2048,0,6,6
8191,8191,,1866,0,0,0
8192,8192,,1867,0,0,0
8193,8193,,1974,1,0,1
8194,8194,,1868,0,0,0
8195,8195,,1502,0,6,6
8196,8196,,2048,0,2,2
8197,8197,,1998,0,16,16
8198,8198,,1985,3,0,3
8199,8199,,1952,2,0,2
8200,8200,,1869,0,0,0
8201,8201,,1870,0,0,0
8202,8202,,1974,0,5,5
8203,8203,,1974,7,0,7
8204,8204,,1502,0,181,181
8205,8205,,1502,2,0,2
8206,8206,,427,0,3,3
8207,8207,,427,2,0,2
8208,8208,,427,2,0,2
8209,8209,,1502,0,3,3
8210,8210,,1502,0,7,7
8211,8211,,1952,0,3,3
8212,8212,,1952,2,0,2
8213,8213,,2008,0,186,186
8214,8214,,1214,3,0,3
8215,8215,,1214,2,0,2
8216,8216,,1871,0,9,9
8217,8217,,1871,2,0,2
8218,8218,,1871,2,0,2
8219,8219,,1871,2,0,2
8220,8220,,1871,2,0,2
8221,8221,,1872,0,0,0
8222,8222,,1873,0,0,0
8223,8223,,1874,0,0,0
8224,8224,,1952,0,5,5
8225,8225,,1952,2,0,2
8226,8226,,1952,7,0,7
8227,8227,,1952,0,5,5
8228,8228,,1952,3,0,3
8229,8229,,1952,0,5,5
8230,8230,,1952,3,0,3
8231,8231,,1875,0,0,0
8232,8232,,1952,0,11,11
8233,8233,,1952,2,0,2
8234,8234,,1952,0,2,2
8235,8235,,2063,0,1,1
8236,8236,,2063,8,0,8
8237,8237,,2048,0,2,2
8238,8238,,2072,0,2,2
8239,8239,,1876,0,0,0
8240,8240,,1877,0,0,0
8241,8241,,1878,0,0,0
8242,8242,,1879,0,0,0
8243,8243,,1880,0,0,0
8244,8244,,2048,2,0,2
8245,8245,,1881,0,0,0
8246,8246,,1882,0,0,0
8247,8247,,2101,0,3,3
8248,8248,,2101,2,0,2
8249,8249,,1502,0,3,3
8250,8250,,1883,0,1,1
8251,8251,,1502,0,5,5
8252,8252,,1502,2,0,2
8253,8253,,1884,0,0,0
8254,8254,,2008,0,3,3
8255,8255,,2008,4,0,4
8256,8256,,1885,0,0,0
8257,8257,,1952,1,0,1
8258,8258,,2048,0,15,15
8259,8259,,2048,2,0,2
8260,8260,,2048,4,0,4
8261,8261,,2048,4,0,4
8262,8262,,2048,1,0,1
8263,8263,,2048,1,0,1
8264,8264,,2048,1,0,1
8265,8265,,1886,0,0,0
8266,8266,,1974,1,0,1
8267,8267,,1887,0,0,0
8268,8268,,1888,0,0,0
8269,8269,,1889,0,0,0
8270,8270,,1952,0,15,15
8271,8271,,1890,0,0,0
8272,8272,,2074,0,366,366
8273,8273,,427,0,2,2
8274,8274,,1974,0,9,9
8275,8275,,1502,0,2,2
8276,8276,,1891,0,0,0
8277,8277,,1502,3,0,3
8278,8278,,1502,1,0,1
8279,8279,,1892,0,0,0
8280,8280,,1214,0,2,2
8281,8281,,1998,0,7,7
8282,8282,,427,0,148,148
8283,8283,,427,0,1,1
8284,8284,,1998,0,1,1
8285,8285,,1893,0,1,1
8286,8286,,1893,1,0,1
8287,8287,,1894,0,0,0
8288,8288,,1952,0,21,21
8289,8289,,1952,4,0,4
8290,8290,,1952,0,2,2
8291,8291,,2063,0,2,2
8292,8292,,1998,0,3,3
8293,8293,,2101,0,2,2
8294,8294,,1895,0,0,0
8295,8295,,2063,4,0,4
8296,8296,,1896,0,2,2
8297,8297,,1896,1,0,1
8298,8298,,1896,1,0,1
8299,8299,,1897,0,0,0
8300,8300,,1898,0,0,0
8301,8301,,427,0,149,149
8302,8302,,1899,0,0,0
8303,8303,,1900,0,0,0
8304,8304,,1998,0,4,4
8305,8305,,1998,0,5,5
8306,8306,,1901,0,1,1
8307,8307,,1902,0,0,0
8308,8308,,1903,0,0,0
8309,8309,,1904,0,0,0
8310,8310,,1985,1,0,1
8311,8311,,1502,0,2,2
8312,8312,,1905,0,0,0
8313,8313,,1952,4,0,4
8314,8314,,1906,0,0,0
8315,8315,,1907,0,0,0
8316,8316,,1908,0,0,0
8317,8317,,1909,0,0,0
8318,8318,,1910,0,0,0
8319,8319,,1911,0,0,0
8320,8320,,1912,0,0,0
8321,8321,,1502,0,13,13
8322,8322,,2072,0,2,2
8323,8323,,1952,0,5,5
8324,8324,,1952,3,0,3
8325,8325,,1502,0,2,2
8326,8326,,1913,0,0,0
8327,8327,,1952,0,6,6
8328,8328,,1952,5,0,5
8329,8329,,1214,0,1,1
8330,8330,,2110,0,3,3
8331,8331,,2110,2,0,2
8332,8332,,2110,1,0,1
8333,8333,,2072,0,4,4
8334,8334,,2011,0,1,1
8335,8335,,1985,0,3,3
8336,8336,,1974,0,2,2
8337,8337,,1952,0,2,2
8338,8338,,1502,2,0,2
8339,8339,,1914,0,0,0
8340,8340,,1214,0,2,2
8341,8341,,1985,1,0,1
8342,8342,,1985,0,2,2
8343,8343,,1985,3,0,3
8344,8344,,1985,0,2,2
8345,8345,,1985,2,0,2
8346,8346,,1998,0,4,4
8347,8347,,1502,0,6,6
8348,8348,,1915,0,0,0
8349,8349,,1502,0,2,2
8350,8350,,1502,0,2,2
8351,8351,,2101,0,1,1
8352,8352,,1916,0,0,0
8353,8353,,1998,0,12,12
8354,8354,,1917,0,0,0
8355,8355,,1918,0,0,0
8356,8356,,2048,0,1,1
8357,8357,,1919,0,0,0
8358,8358,,1974,3,0,3
8359,8359,,1502,0,11,11
8360,8360,,1502,2,0,2
8361,8361,,1920,0,0,0
8362,8362,,427,0,2,2
8363,8363,,1921,0,0,0
8364,8364,,1922,0,0,0
8365,8365,,1923,0,0,0
8366,8366,,2101,0,2,2
8367,8367,,1998,0,2,2
8368,8368,,1602,5,0,5
8369,8369,,1977,2,0,2
8370,8370,,1974,2,0,2
8371,8371,,1924,0,0,0
8372,8372,,2063,0,1,1
8373,8373,,1925,0,0,0
8374,8374,,1926,0,0,0
8375,8375,,261,0,1,1
8376,8376,,1998,3,0,3
8377,8377,,261,2,0,2
8378,8378,,1927,0,0,0
8379,8379,,1928,0,0,0
8380,8380,,1502,0,5,5
8381,8381,,1929,0,0,0
8382,8382,,1998,0,4,4
8383,8383,,261,2,0,2
8384,8384,,1502,0,15,15
8385,8385,,1985,0,552,552
8386,8386,,1502,0,3,3
8387,8387,,1930,0,0,0
8388,8388,,1502,0,1,1
8389,8389,,1985,0,3,3
8390,8390,,1502,0,6,6
8391,8391,,1931,0,0,0
8392,8392,,1932,0,0,0
8393,8393,,1998,0,3,3
8394,8394,,3289,0,35,35
8395,8395,,1933,0,0,0
8396,8396,,1934,0,0,0
8397,8397,,2096,0,2,2
8398,8398,,2063,0,7,7
8399,8399,,2063,2,0,2
8400,8400,,2063,1,0,1
8401,8401,,2063,7,0,7
8402,8402,,2063,2,0,2
8403,8403,,2063,2,0,2
8404,8404,,1502,0,1,1
8405,8405,,1502,0,1,1
8406,8406,,1502,0,1,1
8407,8407,,1502,0,1,1
8408,8408,,427,0,8,8
8409,8409,,427,1,0,1
8410,8410,,1935,0,0,0
8411,8411,,1936,0,1,1
8412,8412,,1937,0,3,3
8413,8413,,1502,0,4,4
8414,8414,,2110,0,1,1
8415,8415,,1938,0,0,0
8416,8416,,1939,0,0,0
8417,8417,,1940,0,0,0
8418,8418,,2096,2,0,2
8419,8419,,2096,2,0,2
8420,8420,,1502,0,2,2
8421,8421,,1502,0,2,2
8422,8422,,1974,2,0,2
8423,8423,,1502,0,3,3
8424,8424,,1508,0,1,1
8425,8425,,1941,0,0,0
8426,8426,,1952,0,164,164
8427,8427,,1942,0,1,1
8428,8428,,1502,0,11,11
8429,8429,,1974,0,3,3
8430,8430,,1998,0,3,3
8431,8431,,1502,0,3,3
8432,8432,,1502,7,0,7
8433,8433,,1502,0,2,2
8434,8434,,427,0,3,3
8435,8435,,427,2,0,2
8436,8436,,1502,0,3,3
8437,8437,,1943,0,0,0
8438,8438,,1502,0,23,23
8439,8439,,1296,0,2,2
8440,8440,,1502,0,3,3
8441,8441,,1502,0,15,15
8442,8442,,1998,0,2,2
8443,8443,,1952,0,5,5
8444,8444,,1952,3,0,3
8445,8445,,1602,0,2,2
8446,8446,,1944,0,0,0
8447,8447,,1998,0,2,2
8448,8448,,1945,0,0,0
8449,8449,,1946,0,2,2
8450,8450,,1946,3,0,3
8451,8451,,1952,0,3,3
8452,8452,,1952,2,0,2
8453,8453,,1947,0,0,0
8454,8454,,3289,0,22,22
8455,8455,,1502,0,4,4
8456,8456,,1502,1,0,1
8457,8457,,1948,0,0,0
8458,8458,,825,2,0,2
8459,8459,,1949,0,0,0
8460,8460,,1950,0,0,0
8461,8461,,1951,0,0,0
8462,8462,,1952,0,5,5
8463,8463,,1952,3,0,3
8464,8464,,1542,0,3,3
8465,8465,,1542,1,0,1
8466,8466,,1953,0,0,0
8467,8467,,1954,0,0,0
8468,8468,,1502,0,3,3
8469,8469,,1998,0,11,11
8470,8470,,1998,0,1,1
8471,8471,,1502,0,1,1
8472,8472,,1502,0,9,9
8473,8473,,1998,0,11,11
8474,8474,,1502,0,3,3
8475,8475,,1502,0,2,2
8476,8476,,1502,0,2,2
8477,8477,,1502,0,3,3
8478,8478,,1955,0,0,0
8479,8479,,1998,1,0,1
8480,8480,,1956,0,0,0
8481,8481,,1957,0,0,0
8482,8482,,1958,0,0,0
8483,8483,,1959,0,0,0
8484,8484,,1960,0,0,0
8485,8485,,1961,0,0,0
8486,8486,,1962,0,0,0
8487,8487,,1963,0,0,0
8488,8488,,1964,0,0,0
8489,8489,,1952,0,2,2
8490,8490,,1998,0,1,1
8491,8491,,1502,0,1,1
8492,8492,,1502,0,12,12
8493,8493,,1502,0,2,2
8494,8494,,1502,0,13,13
8495,8495,,1952,8,0,8
8496,8496,,1502,0,2,2
8497,8497,,1965,0,0,0
8498,8498,,1966,0,0,0
8499,8499,,1952,0,191,191
8500,8500,,1502,0,3,3
8501,8501,,1502,0,2,2
8502,8502,,1952,0,3,3
8503,8503,,1502,0,9,9
8504,8504,,2110,0,22,22
8505,8505,,1967,0,0,0
8506,8506,,1974,0,2,2
8507,8507,,1968,0,0,0
8508,8508,,1969,0,0,0
8509,8509,,1970,0,0,0
8510,8510,,1971,0,0,0
8511,8511,,2110,0,2,2
8512,8512,,1972,0,0,0
8513,8513,,1998,0,1,1
8514,8514,,1973,0,0,0
8515,8515,,1974,2,0,2
8516,8516,,1985,0,341,341
8517,8517,,2096,3,0,3
8518,8518,,1952,0,5,5
8519,8519,,1502,0,7,7
8520,8520,,1502,0,2,2
8521,8521,,2063,0,1,1
8522,8522,,1975,0,0,0
8523,8523,,1976,0,0,0
8524,8524,,1977,0,5,5
8525,8525,,1214,0,2,2
8526,8526,,1978,0,0,0
8527,8527,,1979,0,0,0
8528,8528,,1952,14,0,14
8529,8529,,1502,0,174,174
8530,8530,,1502,0,2,2
8531,8531,,1980,0,0,0
8532,8532,,1981,0,0,0
8533,8533,,1982,0,0,0
8534,8534,,1983,0,0,0
8535,8535,,1984,0,1,1
8536,8536,,1952,0,7,7
8537,8537,,1985,1,0,1
8538,8538,,1502,0,2,2
8539,8539,,1952,0,1,1
8540,8540,,1974,0,2,2
8541,8541,,1502,0,8,8
8542,8542,,1502,0,4,4
8543,8543,,1502,0,8,8
8544,8544,,1502,0,3,3
8545,8545,,1214,0,3,3
8546,8546,,1214,2,0,2
8547,8547,,1974,1,0,1
8548,8548,,1502,0,3,3
8549,8549,,1502,2,0,2
8550,8550,,1502,0,6,6
8551,8551,,1502,0,5,5
8552,8552,,1985,0,695,695
8553,8553,,1214,2,0,2
8554,8554,,1998,0,4,4
8555,8555,,1502,0,2,2
8556,8556,,1952,0,2,2
8557,8557,,1986,0,1,1
8558,8558,,1987,0,0,0
8559,8559,,1998,0,3,3
8560,8560,,1988,0,0,0
8561,8561,,1989,0,0,0
8562,8562,,1990,0,0,0
8563,8563,,2101,0,2,2
8564,8564,,1952,0,3,3
8565,8565,,1502,0,7,7
8566,8566,,1991,0,0,0
8567,8567,,1998,0,2,2
8568,8568,,2008,0,2,2
8569,8569,,1992,0,0,0
8570,8570,,1993,0,0,0
8571,8571,,158,0,170,170
8572,8572,,1974,0,1,1
8573,8573,,1502,0,10,10
8574,8574,,1994,0,0,0
8575,8575,,1995,0,0,0
8576,8576,,1996,0,0,0
8577,8577,,1502,0,5,5
8578,8578,,1502,0,1,1
8579,8579,,2063,0,5,5
8580,8580,,1997,0,0,0
8581,8581,,1502,0,8,8
8582,8582,,1502,0,3,3
8583,8583,,1502,0,4,4
8584,8584,,1998,0,5,5
8585,8585,,1502,0,13,13
8586,8586,,1502,0,2,2
8587,8587,,1999,0,0,0
8588,8588,,2000,0,0,0
8589,8589,,1952,0,3,3
8590,8590,,1502,0,4,4
8591,8591,,1214,2,0,2
8592,8592,,2001,0,0,0
8593,8593,,2002,0,0,0
8594,8594,,2003,0,0,0
8595,8595,,2004,0,0,0
8596,8596,,1502,1,0,1
8597,8597,,2005,0,0,0
8598,8598,,2006,0,0,0
8599,8599,,2007,0,0,0
8600,8600,,1952,0,3,3
8601,8601,,2063,0,2,2
8602,8602,,1502,0,7,7
8603,8603,,1952,0,2,2
8604,8604,,1502,0,3,3
8605,8605,,1296,0,2,2
8606,8606,,1974,0,2,2
8607,8607,,1203,1,0,1
8608,8608,,2008,4,0,4
8609,8609,,2009,0,0,0
8610,8610,,1502,0,1,1
8611,8611,,2011,0,3,3
8612,8612,,2010,0,0,0
8613,8613,,2011,2,0,2
8614,8614,,2012,0,0,0
8615,8615,,1952,0,5,5
8616,8616,,1952,10,0,10
8617,8617,,1952,0,11,11
8618,8618,,2013,0,2,2
8619,8619,,2014,0,0,0
8620,8620,,2015,0,0,0
8621,8621,,1502,0,2,2
8622,8622,,1504,0,2,2
8623,8623,,1214,1,0,1
8624,8624,,1502,0,2,2
8625,8625,,1502,2,0,2
8626,8626,,1952,0,5,5
8627,8627,,1502,0,3,3
8628,8628,,1998,0,3,3
8629,8629,,1952,0,8,8
8630,8630,,3289,0,20,20
8631,8631,,1998,2,0,2
8632,8632,,1998,3,0,3
8633,8633,,1974,0,1,1
8634,8634,,1502,0,1,1
8635,8635,,1952,0,6,6
8636,8636,,1952,9,0,9
8637,8637,,2048,0,37,37
8638,8638,,2048,5,0,5
8639,8639,,2016,0,0,0
8640,8640,,2096,2,0,2
8641,8641,,1985,0,2,2
8642,8642,,1985,3,0,3
8643,8643,,3289,0,30,30
8644,8644,,1952,6,0,6
8645,8645,,1214,0,2,2
8646,8646,,1502,0,3,3
8647,8647,,2017,0,0,0
8648,8648,,2018,0,0,0
8649,8649,,2019,0,0,0
8650,8650,,1985,0,2,2
8651,8651,,1502,0,2,2
8652,8652,,2020,0,1,1
8653,8653,,2021,0,2,2
8654,8654,,2022,0,1,1
8655,8655,,2022,1,0,1
8656,8656,,2110,0,2,2
8657,8657,,2008,0,1,1
8658,8658,,1502,0,11,11
8659,8659,,2023,0,0,0
8660,8660,,2024,0,0,0
8661,8661,,2025,0,0,0
8662,8662,,2008,0,3,3
8663,8663,,2026,0,0,0
8664,8664,,2048,2,0,2
8665,8665,,1998,2,0,2
8666,8666,,1214,0,3,3
8667,8667,,1985,0,151,151
8668,8668,,2096,0,2,2
8669,8669,,1998,0,2,2
8670,8670,,1952,2,0,2
8671,8671,,1952,1,0,1
8672,8672,,1998,0,2,2
8673,8673,,2048,0,3,3
8674,8674,,2027,0,0,0
8675,8675,,2028,0,0,0
8676,8676,,2048,1,0,1
8677,8677,,1502,0,2,2
8678,8678,,1952,0,2,2
8679,8679,,1502,0,4,4
8680,8680,,2029,0,0,0
8681,8681,,2030,0,0,0
8682,8682,,1502,0,1,1
8683,8683,,1985,0,4,4
8684,8684,,1502,0,2,2
8685,8685,,2031,0,0,0
8686,8686,,1974,0,9,9
8687,8687,,1974,0,2,2
8688,8688,,2032,0,0,0
8689,8689,,2033,0,0,0
8690,8690,,2034,0,0,0
8691,8691,,2048,0,1,1
8692,8692,,2008,0,364,364
8693,8693,,2008,1,0,1
8694,8694,,2063,2,0,2
8695,8695,,2008,1,0,1
8696,8696,,1502,0,3,3
8697,8697,,2035,0,2,2
8698,8698,,2035,2,0,2
8699,8699,,1985,0,1,1
8700,8700,,1952,3,0,3
8701,8701,,1952,0,6,6
8702,8702,,1952,0,1,1
8703,8703,,1952,3,0,3
8704,8704,,1952,0,17,17
8705,8705,,1952,7,0,7
8706,8706,,1952,1,0,1
8707,8707,,2036,0,0,0
8708,8708,,1974,0,37,37
8709,8709,,2037,0,0,0
8710,8710,,2038,0,2,2
8711,8711,,2039,1,0,1
8712,8712,,1952,0,1,1
8713,8713,,2040,0,0,0
8714,8714,,1974,0,2,2
8715,8715,,1952,0,3,3
8716,8716,,1502,0,4,4
8717,8717,,1952,0,4,4
8718,8718,,1974,0,4,4
8719,8719,,1974,2,0,2
8720,8720,,1974,3,0,3
8721,8721,,1502,0,3,3
8722,8722,,427,2,0,2
8723,8723,,2072,0,3,3
8724,8724,,2041,0,0,0
8725,8725,,2042,0,0,0
8726,8726,,2043,0,0,0
8727,8727,,2044,0,0,0
8728,8728,,1871,1,0,1
8729,8729,,1502,0,2,2
8730,8730,,1985,0,262,262
8731,8731,,2045,0,0,0
8732,8732,,1952,0,1,1
8733,8733,,1952,0,1,1
8734,8734,,1952,0,2,2
8735,8735,,1974,0,7,7
8736,8736,,1952,0,2,2
8737,8737,,2046,0,0,0
8738,8738,,1502,0,2,2
8739,8739,,2047,0,0,0
8740,8740,,2048,0,11,11
8741,8741,,2048,2,0,2
8742,8742,,2048,2,0,2
8743,8743,,1974,0,3,3
8744,8744,,1952,0,5,5
8745,8745,,2048,0,2,2
8746,8746,,1974,0,1,1
8747,8747,,1502,0,4,4
8748,8748,,2049,0,0,0
8749,8749,,1952,0,4,4
8750,8750,,2050,0,0,0
8751,8751,,1952,0,175,175
8752,8752,,1952,0,2,2
8753,8753,,1502,0,9,9
8754,8754,,2051,0,0,0
8755,8755,,2052,0,0,0
8756,8756,,1952,0,169,169
8757,8757,,1952,0,2,2
8758,8758,,1502,0,3,3
8759,8759,,1502,0,9,9
8760,8760,,1952,0,200,200
8761,8761,,1502,0,13,13
8762,8762,,2053,0,0,0
8763,8763,,1952,0,1,1
8764,8764,,1502,0,2,2
8765,8765,,2063,1,0,1
8766,8766,,1502,0,2,2
8767,8767,,1502,0,8,8
8768,8768,,427,0,5,5
8769,8769,,2054,0,0,0
8770,8770,,427,3,0,3
8771,8771,,1502,0,3,3
8772,8772,,2055,0,0,0
8773,8773,,2056,0,0,0
8774,8774,,2057,0,0,0
8775,8775,,2063,0,3,3
8776,8776,,1952,0,3,3
8777,8777,,2058,0,0,0
8778,8778,,1502,0,4,4
8779,8779,,1502,0,161,161
8780,8780,,2059,0,0,0
8781,8781,,2060,0,0,0
8782,8782,,2062,0,3,3
8783,8783,,2063,0,2,2
8784,8784,,1502,0,4,4
8785,8785,,1214,0,2,2
8786,8786,,1985,0,1,1
8787,8787,,2074,0,198,198
8788,8788,,1985,1,0,1
8789,8789,,1502,0,6,6
8790,8790,,1502,0,12,12
8791,8791,,1502,2,0,2
8792,8792,,1952,0,1,1
8793,8793,,2061,0,0,0
8794,8794,,1952,0,2,2
8795,8795,,2062,0,1,1
8796,8796,,2063,0,7,7
8797,8797,,2063,1,0,1
8798,8798,,2064,0,2,2
8799,8799,,2065,0,0,0
8800,8800,,2066,0,0,0
8801,8801,,1203,0,2,2
8802,8802,,1203,2,0,2
8803,8803,,2067,0,0,0
8804,8804,,1502,0,5,5
8805,8805,,2068,0,0,0
8806,8806,,2063,0,4,4
8807,8807,,2110,0,3,3
8808,8808,,2069,0,0,0
8809,8809,,2070,0,0,0
8810,8810,,2071,0,0,0
8811,8811,,1952,0,2,2
8812,8812,,2072,0,385,385
8813,8813,,2072,386,0,386
8814,8814,,1952,0,3,3
8815,8815,,2073,0,0,0
8816,8816,,1502,0,3,3
8817,8817,,2074,0,7,7
8818,8818,,2075,0,0,0
8819,8819,,2076,0,0,0
8820,8820,,2077,0,0,0
8821,8821,,2078,0,0,0
8822,8822,,1502,0,4,4
8823,8823,,2079,0,0,0
8824,8824,,2110,0,211,211
8825,8825,,2072,0,2,2
8826,8826,,2063,0,7,7
8827,8827,,2080,0,0,0
8828,8828,,1952,0,2,2
8829,8829,,2081,0,0,0
8830,8830,,1502,2,0,2
8831,8831,,2082,0,0,0
8832,8832,,1502,0,1,1
8833,8833,,2083,0,0,0
8834,8834,,1952,0,3,3
8835,8835,,2084,0,0,0
8836,8836,,1602,1,0,1
8837,8837,,2085,0,0,0
8838,8838,,1502,0,1,1
8839,8839,,2086,0,0,0
8840,8840,,2063,0,3,3
8841,8841,,2087,0,0,0
8842,8842,,1985,0,203,203
8843,8843,,2088,0,0,0
8844,8844,,2089,0,0,0
8845,8845,,2090,0,0,0
8846,8846,,1998,0,2,2
8847,8847,,2091,0,0,0
8848,8848,,2092,0,0,0
8849,8849,,1502,0,4,4
8850,8850,,1998,0,2,2
8851,8851,,1952,0,7,7
8852,8852,,1952,20,0,20
8853,8853,,1952,1,0,1
8854,8854,,3289,0,11,11
8855,8855,,2093,0,0,0
8856,8856,,2094,0,0,0
8857,8857,,1985,0,3,3
8858,8858,,2095,0,0,0
8859,8859,,1952,0,3,3
8860,8860,,1502,0,1,1
8861,8861,,2096,0,2,2
8862,8862,,2097,0,0,0
8863,8863,,2072,0,827,827
8864,8864,,1998,0,3,3
8865,8865,,1985,0,1,1
8866,8866,,2098,0,0,0
8867,8867,,2099,0,0,0
8868,8868,,2100,0,0,0
8869,8869,,1952,0,2,2
8870,8870,,1502,0,1,1
8871,8871,,2101,0,6,6
8872,8872,,1952,0,5,5
8873,8873,,1952,0,3,3
8874,8874,,1502,0,2,2
8875,8875,,1502,2,0,2
8876,8876,,1502,0,5,5
8877,8877,,1998,0,2,2
8878,8878,,1502,0,1,1
8879,8879,,1502,0,4,4
8880,8880,,427,0,3,3
8881,8881,,427,1,0,1
8882,8882,,2063,0,2,2
8883,8883,,1502,0,2,2
8884,8884,,2102,0,0,0
8885,8885,,2103,0,0,0
8886,8886,,2048,0,2,2
8887,8887,,1502,0,2,2
8888,8888,,1974,0,12,12
8889,8889,,1952,0,3,3
8890,8890,,2104,0,0,0
8891,8891,,2105,0,0,0
8892,8892,,2063,0,28,28
8893,8893,,2106,0,0,0
8894,8894,,2107,0,0,0
8895,8895,,2108,0,0,0
8896,8896,,1952,0,6,6
8897,8897,,1952,3,0,3
8898,8898,,1502,0,9,9
8899,8899,,2109,0,0,0
8900,8900,,1502,2,0,2
8901,8901,,2110,0,2,2
8902,8902,,1946,0,2,2
8903,8903,,2111,0,0,0
8904,8904,,2112,0,0,0
8905,8905,,1952,0,2,2
8906,8906,,1985,0,1,1
8907,8907,,1974,0,11,11
8908,8908,,1974,7,0,7
8909,8909,,2113,0,0,0
8910,8910,,2114,0,0,0
8911,8911,,1974,0,16,16
8912,8912,,2115,0,0,0
8913,8913,,1434,0,2,2
8914,8914,,2116,0,0,0
8915,8915,,2117,0,0,0
8916,8916,,2118,0,0,0
8917,8917,,2119,0,0,0
8918,8918,,2120,0,0,0
8919,8919,,2121,0,0,0
8920,8920,,1952,0,2,2
8921,8921,,1502,0,1,1
8922,8922,,2122,0,0,0
8923,8923,,1214,0,3,3
8924,8924,,1502,0,2,2
8925,8925,,1952,0,1,1
8926,8926,,1952,0,6,6
8927,8927,,3912,0,193,193
8928,8928,,1952,0,3,3
8929,8929,,1502,0,9,9
8930,8930,,1952,0,1,1
8931,8931,,2123,0,0,0
8932,8932,,1502,0,3,3
8933,8933,,2064,0,1,1
8934,8934,,2124,0,0,0
8935,8935,,2125,0,0,0
8936,8936,,2157,0,1,1
8937,8937,,1502,0,2,2
8938,8938,,1952,0,2,2
8939,8939,,1502,0,10,10
8940,8940,,1502,0,8,8
8941,8941,,1952,0,18,18
8942,8942,,2126,0,0,0
8943,8943,,1985,0,527,527
8944,8944,,1214,0,3,3
8945,8945,,1952,0,1,1
8946,8946,,1952,0,3,3
8947,8947,,2127,0,0,0
8948,8948,,825,0,2,2
8949,8949,,158,0,7,7
8950,8950,,1998,0,2,2
8951,8951,,1985,0,2,2
8952,8952,,1502,2,0,2
8953,8953,,2128,0,0,0
8954,8954,,2129,0,0,0
8955,8955,,1985,0,111,111
8956,8956,,1952,0,2,2
8957,8957,,2110,0,193,193
8958,8958,,2130,0,0,0
8959,8959,,2131,0,0,0
8960,8960,,1952,0,2,2
8961,8961,,1296,0,2,2
8962,8962,,2132,0,2,2
8963,8963,,2133,0,0,0
8964,8964,,2134,0,0,0
8965,8965,,2135,0,0,0
8966,8966,,2101,0,3,3
8967,8967,,1998,0,3,3
8968,8968,,2048,0,1,1
8969,8969,,1502,0,1,1
8970,8970,,1502,0,2,2
8971,8971,,2136,0,0,0
8972,8972,,2048,4,0,4
8973,8973,,1502,0,5,5
8974,8974,,2048,0,12,12
8975,8975,,2137,0,0,0
8976,8976,,1974,0,2,2
8977,8977,,1985,0,2,2
8978,8978,,2072,0,4,4
8979,8979,,2072,0,2,2
8980,8980,,2063,0,2,2
8981,8981,,2138,0,0,0
8982,8982,,2072,0,2,2
8983,8983,,158,0,8,8
8984,8984,,2139,0,0,0
8985,8985,,1998,0,6,6
8986,8986,,1998,2,0,2
8987,8987,,2140,0,0,0
8988,8988,,1952,0,2,2
8989,8989,,1952,0,211,211
8990,8990,,2141,0,2,2
8991,8991,,1502,0,3,3
8992,8992,,1203,0,8,8
8993,8993,,1203,1,0,1
8994,8994,,1203,2,0,2
8995,8995,,1203,1,0,1
8996,8996,,2142,0,0,0
8997,8997,,1214,0,2,2
8998,8998,,1952,0,8,8
8999,8999,,1952,0,10,10
9000,9000,,2143,0,0,0
9001,9001,,2144,0,2,2
9002,9002,,1952,10,0,10
9003,9003,,1504,0,1,1
9004,9004,,2145,0,0,0
9005,9005,,2146,0,0,0
9006,9006,,2147,0,0,0
9007,9007,,2074,0,3,3
9008,9008,,1985,0,2,2
9009,9009,,1952,0,3,3
9010,9010,,1952,9,0,9
9011,9011,,1502,0,7,7
9012,9012,,2072,0,5,5
9013,9013,,1502,0,2,2
9014,9014,,1502,0,3,3
9015,9015,,2063,0,18,18
9016,9016,,2096,0,2,2
9017,9017,,1985,0,2,2
9018,9018,,1985,0,177,177
9019,9019,,1502,0,2,2
9020,9020,,1985,0,2,2
9021,9021,,2148,0,0,0
9022,9022,,2149,0,0,0
9023,9023,,2150,0,0,0
9024,9024,,1502,0,7,7
9025,9025,,2151,0,0,0
9026,9026,,1998,0,2,2
9027,9027,,1502,0,2,2
9028,9028,,1998,0,3,3
9029,9029,,2152,0,0,0
9030,9030,,2153,0,0,0
9031,9031,,2154,0,0,0
9032,9032,,1946,0,2,2
9033,9033,,2155,0,0,0
9034,9034,,2156,0,0,0
9035,9035,,2157,0,1,1
9036,9036,,1502,0,17,17
9037,9037,,1952,0,4,4
9038,9038,,1974,0,2,2
9039,9039,,2158,0,0,0
9040,9040,,2159,0,0,0
9041,9041,,2160,0,0,0
9042,9042,,1952,0,2,2
9043,9043,,1502,0,5,5
9044,9044,,427,0,5,5
9045,9045,,1985,0,144,144
9046,9046,,2161,0,1,1
9047,9047,,2161,1,0,1
9048,9048,,1502,0,6,6
9049,9049,,2162,0,0,0
9050,9050,,1974,1,0,1
9051,9051,,1952,0,176,176
9052,9052,,2163,0,0,0
9053,9053,,2048,0,3,3
9054,9054,,1974,0,11,11
9055,9055,,1974,2,0,2
9056,9056,,1502,0,5,5
9057,9057,,1998,0,5,5
9058,9058,,2074,0,2,2
9059,9059,,2164,0,0,0
9060,9060,,3289,0,7,7
9061,9061,,2165,0,0,0
9062,9062,,1602,0,2,2
9063,9063,,1985,0,166,166
9064,9064,,2166,0,0,0
9065,9065,,2167,0,0,0
9066,9066,,2168,0,0,0
9067,9067,,2169,0,0,0
9068,9068,,1952,0,9,9
9069,9069,,2063,0,2,2
9070,9070,,1985,0,187,187
9071,9071,,1998,0,1,1
9072,9072,,2170,0,1,1
9073,9073,,2171,0,0,0
9074,9074,,1502,0,4,4
9075,9075,,158,0,4,4
9076,9076,,2063,0,204,204
9077,9077,,2172,0,0,0
9078,9078,,2173,0,0,0
9079,9079,,2174,0,0,0
9080,9080,,2175,0,0,0
9081,9081,,1502,0,2,2
9082,9082,,2176,0,0,0
9083,9083,,1952,0,3,3
9084,9084,,1502,0,5,5
9085,9085,,2177,0,0,0
9086,9086,,1502,0,2,2
9087,9087,,1502,0,2,2
9088,9088,,427,0,5,5
9089,9089,,1998,0,3,3
9090,9090,,1502,0,11,11
9091,9091,,2178,0,0,0
9092,9092,,427,0,2,2
9093,9093,,2179,0,0,0
9094,9094,,2180,0,0,0
9095,9095,,1952,0,6,6
9096,9096,,1502,0,3,3
9097,9097,,2181,0,1,1
9098,9098,,2181,1,0,1
9099,9099,,1952,0,1,1
9100,9100,,1203,0,2,2
9101,9101,,1952,0,10,10
9102,9102,,2182,0,0,0
9103,9103,,1998,0,2,2
9104,9104,,2183,0,0,0
9105,9105,,1502,0,2,2
9106,9106,,2184,0,0,0
9107,9107,,2185,0,0,0
9108,9108,,2186,0,0,0
9109,9109,,2063,3,0,3
9110,9110,,1214,0,1,1
9111,9111,,2063,0,3,3
9112,9112,,2187,0,0,0
9113,9113,,2063,0,11,11
9114,9114,,2188,0,0,0
9115,9115,,2189,0,0,0
9116,9116,,2190,0,2,2
9117,9117,,2191,0,0,0
9118,9118,,2192,0,0,0
9119,9119,,1998,0,2,2
9120,9120,,1502,0,1,1
9121,9121,,2072,0,4,4
9122,9122,,1974,0,5,5
9123,9123,,1502,0,2,2
9124,9124,,1214,0,3,3
9125,9125,,2193,0,0,0
9126,9126,,2194,0,0,0
9127,9127,,1985,0,3,3
9128,9128,,2195,0,0,0
9129,9129,,1952,0,2,2
9130,9130,,158,208,0,208
9131,9131,,158,208,0,208
9132,9132,,158,208,0,208
9133,9133,,158,212,0,212
9134,9134,,158,208,0,208
9135,9135,,158,208,0,208
9136,9136,,158,422,0,422
9137,9137,,158,422,0,422
9138,9138,,158,422,0,422
9139,9139,,158,422,0,422
9140,9140,,158,422,0,422
9141,9141,,991,0,211,211
9142,9142,,1602,185,0,185
9143,9143,,47,0,211,211
9144,9144,,158,0,3376,3376
9145,9145,,261,0,211,211
9146,9146,,132,0,211,211
9147,9147,,99,211,0,211
9148,9148,,2196,0,0,0
9149,9149,,1985,450,0,450
9150,9150,,1502,13,0,13
9151,9151,,3289,0,18,18
9152,9152,,1602,4,0,4
9153,9153,,1602,8,0,8
9154,9154,,2197,0,1,1
9155,9155,,2197,1,0,1
9156,9156,,1985,0,44,44
9157,9157,,1602,32,0,32
9158,9158,,1602,0,2,2
9159,9159,,1214,110,0,110
9160,9160,,2198,0,0,0
9161,9161,,1602,0,42,42
9162,9162,,38,0,100,100
9163,9163,,1602,0,29,29
9164,9164,,46,0,210,210
9165,9165,,2063,4,0,4
9166,9166,,1214,0,6,6
9167,9167,,1998,0,2,2
9168,9168,,1502,0,4,4
9169,9169,,2199,0,0,0
9170,9170,,2200,0,0,0
9171,9171,,2201,0,0,0
9172,9172,,2202,0,0,0
9173,9173,,2203,0,0,0
9174,9174,,2204,0,0,0
9175,9175,,2205,0,0,0
9176,9176,,1952,1,0,1
9177,9177,,2206,0,0,0
9178,9178,,1952,7,0,7
9179,9179,,1998,0,5,5
9180,9180,,2048,3,0,3
9181,9181,,2207,0,0,0
9182,9182,,2063,9,0,9
9183,9183,,1974,1,0,1
9184,9184,,1974,1,0,1
9185,9185,,2208,1,0,1
9186,9186,,2209,0,0,0
9187,9187,,1502,0,7,7
9188,9188,,1502,0,3,3
9189,9189,,2210,0,0,0
9190,9190,,2048,2,0,2
9191,9191,,2211,0,0,0
9192,9192,,2304,1,0,1
9193,9193,,2212,0,0,0
9194,9194,,2213,0,0,0
9195,9195,,1214,0,7,7
9196,9196,,1502,0,2,2
9197,9197,,1214,0,8,8
9198,9198,,1952,2,0,2
9199,9199,,2214,0,0,0
9200,9200,,2048,2,0,2
9201,9201,,2215,0,0,0
9202,9202,,2216,0,0,0
9203,9203,,2048,2,0,2
9204,9204,,2217,0,0,0
9205,9205,,2218,0,0,0
9206,9206,,2219,0,0,0
9207,9207,,1952,0,4,4
9208,9208,,1952,1,0,1
9209,9209,,2220,0,0,0
9210,9210,,2221,0,0,0
9211,9211,,1502,0,4,4
9212,9212,,2222,0,0,0
9213,9213,,2223,0,0,0
9214,9214,,1214,0,7,7
9215,9215,,2224,0,0,0
9216,9216,,2225,0,0,0
9217,9217,,2226,0,0,0
9218,9218,,1952,0,206,206
9219,9219,,2227,0,0,0
9220,9220,,2063,0,3,3
9221,9221,,1214,0,2,2
9222,9222,,1998,0,6,6
9223,9223,,1998,0,3,3
9224,9224,,2228,0,0,0
9225,9225,,1502,0,4,4
9226,9226,,1952,0,2,2
9227,9227,,1952,0,142,142
9228,9228,,1502,0,4,4
9229,9229,,1952,0,2,2
9230,9230,,2048,0,2,2
9231,9231,,2048,1,0,1
9232,9232,,1214,0,2,2
9233,9233,,1502,0,4,4
9234,9234,,1214,0,10,10
9235,9235,,2229,0,0,0
9236,9236,,1952,0,142,142
9237,9237,,1214,0,5,5
9238,9238,,1502,0,3,3
9239,9239,,1998,0,3,3
9240,9240,,2230,0,0,0
9241,9241,,2063,0,6,6
9242,9242,,2231,0,0,0
9243,9243,,2232,0,0,0
9244,9244,,1502,0,4,4
9245,9245,,1952,1,0,1
9246,9246,,1952,1,0,1
9247,9247,,2233,0,0,0
9248,9248,,2234,0,0,0
9249,9249,,1952,3,0,3
9250,9250,,1952,1,0,1
9251,9251,,1952,1,0,1
9252,9252,,2235,0,0,0
9253,9253,,1499,0,1,1
9254,9254,,1499,0,2,2
9255,9255,,1502,0,3,3
9256,9256,,2236,0,0,0
9257,9257,,2237,0,0,0
9258,9258,,1502,0,4,4
9259,9259,,2238,0,0,0
9260,9260,,2239,0,0,0
9261,9261,,2240,0,0,0
9262,9262,,2063,0,1,1
9263,9263,,1502,0,3,3
9264,9264,,1502,0,3,3
9265,9265,,1952,1,0,1
9266,9266,,1952,2,0,2
9267,9267,,2241,0,0,0
9268,9268,,1502,0,9,9
9269,9269,,1502,0,6,6
9270,9270,,2242,0,0,0
9271,9271,,1952,2,0,2
9272,9272,,1502,0,4,4
9273,9273,,1952,4,0,4
9274,9274,,1974,2,0,2
9275,9275,,2243,0,0,0
9276,9276,,2244,0,0,0
9277,9277,,2245,0,0,0
9278,9278,,2246,0,0,0
9279,9279,,2247,0,0,0
9280,9280,,1952,0,3,3
9281,9281,,2248,0,0,0
9282,9282,,2249,0,0,0
9283,9283,,1214,0,3,3
9284,9284,,2250,0,0,0
9285,9285,,2251,0,0,0
9286,9286,,2252,0,0,0
9287,9287,,2253,0,0,0
9288,9288,,1998,0,5,5
9289,9289,,1502,0,2,2
9290,9290,,2254,0,0,0
9291,9291,,1502,0,2,2
9292,9292,,2255,0,0,0
9293,9293,,1998,0,3,3
9294,9294,,1952,0,161,161
9295,9295,,1214,0,7,7
9296,9296,,1977,1,0,1
9297,9297,,2256,0,0,0
9298,9298,,2257,0,0,0
9299,9299,,1952,2,0,2
9300,9300,,1952,1,0,1
9301,9301,,2258,0,0,0
9302,9302,,2259,0,0,0
9303,9303,,2260,0,0,0
9304,9304,,2261,0,0,0
9305,9305,,2262,0,0,0
9306,9306,,1952,0,163,163
9307,9307,,1998,0,2,2
9308,9308,,1998,0,6,6
9309,9309,,2263,0,0,0
9310,9310,,1952,2,0,2
9311,9311,,1952,1,0,1
9312,9312,,1502,0,3,3
9313,9313,,2264,0,0,0
9314,9314,,2265,0,0,0
9315,9315,,1502,0,14,14
9316,9316,,1214,0,5,5
9317,9317,,2266,0,0,0
9318,9318,,1952,2,0,2
9319,9319,,2267,0,0,0
9320,9320,,2268,0,0,0
9321,9321,,2269,0,0,0
9322,9322,,2270,0,0,0
9323,9323,,2271,0,0,0
9324,9324,,2272,0,0,0
9325,9325,,2273,0,0,0
9326,9326,,2274,0,0,0
9327,9327,,2275,0,0,0
9328,9328,,2276,0,0,0
9329,9329,,1811,1,0,1
9330,9330,,2277,0,0,0
9331,9331,,2278,0,0,0
9332,9332,,2279,0,0,0
9333,9333,,1952,9,0,9
9334,9334,,2280,0,0,0
9335,9335,,2281,0,0,0
9336,9336,,1502,0,2,2
9337,9337,,1998,0,3,3
9338,9338,,1952,0,2,2
9339,9339,,1502,0,2,2
9340,9340,,2282,0,0,0
9341,9341,,1502,0,2,2
9342,9342,,1214,0,3,3
9343,9343,,2283,0,0,0
9344,9344,,2284,0,0,0
9345,9345,,2285,0,0,0
9346,9346,,2286,0,0,0
9347,9347,,2048,1,0,1
9348,9348,,1214,0,8,8
9349,9349,,1214,0,2,2
9350,9350,,1952,0,1,1
9351,9351,,1998,0,7,7
9352,9352,,2287,0,0,0
9353,9353,,1998,0,2,2
9354,9354,,2288,0,0,0
9355,9355,,2289,0,0,0
9356,9356,,1502,0,2,2
9357,9357,,1214,0,12,12
9358,9358,,2290,0,0,0
9359,9359,,2291,0,0,0
9360,9360,,2292,0,0,0
9361,9361,,1502,0,9,9
9362,9362,,2293,0,0,0
9363,9363,,1502,0,6,6
9364,9364,,1214,0,2,2
9365,9365,,1214,0,9,9
9366,9366,,1502,0,4,4
9367,9367,,2294,0,0,0
9368,9368,,2295,0,0,0
9369,9369,,1952,0,3,3
9370,9370,,1998,0,2,2
9371,9371,,1998,0,5,5
9372,9372,,2296,0,0,0
9373,9373,,2297,0,0,0
9374,9374,,1952,1,0,1
9375,9375,,1502,0,2,2
9376,9376,,2048,0,3,3
9377,9377,,1998,0,6,6
9378,9378,,2048,0,2,2
9379,9379,,1998,0,2,2
9380,9380,,1502,0,2,2
9381,9381,,1998,0,5,5
9382,9382,,2298,0,0,0
9383,9383,,2299,0,0,0
9384,9384,,2300,0,0,0
9385,9385,,1952,0,3,3
9386,9386,,1952,0,211,211
9387,9387,,2301,0,0,0
9388,9388,,2302,0,0,0
9389,9389,,2303,0,0,0
9390,9390,,1952,0,177,177
9391,9391,,2304,0,1,1
9392,9392,,1952,0,2,2
9393,9393,,1998,0,2,2
9394,9394,,1952,0,2,2
9395,9395,,1214,0,3,3
9396,9396,,1952,0,4,4
9397,9397,,1502,0,7,7
9398,9398,,2305,0,0,0
9399,9399,,1998,0,3,3
9400,9400,,2306,0,0,0
9401,9401,,1952,0,138,138
9402,9402,,1998,0,3,3
9403,9403,,2307,0,0,0
9404,9404,,1502,0,3,3
9405,9405,,1952,0,5,5
9406,9406,,1952,0,1,1
9407,9407,,2308,0,0,0
9408,9408,,1998,0,3,3
9409,9409,,1952,0,3,3
9410,9410,,1998,0,2,2
9411,9411,,1502,0,3,3
9412,9412,,1502,0,4,4
9413,9413,,1502,0,5,5
9414,9414,,1998,0,2,2
9415,9415,,1998,0,3,3
9416,9416,,1952,0,2,2
9417,9417,,2309,0,1,1
9418,9418,,2309,1,0,1
9419,9419,,1214,0,2,2
9420,9420,,1985,0,179,179
9421,9421,,1998,0,3,3
9422,9422,,2310,0,0,0
9423,9423,,1502,0,11,11
9424,9424,,2311,0,0,0
9425,9425,,1502,0,6,6
9426,9426,,1998,0,2,2
9427,9427,,1502,0,10,10
9428,9428,,1952,2,0,2
9429,9429,,1998,0,8,8
9430,9430,,1952,0,2,2
9431,9431,,1998,0,14,14
9432,9432,,2317,0,1,1
9433,9433,,2312,0,0,0
9434,9434,,456,351,0,351
9435,9435,,467,3,0,3
9436,9436,,456,0,50,50
9437,9437,,456,50,0,50
9438,9438,,456,5,0,5
9439,9439,,456,0,7,7
9440,9440,,456,4,0,4
9441,9441,,2319,0,3,3
9442,9442,,2319,13,0,13
9443,9443,,2072,10,0,10
9444,9444,,456,0,2,2
9445,9445,,2314,1,0,1
9446,9446,,2313,0,0,0
9447,9447,,456,2,0,2
9448,9448,,2314,0,1,1
9449,9449,,2315,0,0,0
9450,9450,,2319,0,3,3
9451,9451,,2319,18,0,18
9452,9452,,2319,0,5,5
9453,9453,,2319,2,0,2
9454,9454,,2319,2,0,2
9455,9455,,2319,92,0,92
9456,9456,,2319,0,4,4
9457,9457,,2319,16,0,16
9458,9458,,2319,5,0,5
9459,9459,,2319,0,2,2
9460,9460,,2316,0,0,0
9461,9461,,2317,1,0,1
9462,9462,,1214,207,0,207
9463,9463,,456,0,6,6
9464,9464,,456,1,0,1
9465,9465,,456,216,0,216
9466,9466,,2318,0,0,0
9467,9467,,2319,0,2,2
9468,9468,,579,5,0,5
9469,9469,,2319,5,0,5
9470,9470,,2319,0,92,92
9471,9471,,1974,5,0,5
9472,9472,,2319,0,2,2
9473,9473,,467,7,0,7
9474,9474,,456,0,3,3
9475,9475,,456,4,0,4
9476,9476,,2320,0,0,0
9477,9477,,2319,5,0,5
9478,9478,,2321,0,0,0
9479,9479,,2319,2,0,2
9480,9480,,2322,0,0,0
9481,9481,,2323,0,0,0
9482,9482,,2338,0,10,10
9483,9483,,2338,20,0,20
9484,9484,,2338,2,0,2
9485,9485,,1952,1,0,1
9486,9486,,2324,0,0,0
9487,9487,,2325,0,0,0
9488,9488,,2326,0,0,0
9489,9489,,2327,0,0,0
9490,9490,,2319,0,4,4
9491,9491,,2319,1,0,1
9492,9492,,2328,0,0,0
9493,9493,,2329,0,0,0
9494,9494,,2319,0,2,2
9495,9495,,2319,0,3,3
9496,9496,,2330,0,0,0
9497,9497,,456,0,2,2
9498,9498,,2335,0,2,2
9499,9499,,2335,3,0,3
9500,9500,,2335,3,0,3
9501,9501,,2331,0,0,0
9502,9502,,2332,0,0,0
9503,9503,,456,0,11,11
9504,9504,,2333,0,0,0
9505,9505,,2319,0,2,2
9506,9506,,2319,0,2,2
9507,9507,,2319,0,6,6
9508,9508,,456,0,2,2
9509,9509,,2334,0,0,0
9510,9510,,456,2,0,2
9511,9511,,1214,2,0,2
9512,9512,,2319,0,2,2
9513,9513,,2335,0,4,4
9514,9514,,2336,0,0,0
9515,9515,,2319,0,3,3
9516,9516,,2319,0,4,4
9517,9517,,456,0,2,2
9518,9518,,2339,0,2,2
9519,9519,,2339,5,0,5
9520,9520,,2337,0,2,2
9521,9521,,2337,2,0,2
9522,9522,,2319,0,3,3
9523,9523,,456,0,2,2
9524,9524,,2319,0,3,3
9525,9525,,2338,0,12,12
9526,9526,,2319,0,3,3
9527,9527,,2335,0,2,2
9528,9528,,2335,2,0,2
9529,9529,,2319,0,3,3
9530,9530,,2319,0,2,2
9531,9531,,2319,0,4,4
9532,9532,,2319,0,1,1
9533,9533,,2339,0,3,3
9534,9534,,456,0,214,214
9535,9535,,1214,2,0,2
9536,9536,,2340,0,0,0
9537,9537,,2341,0,0,0
9538,9538,,3289,88,0,88
9539,9539,,3289,23,0,23
9540,9540,,3289,4,0,4
9541,9541,,3289,5,0,5
9542,9542,,2342,0,0,0
9543,9543,,3289,61,0,61
9544,9544,,3289,226,0,226
9545,9545,,3289,2,0,2
9546,9546,,3289,84,0,84
9547,9547,,3289,16,0,16
9548,9548,,3289,8,0,8
9549,9549,,3289,19,0,19
9550,9550,,3289,19,0,19
9551,9551,,3289,3,0,3
9552,9552,,3289,9,0,9
9553,9553,,3289,1,0,1
9554,9554,,3289,1,0,1
9555,9555,,3289,1,0,1
9556,9556,,3289,10,0,10
9557,9557,,3289,46,0,46
9558,9558,,3289,16,0,16
9559,9559,,2343,0,0,0
9560,9560,,3289,11,0,11
9561,9561,,3289,4,0,4
9562,9562,,3289,9,0,9
9563,9563,,3289,3,0,3
9564,9564,,3289,2,0,2
9565,9565,,3289,6,0,6
9566,9566,,3289,19,0,19
9567,9567,,3289,35,0,35
9568,9568,,3289,88,0,88
9569,9569,,3289,12,0,12
9570,9570,,3289,9,0,9
9571,9571,,3289,0,24,24
9572,9572,,3289,7,0,7
9573,9573,,3289,14,0,14
9574,9574,,3289,26,0,26
9575,9575,,3289,16,0,16
9576,9576,,3289,13,0,13
9577,9577,,3289,15,0,15
9578,9578,,3289,1,0,1
9579,9579,,3289,42,0,42
9580,9580,,3289,13,0,13
9581,9581,,3289,36,0,36
9582,9582,,3289,4,0,4
9583,9583,,3289,3,0,3
9584,9584,,3289,8,0,8
9585,9585,,3289,6,0,6
9586,9586,,3289,14,0,14
9587,9587,,3289,15,0,15
9588,9588,,3289,0,2,2
9589,9589,,3289,476,0,476
9590,9590,,3289,12,0,12
9591,9591,,3289,16,0,16
9592,9592,,3289,77,0,77
9593,9593,,3289,6,0,6
9594,9594,,3289,28,0,28
9595,9595,,3289,93,0,93
9596,9596,,3289,0,8,8
9597,9597,,3289,32,0,32
9598,9598,,3289,10,0,10
9599,9599,,3341,4,0,4
9600,9600,,3289,13,0,13
9601,9601,,3289,8,0,8
9602,9602,,2344,0,0,0
9603,9603,,3289,28,0,28
9604,9604,,3289,13,0,13
9605,9605,,3289,2,0,2
9606,9606,,3289,7,0,7
9607,9607,,2345,0,0,0
9608,9608,,3289,1,0,1
9609,9609,,3289,7,0,7
9610,9610,,2346,0,0,0
9611,9611,,3289,0,12,12
9612,9612,,3289,18,0,18
9613,9613,,3289,3,0,3
9614,9614,,3289,15,0,15
9615,9615,,3289,1,0,1
9616,9616,,3289,0,23,23
9617,9617,,3289,25,0,25
9618,9618,,3289,16,0,16
9619,9619,,3289,1,0,1
9620,9620,,2347,0,0,0
9621,9621,,3289,2,0,2
9622,9622,,3289,17,0,17
9623,9623,,3289,7,0,7
9624,9624,,3289,12,0,12
9625,9625,,3289,5,0,5
9626,9626,,2348,0,0,0
9627,9627,,2349,0,0,0
9628,9628,,3289,6,0,6
9629,9629,,2350,0,0,0
9630,9630,,3289,46,0,46
9631,9631,,2351,0,0,0
9632,9632,,2352,0,0,0
9633,9633,,3289,22,0,22
9634,9634,,2544,3,0,3
9635,9635,,2353,0,0,0
9636,9636,,3289,7,0,7
9637,9637,,3289,4,0,4
9638,9638,,2354,0,0,0
9639,9639,,3289,18,0,18
9640,9640,,3405,2,0,2
9641,9641,,3289,5,0,5
9642,9642,,3289,10,0,10
9643,9643,,3289,38,0,38
9644,9644,,3289,2,0,2
9645,9645,,3289,12,0,12
9646,9646,,2355,0,0,0
9647,9647,,3289,7,0,7
9648,9648,,3289,16,0,16
9649,9649,,2356,0,0,0
9650,9650,,3289,16,0,16
9651,9651,,3289,5,0,5
9652,9652,,2357,0,0,0
9653,9653,,3289,19,0,19
9654,9654,,3289,23,0,23
9655,9655,,3289,3,0,3
9656,9656,,3289,4,0,4
9657,9657,,2358,0,0,0
9658,9658,,3289,12,0,12
9659,9659,,3289,23,0,23
9660,9660,,3289,18,0,18
9661,9661,,2359,0,0,0
9662,9662,,2360,0,0,0
9663,9663,,3289,18,0,18
9664,9664,,2361,0,0,0
9665,9665,,3289,5,0,5
9666,9666,,2362,0,0,0
9667,9667,,2363,0,0,0
9668,9668,,3289,14,0,14
9669,9669,,3289,1,0,1
9670,9670,,3289,0,23,23
9671,9671,,3289,6,0,6
9672,9672,,3289,10,0,10
9673,9673,,3289,12,0,12
9674,9674,,3289,8,0,8
9675,9675,,3289,2,0,2
9676,9676,,2364,0,0,0
9677,9677,,3289,9,0,9
9678,9678,,3289,25,0,25
9679,9679,,3289,22,0,22
9680,9680,,3289,0,211,211
9681,9681,,3289,2,0,2
9682,9682,,2365,0,0,0
9683,9683,,3289,8,0,8
9684,9684,,3289,2,0,2
9685,9685,,3289,17,0,17
9686,9686,,3289,2,0,2
9687,9687,,3289,1,0,1
9688,9688,,2366,0,0,0
9689,9689,,3289,106,0,106
9690,9690,,1296,13,0,13
9691,9691,,3289,0,3,3
9692,9692,,3289,3,0,3
9693,9693,,3289,18,0,18
9694,9694,,3289,3,0,3
9695,9695,,3289,25,0,25
9696,9696,,3289,2,0,2
9697,9697,,2367,0,0,0
9698,9698,,3289,35,0,35
9699,9699,,3289,1,0,1
9700,9700,,3289,9,0,9
9701,9701,,3289,21,0,21
9702,9702,,3289,1,0,1
9703,9703,,3289,11,0,11
9704,9704,,3289,2,0,2
9705,9705,,2368,0,0,0
9706,9706,,3289,10,0,10
9707,9707,,3289,16,0,16
9708,9708,,3289,32,0,32
9709,9709,,3289,11,0,11
9710,9710,,3289,10,0,10
9711,9711,,2369,0,0,0
9712,9712,,3289,26,0,26
9713,9713,,2370,0,0,0
9714,9714,,3289,0,16,16
9715,9715,,2371,0,0,0
9716,9716,,3289,13,0,13
9717,9717,,3289,7,0,7
9718,9718,,2372,0,0,0
9719,9719,,3289,1,0,1
9720,9720,,3289,3,0,3
9721,9721,,3289,27,0,27
9722,9722,,3289,8,0,8
9723,9723,,3289,12,0,12
9724,9724,,3289,4,0,4
9725,9725,,3289,41,0,41
9726,9726,,2373,0,0,0
9727,9727,,3289,22,0,22
9728,9728,,3289,44,0,44
9729,9729,,3289,6,0,6
9730,9730,,3289,6,0,6
9731,9731,,3289,2,0,2
9732,9732,,2374,0,0,0
9733,9733,,2375,0,0,0
9734,9734,,3289,2,0,2
9735,9735,,3289,5,0,5
9736,9736,,3289,3,0,3
9737,9737,,3289,4,0,4
9738,9738,,3289,22,0,22
9739,9739,,2376,0,0,0
9740,9740,,3289,4,0,4
9741,9741,,3289,4,0,4
9742,9742,,2377,0,0,0
9743,9743,,3289,2,0,2
9744,9744,,3289,50,0,50
9745,9745,,3289,6,0,6
9746,9746,,3289,11,0,11
9747,9747,,2378,0,0,0
9748,9748,,2379,0,0,0
9749,9749,,2380,0,0,0
9750,9750,,2381,0,0,0
9751,9751,,2382,0,0,0
9752,9752,,3289,6,0,6
9753,9753,,2383,0,0,0
9754,9754,,3289,12,0,12
9755,9755,,3289,0,2,2
9756,9756,,3289,62,0,62
9757,9757,,3289,38,0,38
9758,9758,,3289,12,0,12
9759,9759,,3289,18,0,18
9760,9760,,2384,0,0,0
9761,9761,,3289,7,0,7
9762,9762,,3289,18,0,18
9763,9763,,3289,13,0,13
9764,9764,,2385,0,0,0
9765,9765,,2386,0,0,0
9766,9766,,3289,14,0,14
9767,9767,,3289,15,0,15
9768,9768,,3289,11,0,11
9769,9769,,3289,6,0,6
9770,9770,,2387,0,0,0
9771,9771,,2388,0,0,0
9772,9772,,3289,0,24,24
9773,9773,,3289,12,0,12
9774,9774,,3289,8,0,8
9775,9775,,3289,18,0,18
9776,9776,,3289,31,0,31
9777,9777,,3289,30,0,30
9778,9778,,3734,0,3,3
9779,9779,,3734,4,0,4
9780,9780,,3289,6,0,6
9781,9781,,3734,6,0,6
9782,9782,,3289,0,21,21
9783,9783,,3289,20,0,20
9784,9784,,3289,2,0,2
9785,9785,,3289,138,0,138
9786,9786,,2389,0,0,0
9787,9787,,3289,8,0,8
9788,9788,,3289,4,0,4
9789,9789,,3289,9,0,9
9790,9790,,3289,13,0,13
9791,9791,,3289,32,0,32
9792,9792,,3289,4,0,4
9793,9793,,3289,1,0,1
9794,9794,,3289,3,0,3
9795,9795,,2390,0,0,0
9796,9796,,2391,0,0,0
9797,9797,,3289,9,0,9
9798,9798,,3289,3,0,3
9799,9799,,3289,18,0,18
9800,9800,,3289,35,0,35
9801,9801,,2392,0,0,0
9802,9802,,3289,2,0,2
9803,9803,,2393,0,0,0
9804,9804,,3289,1,0,1
9805,9805,,2394,0,0,0
9806,9806,,2395,0,0,0
9807,9807,,3289,4,0,4
9808,9808,,2396,0,0,0
9809,9809,,3289,3,0,3
9810,9810,,3289,23,0,23
9811,9811,,3289,15,0,15
9812,9812,,2397,0,0,0
9813,9813,,3289,74,0,74
9814,9814,,2398,0,0,0
9815,9815,,3289,22,0,22
9816,9816,,3289,32,0,32
9817,9817,,3289,6,0,6
9818,9818,,3289,42,0,42
9819,9819,,2399,0,0,0
9820,9820,,3289,16,0,16
9821,9821,,2400,0,0,0
9822,9822,,3289,19,0,19
9823,9823,,3289,13,0,13
9824,9824,,3289,2,0,2
9825,9825,,3289,44,0,44
9826,9826,,3289,15,0,15
9827,9827,,3289,17,0,17
9828,9828,,2401,0,0,0
9829,9829,,3289,30,0,30
9830,9830,,3289,2,0,2
9831,9831,,2402,0,0,0
9832,9832,,2403,0,0,0
9833,9833,,3289,21,0,21
9834,9834,,2404,0,0,0
9835,9835,,2405,0,0,0
9836,9836,,2406,0,0,0
9837,9837,,3289,2,0,2
9838,9838,,2407,0,0,0
9839,9839,,3289,17,0,17
9840,9840,,3289,44,0,44
9841,9841,,2408,0,0,0
9842,9842,,3289,9,0,9
9843,9843,,3289,1,0,1
9844,9844,,2409,0,0,0
9845,9845,,3289,16,0,16
9846,9846,,2410,0,0,0
9847,9847,,3289,1,0,1
9848,9848,,2411,0,0,0
9849,9849,,3289,4,0,4
9850,9850,,3289,32,0,32
9851,9851,,3289,1,0,1
9852,9852,,3289,0,12,12
9853,9853,,3289,7,0,7
9854,9854,,3289,15,0,15
9855,9855,,3289,0,6,6
9856,9856,,3289,30,0,30
9857,9857,,3289,12,0,12
9858,9858,,3289,37,0,37
9859,9859,,3289,22,0,22
9860,9860,,2412,0,0,0
9861,9861,,3289,5,0,5
9862,9862,,3289,2,0,2
9863,9863,,3289,20,0,20
9864,9864,,3289,0,22,22
9865,9865,,3289,9,0,9
9866,9866,,3289,14,0,14
9867,9867,,3289,1,0,1
9868,9868,,3289,1,0,1
9869,9869,,2413,0,0,0
9870,9870,,3289,19,0,19
9871,9871,,3289,28,0,28
9872,9872,,3289,0,2,2
9873,9873,,3289,6,0,6
9874,9874,,3289,1,0,1
9875,9875,,3289,4,0,4
9876,9876,,3289,1,0,1
9877,9877,,2414,0,0,0
9878,9878,,3289,23,0,23
9879,9879,,2415,0,0,0
9880,9880,,3289,10,0,10
9881,9881,,3289,6,0,6
9882,9882,,2416,0,0,0
9883,9883,,2417,0,0,0
9884,9884,,2418,0,0,0
9885,9885,,3289,11,0,11
9886,9886,,3289,40,0,40
9887,9887,,3289,4,0,4
9888,9888,,2419,0,0,0
9889,9889,,2420,0,0,0
9890,9890,,3289,5,0,5
9891,9891,,2421,0,0,0
9892,9892,,2422,0,0,0
9893,9893,,3289,66,0,66
9894,9894,,2423,0,0,0
9895,9895,,2424,0,0,0
9896,9896,,2425,0,0,0
9897,9897,,2426,0,0,0
9898,9898,,3289,8,0,8
9899,9899,,3289,1,0,1
9900,9900,,3289,8,0,8
9901,9901,,2427,0,0,0
9902,9902,,2428,0,0,0
9903,9903,,3289,9,0,9
9904,9904,,3289,0,11,11
9905,9905,,3289,17,0,17
9906,9906,,3289,7,0,7
9907,9907,,3289,2,0,2
9908,9908,,3289,6,0,6
9909,9909,,3289,0,29,29
9910,9910,,3289,2,0,2
9911,9911,,3289,7,0,7
9912,9912,,3289,52,0,52
9913,9913,,1974,15,0,15
9914,9914,,2429,0,0,0
9915,9915,,2430,0,0,0
9916,9916,,3289,3,0,3
9917,9917,,2431,0,0,0
9918,9918,,2432,0,0,0
9919,9919,,3289,1,0,1
9920,9920,,3289,1,0,1
9921,9921,,3289,1,0,1
9922,9922,,3289,0,3,3
9923,9923,,3289,37,0,37
9924,9924,,2433,0,0,0
9925,9925,,2434,0,0,0
9926,9926,,3289,25,0,25
9927,9927,,3289,21,0,21
9928,9928,,2435,0,0,0
9929,9929,,2436,0,0,0
9930,9930,,2437,0,0,0
9931,9931,,3289,9,0,9
9932,9932,,2438,0,0,0
9933,9933,,3289,4,0,4
9934,9934,,3289,29,0,29
9935,9935,,2439,0,0,0
9936,9936,,3289,2,0,2
9937,9937,,3289,26,0,26
9938,9938,,3289,1,0,1
9939,9939,,3289,26,0,26
9940,9940,,2440,0,0,0
9941,9941,,3289,8,0,8
9942,9942,,3289,3,0,3
9943,9943,,2441,0,0,0
9944,9944,,2442,0,0,0
9945,9945,,3289,1,0,1
9946,9946,,2443,0,0,0
9947,9947,,2444,0,0,0
9948,9948,,2445,0,0,0
9949,9949,,3289,11,0,11
9950,9950,,3289,6,0,6
9951,9951,,2446,0,0,0
9952,9952,,2447,0,0,0
9953,9953,,2448,0,0,0
9954,9954,,2449,0,0,0
9955,9955,,2450,0,0,0
9956,9956,,2451,0,0,0
9957,9957,,3289,1,0,1
9958,9958,,2452,0,0,0
9959,9959,,3289,23,0,23
9960,9960,,2453,0,0,0
9961,9961,,2454,0,0,0
9962,9962,,2455,0,0,0
9963,9963,,2456,0,0,0
9964,9964,,3289,5,0,5
9965,9965,,2457,0,0,0
9966,9966,,3289,2,0,2
9967,9967,,2458,0,0,0
9968,9968,,2459,0,0,0
9969,9969,,3289,4,0,4
9970,9970,,2460,0,0,0
9971,9971,,2461,0,0,0
9972,9972,,2462,0,0,0
9973,9973,,3289,4,0,4
9974,9974,,3289,20,0,20
9975,9975,,3289,0,30,30
9976,9976,,3289,8,0,8
9977,9977,,3289,0,19,19
9978,9978,,3289,5,0,5
9979,9979,,3289,20,0,20
9980,9980,,3289,15,0,15
9981,9981,,3289,5,0,5
9982,9982,,3289,0,46,46
9983,9983,,3289,0,15,15
9984,9984,,3289,26,0,26
9985,9985,,3289,50,0,50
9986,9986,,3289,22,0,22
9987,9987,,3289,0,7,7
9988,9988,,3289,19,0,19
9989,9989,,3289,7,0,7
9990,9990,,3289,35,0,35
9991,9991,,3289,19,0,19
9992,9992,,3142,3,0,3
9993,9993,,3289,4,0,4
9994,9994,,3289,40,0,40
9995,9995,,3289,22,0,22
9996,9996,,3289,53,0,53
9997,9997,,3289,0,12,12
9998,9998,,3289,4,0,4
9999,9999,,3289,6,0,6
10000,10000,,3289,6,0,6
10001,10001,,2463,0,0,0
10002,10002,,2464,0,0,0
10003,10003,,3289,16,0,16
10004,10004,,2465,0,0,0
10005,10005,,3289,77,0,77
10006,10006,,2466,0,0,0
10007,10007,,2467,0,0,0
10008,10008,,3289,4,0,4
10009,10009,,2468,0,0,0
10010,10010,,3289,11,0,11
10011,10011,,2469,0,0,0
10012,10012,,2110,16,0,16
10013,10013,,2470,0,0,0
10014,10014,,2472,0,1,1
10015,10015,,2471,0,0,0
10016,10016,,2472,1,0,1
10017,10017,,2473,0,0,0
10018,10018,,3289,7,0,7
10019,10019,,2474,0,0,0
10020,10020,,2475,0,0,0
10021,10021,,3289,0,26,26
10022,10022,,3289,13,0,13
10023,10023,,2476,0,0,0
10024,10024,,3289,4,0,4
10025,10025,,3597,5,0,5
10026,10026,,2477,0,0,0
10027,10027,,3289,2,0,2
10028,10028,,2478,0,0,0
10029,10029,,3289,13,0,13
10030,10030,,3289,73,0,73
10031,10031,,2479,0,0,0
10032,10032,,3289,8,0,8
10033,10033,,3289,7,0,7
10034,10034,,2480,0,0,0
10035,10035,,3289,2,0,2
10036,10036,,2481,0,0,0
10037,10037,,3289,9,0,9
10038,10038,,2482,0,0,0
10039,10039,,2483,0,0,0
10040,10040,,3289,16,0,16
10041,10041,,3289,11,0,11
10042,10042,,3289,4,0,4
10043,10043,,3289,2,0,2
10044,10044,,3289,13,0,13
10045,10045,,3289,7,0,7
10046,10046,,2484,0,0,0
10047,10047,,3289,10,0,10
10048,10048,,2485,0,0,0
10049,10049,,2486,0,0,0
10050,10050,,2487,0,0,0
10051,10051,,3289,6,0,6
10052,10052,,3289,7,0,7
10053,10053,,2488,0,0,0
10054,10054,,2489,0,0,0
10055,10055,,2490,0,0,0
10056,10056,,3289,0,12,12
10057,10057,,3289,10,0,10
10058,10058,,3289,5,0,5
10059,10059,,2491,0,0,0
10060,10060,,2492,0,0,0
10061,10061,,3289,3,0,3
10062,10062,,3289,7,0,7
10063,10063,,3289,0,17,17
10064,10064,,3289,2,0,2
10065,10065,,3289,11,0,11
10066,10066,,3289,0,17,17
10067,10067,,3289,0,4,4
10068,10068,,2493,0,0,0
10069,10069,,3289,21,0,21
10070,10070,,2494,0,0,0
10071,10071,,2495,0,0,0
10072,10072,,2496,0,0,0
10073,10073,,3289,17,0,17
10074,10074,,2497,0,0,0
10075,10075,,2498,0,0,0
10076,10076,,2499,0,0,0
10077,10077,,3289,2,0,2
10078,10078,,2500,0,0,0
10079,10079,,3289,9,0,9
10080,10080,,2501,0,0,0
10081,10081,,3289,2,0,2
10082,10082,,3289,13,0,13
10083,10083,,3289,4,0,4
10084,10084,,2502,0,0,0
10085,10085,,2503,0,0,0
10086,10086,,2504,0,0,0
10087,10087,,2505,0,0,0
10088,10088,,3623,1,0,1
10089,10089,,2506,0,0,0
10090,10090,,2507,0,0,0
10091,10091,,3289,9,0,9
10092,10092,,3289,17,0,17
10093,10093,,2508,0,0,0
10094,10094,,3289,11,0,11
10095,10095,,2509,0,0,0
10096,10096,,2510,0,0,0
10097,10097,,2511,0,0,0
10098,10098,,2512,0,0,0
10099,10099,,2513,0,0,0
10100,10100,,2514,0,0,0
10101,10101,,3289,7,0,7
10102,10102,,2515,0,0,0
10103,10103,,2516,0,0,0
10104,10104,,3289,9,0,9
10105,10105,,3289,16,0,16
10106,10106,,3289,18,0,18
10107,10107,,3289,6,0,6
10108,10108,,3289,0,25,25
10109,10109,,3289,3,0,3
10110,10110,,3289,3,0,3
10111,10111,,3289,32,0,32
10112,10112,,3289,5,0,5
10113,10113,,3306,2,0,2
10114,10114,,3289,0,12,12
10115,10115,,3289,5,0,5
10116,10116,,3289,12,0,12
10117,10117,,3289,7,0,7
10118,10118,,3289,12,0,12
10119,10119,,3289,4,0,4
10120,10120,,2517,0,0,0
10121,10121,,3289,7,0,7
10122,10122,,3289,2,0,2
10123,10123,,3289,9,0,9
10124,10124,,3289,0,29,29
10125,10125,,3289,3,0,3
10126,10126,,2518,0,0,0
10127,10127,,3289,9,0,9
10128,10128,,2693,3,0,3
10129,10129,,3289,12,0,12
10130,10130,,2519,0,0,0
10131,10131,,2520,0,0,0
10132,10132,,2521,0,0,0
10133,10133,,3289,3,0,3
10134,10134,,2522,0,0,0
10135,10135,,3289,0,14,14
10136,10136,,3289,14,0,14
10137,10137,,2523,0,0,0
10138,10138,,3289,2,0,2
10139,10139,,3289,0,23,23
10140,10140,,3289,2,0,2
10141,10141,,3289,4,0,4
10142,10142,,3289,18,0,18
10143,10143,,3289,41,0,41
10144,10144,,2524,0,0,0
10145,10145,,3289,17,0,17
10146,10146,,3289,5,0,5
10147,10147,,2525,0,6,6
10148,10148,,2525,2,0,2
10149,10149,,2525,2,0,2
10150,10150,,2525,2,0,2
10151,10151,,2526,0,0,0
10152,10152,,2527,0,0,0
10153,10153,,2528,0,0,0
10154,10154,,2529,0,0,0
10155,10155,,2530,0,0,0
10156,10156,,3289,7,0,7
10157,10157,,3289,6,0,6
10158,10158,,3289,0,4,4
10159,10159,,3289,20,0,20
10160,10160,,2531,0,0,0
10161,10161,,3289,34,0,34
10162,10162,,2532,0,0,0
10163,10163,,2533,0,0,0
10164,10164,,2534,0,0,0
10165,10165,,2535,0,0,0
10166,10166,,2536,0,0,0
10167,10167,,2539,0,1,1
10168,10168,,2537,0,0,0
10169,10169,,2538,0,0,0
10170,10170,,2539,1,0,1
10171,10171,,2540,0,0,0
10172,10172,,2541,0,0,0
10173,10173,,3289,2,0,2
10174,10174,,3289,1,0,1
10175,10175,,2542,0,0,0
10176,10176,,3289,0,36,36
10177,10177,,3289,3,0,3
10178,10178,,3289,29,0,29
10179,10179,,3289,19,0,19
10180,10180,,3289,0,13,13
10181,10181,,2543,0,0,0
10182,10182,,2544,0,3,3
10183,10183,,3289,4,0,4
10184,10184,,3289,10,0,10
10185,10185,,3289,4,0,4
10186,10186,,2545,0,0,0
10187,10187,,3289,8,0,8
10188,10188,,2546,0,0,0
10189,10189,,2547,0,0,0
10190,10190,,2548,0,0,0
10191,10191,,3289,2,0,2
10192,10192,,2549,0,0,0
10193,10193,,3289,4,0,4
10194,10194,,2550,0,0,0
10195,10195,,3289,3,0,3
10196,10196,,3289,2,0,2
10197,10197,,2551,0,0,0
10198,10198,,3289,8,0,8
10199,10199,,2552,0,0,0
10200,10200,,2553,0,0,0
10201,10201,,3289,8,0,8
10202,10202,,3289,12,0,12
10203,10203,,2554,0,0,0
10204,10204,,3289,3,0,3
10205,10205,,2637,2,0,2
10206,10206,,2555,0,0,0
10207,10207,,3289,0,36,36
10208,10208,,3289,8,0,8
10209,10209,,3289,28,0,28
10210,10210,,3289,9,0,9
10211,10211,,3289,2,0,2
10212,10212,,2556,0,0,0
10213,10213,,2557,0,0,0
10214,10214,,2558,0,0,0
10215,10215,,2559,0,0,0
10216,10216,,3289,0,9,9
10217,10217,,2560,0,0,0
10218,10218,,3289,0,7,7
10219,10219,,3289,7,0,7
10220,10220,,3289,12,0,12
10221,10221,,2561,0,0,0
10222,10222,,3289,0,4,4
10223,10223,,3289,1,0,1
10224,10224,,3289,5,0,5
10225,10225,,3289,0,28,28
10226,10226,,3289,4,0,4
10227,10227,,3289,4,0,4
10228,10228,,3289,31,0,31
10229,10229,,3289,16,0,16
10230,10230,,3289,9,0,9
10231,10231,,3289,20,0,20
10232,10232,,2562,0,0,0
10233,10233,,3289,27,0,27
10234,10234,,2563,0,0,0
10235,10235,,2564,0,0,0
10236,10236,,2565,0,0,0
10237,10237,,3289,4,0,4
10238,10238,,2566,0,0,0
10239,10239,,3289,0,42,42
10240,10240,,3289,1,0,1
10241,10241,,3289,29,0,29
10242,10242,,2567,0,0,0
10243,10243,,3289,2,0,2
10244,10244,,2568,0,0,0
10245,10245,,2569,0,0,0
10246,10246,,2570,0,0,0
10247,10247,,3289,2,0,2
10248,10248,,3289,7,0,7
10249,10249,,2571,0,0,0
10250,10250,,3289,17,0,17
10251,10251,,3289,4,0,4
10252,10252,,3289,5,0,5
10253,10253,,3289,3,0,3
10254,10254,,3289,1,0,1
10255,10255,,3289,6,0,6
10256,10256,,3289,13,0,13
10257,10257,,3289,6,0,6
10258,10258,,3289,43,0,43
10259,10259,,2572,0,0,0
10260,10260,,2573,0,0,0
10261,10261,,2574,0,0,0
10262,10262,,2575,0,0,0
10263,10263,,3214,1,0,1
10264,10264,,2576,0,0,0
10265,10265,,2577,0,0,0
10266,10266,,2578,0,0,0
10267,10267,,2579,0,0,0
10268,10268,,3289,4,0,4
10269,10269,,2580,0,0,0
10270,10270,,2581,0,0,0
10271,10271,,2582,0,0,0
10272,10272,,2583,0,0,0
10273,10273,,2584,0,0,0
10274,10274,,2585,0,0,0
10275,10275,,2586,0,0,0
10276,10276,,2587,0,0,0
10277,10277,,3289,8,0,8
10278,10278,,3289,15,0,15
10279,10279,,3289,17,0,17
10280,10280,,2588,0,0,0
10281,10281,,3289,1,0,1
10282,10282,,2589,0,0,0
10283,10283,,2590,0,0,0
10284,10284,,3289,31,0,31
10285,10285,,3289,13,0,13
10286,10286,,3289,3,0,3
10287,10287,,2591,0,0,0
10288,10288,,3289,18,0,18
10289,10289,,3289,12,0,12
10290,10290,,2592,0,0,0
10291,10291,,3289,4,0,4
10292,10292,,3289,21,0,21
10293,10293,,2593,0,0,0
10294,10294,,3289,2,0,2
10295,10295,,3289,2,0,2
10296,10296,,2594,0,0,0
10297,10297,,3289,1,0,1
10298,10298,,2595,0,0,0
10299,10299,,3289,2,0,2
10300,10300,,2596,0,0,0
10301,10301,,2666,1,0,1
10302,10302,,2597,0,0,0
10303,10303,,3289,7,0,7
10304,10304,,3289,0,19,19
10305,10305,,3289,14,0,14
10306,10306,,3289,5,0,5
10307,10307,,3289,7,0,7
10308,10308,,3289,14,0,14
10309,10309,,2598,0,0,0
10310,10310,,3289,0,17,17
10311,10311,,3289,6,0,6
10312,10312,,2599,0,0,0
10313,10313,,2600,0,0,0
10314,10314,,3289,13,0,13
10315,10315,,3289,1,0,1
10316,10316,,3289,2,0,2
10317,10317,,2601,0,0,0
10318,10318,,2602,0,0,0
10319,10319,,2603,0,0,0
10320,10320,,2604,0,0,0
10321,10321,,2605,0,0,0
10322,10322,,2606,0,0,0
10323,10323,,3289,2,0,2
10324,10324,,3289,0,29,29
10325,10325,,3289,17,0,17
10326,10326,,3289,10,0,10
10327,10327,,3289,6,0,6
10328,10328,,3289,16,0,16
10329,10329,,2607,0,0,0
10330,10330,,2608,0,0,0
10331,10331,,2609,0,0,0
10332,10332,,2610,0,0,0
10333,10333,,3734,2,0,2
10334,10334,,3182,3,0,3
10335,10335,,3787,2,0,2
10336,10336,,3289,0,3,3
10337,10337,,2611,0,0,0
10338,10338,,3289,0,5,5
10339,10339,,3289,11,0,11
10340,10340,,3289,5,0,5
10341,10341,,3289,28,0,28
10342,10342,,3289,1,0,1
10343,10343,,3289,0,29,29
10344,10344,,3289,11,0,11
10345,10345,,3289,6,0,6
10346,10346,,3289,1,0,1
10347,10347,,2612,0,0,0
10348,10348,,3289,3,0,3
10349,10349,,3289,2,0,2
10350,10350,,3660,2,0,2
10351,10351,,3289,2,0,2
10352,10352,,2613,0,0,0
10353,10353,,2614,0,0,0
10354,10354,,2615,0,0,0
10355,10355,,3289,4,0,4
10356,10356,,3289,1,0,1
10357,10357,,2616,0,0,0
10358,10358,,3289,8,0,8
10359,10359,,3289,8,0,8
10360,10360,,3289,4,0,4
10361,10361,,2617,0,0,0
10362,10362,,3289,8,0,8
10363,10363,,2618,0,0,0
10364,10364,,2619,0,0,0
10365,10365,,2620,0,0,0
10366,10366,,2621,0,0,0
10367,10367,,2622,0,0,0
10368,10368,,3289,0,18,18
10369,10369,,3289,3,0,3
10370,10370,,3289,16,0,16
10371,10371,,3289,12,0,12
10372,10372,,3289,0,3,3
10373,10373,,2623,0,0,0
10374,10374,,2624,0,0,0
10375,10375,,2625,0,0,0
10376,10376,,3289,4,0,4
10377,10377,,3289,5,0,5
10378,10378,,2626,0,0,0
10379,10379,,2627,0,0,0
10380,10380,,3289,1,0,1
10381,10381,,3289,11,0,11
10382,10382,,2628,0,0,0
10383,10383,,3289,6,0,6
10384,10384,,2629,0,0,0
10385,10385,,3289,17,0,17
10386,10386,,2630,0,0,0
10387,10387,,3289,15,0,15
10388,10388,,3289,3,0,3
10389,10389,,2631,0,0,0
10390,10390,,2632,0,0,0
10391,10391,,2633,0,0,0
10392,10392,,3289,9,0,9
10393,10393,,2634,0,0,0
10394,10394,,3289,9,0,9
10395,10395,,2635,0,0,0
10396,10396,,2636,0,0,0
10397,10397,,2637,0,2,2
10398,10398,,3289,2,0,2
10399,10399,,2638,0,0,0
10400,10400,,2639,0,0,0
10401,10401,,2640,0,0,0
10402,10402,,2641,0,0,0
10403,10403,,3289,1,0,1
10404,10404,,2642,0,0,0
10405,10405,,2643,0,0,0
10406,10406,,3289,0,3,3
10407,10407,,2644,0,0,0
10408,10408,,3289,11,0,11
10409,10409,,2645,0,0,0
10410,10410,,2646,0,0,0
10411,10411,,2647,0,0,0
10412,10412,,3289,3,0,3
10413,10413,,2648,0,0,0
10414,10414,,3289,0,16,16
10415,10415,,2649,0,0,0
10416,10416,,3289,0,1,1
10417,10417,,3289,27,0,27
10418,10418,,2650,0,0,0
10419,10419,,3289,0,4,4
10420,10420,,3289,10,0,10
10421,10421,,3289,1,0,1
10422,10422,,2651,0,0,0
10423,10423,,3289,0,1,1
10424,10424,,2652,0,0,0
10425,10425,,3289,0,37,37
10426,10426,,3289,17,0,17
10427,10427,,3289,14,0,14
10428,10428,,2653,0,0,0
10429,10429,,2654,0,0,0
10430,10430,,2655,0,0,0
10431,10431,,3289,1,0,1
10432,10432,,2656,0,0,0
10433,10433,,2657,0,0,0
10434,10434,,2658,0,0,0
10435,10435,,2659,0,0,0
10436,10436,,2660,0,0,0
10437,10437,,2661,0,0,0
10438,10438,,3289,32,0,32
10439,10439,,2662,0,0,0
10440,10440,,3289,27,0,27
10441,10441,,2663,0,0,0
10442,10442,,2664,0,0,0
10443,10443,,3289,0,9,9
10444,10444,,2665,0,0,0
10445,10445,,3289,10,0,10
10446,10446,,2666,0,1,1
10447,10447,,3289,4,0,4
10448,10448,,3289,0,6,6
10449,10449,,3289,2,0,2
10450,10450,,3289,6,0,6
10451,10451,,2667,0,0,0
10452,10452,,2668,0,0,0
10453,10453,,2669,0,0,0
10454,10454,,3289,0,20,20
10455,10455,,2670,0,0,0
10456,10456,,3289,10,0,10
10457,10457,,3289,18,0,18
10458,10458,,3289,69,0,69
10459,10459,,3289,0,8,8
10460,10460,,3289,0,8,8
10461,10461,,3289,0,20,20
10462,10462,,3289,2,0,2
10463,10463,,3289,13,0,13
10464,10464,,3289,2,0,2
10465,10465,,2671,0,0,0
10466,10466,,3289,0,59,59
10467,10467,,3289,7,0,7
10468,10468,,3289,0,16,16
10469,10469,,2672,0,0,0
10470,10470,,2673,0,0,0
10471,10471,,2674,0,0,0
10472,10472,,2675,0,0,0
10473,10473,,2676,0,0,0
10474,10474,,2677,0,0,0
10475,10475,,3289,2,0,2
10476,10476,,2678,0,0,0
10477,10477,,2679,0,0,0
10478,10478,,2680,0,0,0
10479,10479,,3289,1,0,1
10480,10480,,3289,1,0,1
10481,10481,,2681,0,0,0
10482,10482,,2682,0,0,0
10483,10483,,3289,20,0,20
10484,10484,,3289,0,24,24
10485,10485,,2683,0,0,0
10486,10486,,2684,0,0,0
10487,10487,,3289,0,38,38
10488,10488,,3289,4,0,4
10489,10489,,2685,0,0,0
10490,10490,,2686,0,0,0
10491,10491,,2687,0,0,0
10492,10492,,2688,0,0,0
10493,10493,,2689,0,0,0
10494,10494,,3289,15,0,15
10495,10495,,2690,0,0,0
10496,10496,,3289,0,29,29
10497,10497,,3289,23,0,23
10498,10498,,2691,0,0,0
10499,10499,,3289,3,0,3
10500,10500,,3289,10,0,10
10501,10501,,2692,0,0,0
10502,10502,,3289,0,6,6
10503,10503,,2693,0,3,3
10504,10504,,2694,0,0,0
10505,10505,,2695,0,0,0
10506,10506,,2696,0,0,0
10507,10507,,2697,0,0,0
10508,10508,,3289,0,8,8
10509,10509,,3289,3,0,3
10510,10510,,3289,1,0,1
10511,10511,,3289,0,25,25
10512,10512,,3289,0,1,1
10513,10513,,2698,0,0,0
10514,10514,,3289,6,0,6
10515,10515,,2699,0,0,0
10516,10516,,2700,0,0,0
10517,10517,,3289,0,7,7
10518,10518,,3289,2,0,2
10519,10519,,3289,9,0,9
10520,10520,,2701,0,0,0
10521,10521,,3289,6,0,6
10522,10522,,3289,14,0,14
10523,10523,,3289,1,0,1
10524,10524,,3289,48,0,48
10525,10525,,2702,0,0,0
10526,10526,,2703,0,0,0
10527,10527,,3289,4,0,4
10528,10528,,3289,5,0,5
10529,10529,,3289,0,39,39
10530,10530,,3289,2,0,2
10531,10531,,3791,3,0,3
10532,10532,,3289,0,4,4
10533,10533,,2704,0,0,0
10534,10534,,3289,1,0,1
10535,10535,,2705,0,0,0
10536,10536,,2706,0,0,0
10537,10537,,3289,1,0,1
10538,10538,,3289,3,0,3
10539,10539,,3289,24,0,24
10540,10540,,2707,0,0,0
10541,10541,,3289,0,16,16
10542,10542,,2708,0,0,0
10543,10543,,2709,0,0,0
10544,10544,,2710,0,0,0
10545,10545,,3289,1,0,1
10546,10546,,2711,0,0,0
10547,10547,,2712,0,0,0
10548,10548,,3289,1,0,1
10549,10549,,3289,1,0,1
10550,10550,,2713,0,0,0
10551,10551,,3289,0,5,5
10552,10552,,2714,0,0,0
10553,10553,,3289,6,0,6
10554,10554,,3289,0,1,1
10555,10555,,2715,0,0,0
10556,10556,,3289,1,0,1
10557,10557,,2716,0,0,0
10558,10558,,2717,0,0,0
10559,10559,,2718,0,0,0
10560,10560,,3289,0,23,23
10561,10561,,3289,12,0,12
10562,10562,,3289,3,0,3
10563,10563,,3289,3,0,3
10564,10564,,3289,14,0,14
10565,10565,,3289,19,0,19
10566,10566,,2719,0,0,0
10567,10567,,3289,10,0,10
10568,10568,,2720,0,0,0
10569,10569,,2721,0,0,0
10570,10570,,3289,0,4,4
10571,10571,,2722,0,0,0
10572,10572,,3289,2,0,2
10573,10573,,2110,5,0,5
10574,10574,,2723,0,0,0
10575,10575,,2859,4,0,4
10576,10576,,3289,0,6,6
10577,10577,,2724,0,0,0
10578,10578,,2725,0,0,0
10579,10579,,2726,0,0,0
10580,10580,,2727,0,0,0
10581,10581,,3283,4,0,4
10582,10582,,3289,0,3,3
10583,10583,,3289,6,0,6
10584,10584,,3289,0,16,16
10585,10585,,3289,6,0,6
10586,10586,,2728,0,0,0
10587,10587,,2729,0,0,0
10588,10588,,2730,0,0,0
10589,10589,,3289,2,0,2
10590,10590,,3289,2,0,2
10591,10591,,3289,4,0,4
10592,10592,,2731,0,0,0
10593,10593,,3289,7,0,7
10594,10594,,2732,0,0,0
10595,10595,,3289,5,0,5
10596,10596,,2733,0,0,0
10597,10597,,2734,0,0,0
10598,10598,,2735,0,0,0
10599,10599,,3289,4,0,4
10600,10600,,3289,2,0,2
10601,10601,,3289,0,22,22
10602,10602,,3289,10,0,10
10603,10603,,3289,0,19,19
10604,10604,,3289,6,0,6
10605,10605,,3289,2,0,2
10606,10606,,3289,0,6,6
10607,10607,,2736,0,0,0
10608,10608,,2737,0,0,0
10609,10609,,2738,0,0,0
10610,10610,,2739,0,0,0
10611,10611,,2740,0,0,0
10612,10612,,2741,0,0,0
10613,10613,,2742,0,0,0
10614,10614,,3289,6,0,6
10615,10615,,3289,5,0,5
10616,10616,,2743,0,0,0
10617,10617,,2744,0,0,0
10618,10618,,2745,0,0,0
10619,10619,,2746,0,0,0
10620,10620,,2747,0,0,0
10621,10621,,2748,0,0,0
10622,10622,,2749,0,0,0
10623,10623,,3289,0,11,11
10624,10624,,3289,0,17,17
10625,10625,,3289,14,0,14
10626,10626,,3289,7,0,7
10627,10627,,3289,26,0,26
10628,10628,,3289,11,0,11
10629,10629,,2750,0,0,0
10630,10630,,3289,3,0,3
10631,10631,,3289,8,0,8
10632,10632,,3289,2,0,2
10633,10633,,2751,0,0,0
10634,10634,,2752,0,0,0
10635,10635,,3289,0,27,27
10636,10636,,261,0,37,37
10637,10637,,261,16,0,16
10638,10638,,2753,0,0,0
10639,10639,,3289,16,0,16
10640,10640,,2754,0,0,0
10641,10641,,2755,0,0,0
10642,10642,,3289,3,0,3
10643,10643,,3289,5,0,5
10644,10644,,3289,2,0,2
10645,10645,,3289,2,0,2
10646,10646,,3289,8,0,8
10647,10647,,2756,0,0,0
10648,10648,,3289,8,0,8
10649,10649,,3289,1,0,1
10650,10650,,3289,1,0,1
10651,10651,,2757,0,0,0
10652,10652,,2758,0,0,0
10653,10653,,2759,0,0,0
10654,10654,,2760,0,0,0
10655,10655,,2761,0,0,0
10656,10656,,3289,2,0,2
10657,10657,,3289,13,0,13
10658,10658,,2762,0,0,0
10659,10659,,3289,0,37,37
10660,10660,,3289,11,0,11
10661,10661,,3289,7,0,7
10662,10662,,3289,0,35,35
10663,10663,,2763,0,0,0
10664,10664,,3289,2,0,2
10665,10665,,2764,0,0,0
10666,10666,,3289,18,0,18
10667,10667,,3289,0,27,27
10668,10668,,3289,0,35,35
10669,10669,,3289,2,0,2
10670,10670,,2765,0,0,0
10671,10671,,3289,9,0,9
10672,10672,,2766,0,0,0
10673,10673,,3289,2,0,2
10674,10674,,2767,0,0,0
10675,10675,,2768,0,0,0
10676,10676,,3289,9,0,9
10677,10677,,2769,0,0,0
10678,10678,,3289,2,0,2
10679,10679,,3289,0,25,25
10680,10680,,2770,0,0,0
10681,10681,,2771,0,0,0
10682,10682,,2772,0,0,0
10683,10683,,3289,0,3,3
10684,10684,,2773,0,0,0
10685,10685,,2774,0,0,0
10686,10686,,2775,0,0,0
10687,10687,,2776,0,0,0
10688,10688,,2777,0,0,0
10689,10689,,2778,0,0,0
10690,10690,,2779,0,0,0
10691,10691,,3289,5,0,5
10692,10692,,3289,12,0,12
10693,10693,,2780,0,0,0
10694,10694,,3289,0,29,29
10695,10695,,3289,22,0,22
10696,10696,,2781,0,0,0
10697,10697,,3289,1,0,1
10698,10698,,2782,0,0,0
10699,10699,,2783,0,0,0
10700,10700,,2784,0,0,0
10701,10701,,3289,0,13,13
10702,10702,,3289,0,13,13
10703,10703,,3289,0,31,31
10704,10704,,2785,0,0,0
10705,10705,,2786,0,0,0
10706,10706,,3289,0,13,13
10707,10707,,2787,0,0,0
10708,10708,,3289,10,0,10
10709,10709,,3289,3,0,3
10710,10710,,3289,0,19,19
10711,10711,,3289,0,10,10
10712,10712,,3289,0,10,10
10713,10713,,3289,3,0,3
10714,10714,,3289,11,0,11
10715,10715,,3289,3,0,3
10716,10716,,2788,0,0,0
10717,10717,,3289,0,14,14
10718,10718,,3289,1,0,1
10719,10719,,3289,4,0,4
10720,10720,,3289,9,0,9
10721,10721,,3289,24,0,24
10722,10722,,2789,0,0,0
10723,10723,,3289,4,0,4
10724,10724,,3289,6,0,6
10725,10725,,2790,0,0,0
10726,10726,,3289,0,8,8
10727,10727,,3289,0,18,18
10728,10728,,2791,0,0,0
10729,10729,,2792,0,0,0
10730,10730,,3289,6,0,6
10731,10731,,3289,0,33,33
10732,10732,,2793,0,0,0
10733,10733,,2794,0,0,0
10734,10734,,2795,0,0,0
10735,10735,,3289,1,0,1
10736,10736,,2796,0,0,0
10737,10737,,2797,0,0,0
10738,10738,,3289,2,0,2
10739,10739,,2798,0,0,0
10740,10740,,2799,0,0,0
10741,10741,,3289,2,0,2
10742,10742,,3289,2,0,2
10743,10743,,3289,2,0,2
10744,10744,,2800,0,0,0
10745,10745,,3289,0,20,20
10746,10746,,3289,15,0,15
10747,10747,,3289,0,8,8
10748,10748,,3289,0,5,5
10749,10749,,3289,12,0,12
10750,10750,,2801,0,0,0
10751,10751,,3289,0,25,25
10752,10752,,2802,0,0,0
10753,10753,,2803,0,0,0
10754,10754,,3289,3,0,3
10755,10755,,2804,0,0,0
10756,10756,,2805,0,0,0
10757,10757,,2806,0,0,0
10758,10758,,2807,0,0,0
10759,10759,,2808,0,0,0
10760,10760,,2809,0,0,0
10761,10761,,2810,0,0,0
10762,10762,,2811,0,0,0
10763,10763,,2812,0,0,0
10764,10764,,2813,0,0,0
10765,10765,,3289,33,0,33
10766,10766,,3289,0,8,8
10767,10767,,3289,6,0,6
10768,10768,,2814,0,0,0
10769,10769,,3289,0,17,17
10770,10770,,2815,0,0,0
10771,10771,,3289,14,0,14
10772,10772,,2816,0,0,0
10773,10773,,2817,0,0,0
10774,10774,,2818,0,0,0
10775,10775,,2819,0,0,0
10776,10776,,2820,0,0,0
10777,10777,,2821,0,0,0
10778,10778,,3781,1,0,1
10779,10779,,3289,5,0,5
10780,10780,,2822,0,0,0
10781,10781,,3289,6,0,6
10782,10782,,3289,4,0,4
10783,10783,,2823,0,0,0
10784,10784,,2824,0,0,0
10785,10785,,3289,6,0,6
10786,10786,,3289,5,0,5
10787,10787,,3289,6,0,6
10788,10788,,2825,0,0,0
10789,10789,,3289,14,0,14
10790,10790,,3289,4,0,4
10791,10791,,2826,0,0,0
10792,10792,,2827,0,0,0
10793,10793,,3289,3,0,3
10794,10794,,3289,0,11,11
10795,10795,,2828,0,0,0
10796,10796,,3289,4,0,4
10797,10797,,2829,0,0,0
10798,10798,,3289,0,3,3
10799,10799,,2830,0,0,0
10800,10800,,2831,0,0,0
10801,10801,,3289,19,0,19
10802,10802,,2832,0,0,0
10803,10803,,3289,0,3,3
10804,10804,,3289,9,0,9
10805,10805,,2833,0,0,0
10806,10806,,3289,0,4,4
10807,10807,,3289,3,0,3
10808,10808,,2834,0,0,0
10809,10809,,3289,2,0,2
10810,10810,,3289,5,0,5
10811,10811,,3289,1,0,1
10812,10812,,3289,7,0,7
10813,10813,,3289,58,0,58
10814,10814,,2835,0,0,0
10815,10815,,3289,1,0,1
10816,10816,,3289,0,7,7
10817,10817,,2836,0,0,0
10818,10818,,2837,0,0,0
10819,10819,,3289,7,0,7
10820,10820,,2838,0,0,0
10821,10821,,2839,0,0,0
10822,10822,,2840,0,0,0
10823,10823,,3636,1,0,1
10824,10824,,2841,0,0,0
10825,10825,,2842,0,0,0
10826,10826,,3289,28,0,28
10827,10827,,3289,38,0,38
10828,10828,,3289,0,3,3
10829,10829,,3289,1,0,1
10830,10830,,3289,0,3,3
10831,10831,,3289,2,0,2
10832,10832,,2843,0,0,0
10833,10833,,3289,4,0,4
10834,10834,,3289,5,0,5
10835,10835,,2844,0,0,0
10836,10836,,3289,0,4,4
10837,10837,,3289,0,17,17
10838,10838,,2845,0,0,0
10839,10839,,3289,0,3,3
10840,10840,,2846,0,0,0
10841,10841,,2847,0,0,0
10842,10842,,2848,0,0,0
10843,10843,,3289,2,0,2
10844,10844,,2849,0,0,0
10845,10845,,3289,22,0,22
10846,10846,,2850,0,0,0
10847,10847,,2851,0,0,0
10848,10848,,3289,2,0,2
10849,10849,,2852,0,0,0
10850,10850,,2853,0,0,0
10851,10851,,2854,0,0,0
10852,10852,,2855,0,0,0
10853,10853,,3289,1,0,1
10854,10854,,2856,0,0,0
10855,10855,,3289,2,0,2
10856,10856,,2857,0,0,0
10857,10857,,3289,8,0,8
10858,10858,,2858,0,0,0
10859,10859,,2859,0,4,4
10860,10860,,3289,0,3,3
10861,10861,,3289,0,1,1
10862,10862,,3289,4,0,4
10863,10863,,2860,0,0,0
10864,10864,,3289,0,18,18
10865,10865,,2861,0,0,0
10866,10866,,2862,0,0,0
10867,10867,,3289,0,3,3
10868,10868,,2863,0,0,0
10869,10869,,3289,0,1,1
10870,10870,,2864,0,0,0
10871,10871,,2865,0,0,0
10872,10872,,3289,0,19,19
10873,10873,,2866,0,0,0
10874,10874,,2867,0,0,0
10875,10875,,3289,0,1,1
10876,10876,,3289,10,0,10
10877,10877,,3289,0,1,1
10878,10878,,2868,0,0,0
10879,10879,,2869,0,0,0
10880,10880,,3289,0,25,25
10881,10881,,3289,15,0,15
10882,10882,,3289,6,0,6
10883,10883,,3289,13,0,13
10884,10884,,2870,0,0,0
10885,10885,,2871,0,0,0
10886,10886,,3289,0,7,7
10887,10887,,3289,3,0,3
10888,10888,,2872,0,0,0
10889,10889,,3289,0,14,14
10890,10890,,3289,4,0,4
10891,10891,,3289,0,26,26
10892,10892,,3289,8,0,8
10893,10893,,3289,6,0,6
10894,10894,,2873,0,0,0
10895,10895,,2874,0,0,0
10896,10896,,3797,1,0,1
10897,10897,,2875,0,0,0
10898,10898,,3289,0,13,13
10899,10899,,3289,0,3,3
10900,10900,,3289,0,4,4
10901,10901,,3289,0,9,9
10902,10902,,2876,0,0,0
10903,10903,,2877,0,0,0
10904,10904,,2878,0,0,0
10905,10905,,3289,0,9,9
10906,10906,,2879,0,0,0
10907,10907,,3289,0,3,3
10908,10908,,2880,0,0,0
10909,10909,,3289,0,8,8
10910,10910,,3289,3,0,3
10911,10911,,3289,4,0,4
10912,10912,,2881,0,0,0
10913,10913,,2882,0,0,0
10914,10914,,3289,2,0,2
10915,10915,,3289,5,0,5
10916,10916,,3289,0,23,23
10917,10917,,3289,7,0,7
10918,10918,,2883,0,0,0
10919,10919,,2884,0,0,0
10920,10920,,3306,3,0,3
10921,10921,,2885,0,0,0
10922,10922,,2886,0,0,0
10923,10923,,3289,0,31,31
10924,10924,,2887,0,0,0
10925,10925,,2888,0,0,0
10926,10926,,3289,8,0,8
10927,10927,,2889,0,0,0
10928,10928,,2890,0,0,0
10929,10929,,2891,0,0,0
10930,10930,,3287,1,0,1
10931,10931,,3289,0,4,4
10932,10932,,2892,0,0,0
10933,10933,,2893,0,0,0
10934,10934,,2894,0,0,0
10935,10935,,2895,0,0,0
10936,10936,,2896,0,0,0
10937,10937,,2897,0,0,0
10938,10938,,2898,0,0,0
10939,10939,,2899,0,0,0
10940,10940,,2900,0,0,0
10941,10941,,2901,0,0,0
10942,10942,,2902,0,0,0
10943,10943,,2903,0,0,0
10944,10944,,2904,0,0,0
10945,10945,,2905,0,0,0
10946,10946,,2906,0,0,0
10947,10947,,2907,0,0,0
10948,10948,,2908,0,0,0
10949,10949,,3289,6,0,6
10950,10950,,3289,8,0,8
10951,10951,,2909,0,0,0
10952,10952,,3289,31,0,31
10953,10953,,3289,0,13,13
10954,10954,,2910,0,0,0
10955,10955,,3289,0,11,11
10956,10956,,3289,13,0,13
10957,10957,,3289,7,0,7
10958,10958,,2911,0,0,0
10959,10959,,2912,0,0,0
10960,10960,,2913,0,0,0
10961,10961,,3289,0,1,1
10962,10962,,2914,0,0,0
10963,10963,,2915,0,0,0
10964,10964,,2916,0,0,0
10965,10965,,3289,0,6,6
10966,10966,,2917,0,0,0
10967,10967,,2918,0,0,0
10968,10968,,2919,0,0,0
10969,10969,,3289,0,5,5
10970,10970,,2920,0,0,0
10971,10971,,2921,0,0,0
10972,10972,,3289,3,0,3
10973,10973,,3289,0,17,17
10974,10974,,3289,15,0,15
10975,10975,,2922,0,0,0
10976,10976,,3289,18,0,18
10977,10977,,2923,0,0,0
10978,10978,,2924,0,0,0
10979,10979,,3289,2,0,2
10980,10980,,2925,0,0,0
10981,10981,,2926,0,0,0
10982,10982,,2927,0,0,0
10983,10983,,3289,0,32,32
10984,10984,,2928,0,0,0
10985,10985,,2929,0,0,0
10986,10986,,2930,0,0,0
10987,10987,,3289,0,20,20
10988,10988,,2931,0,0,0
10989,10989,,3289,2,0,2
10990,10990,,3289,6,0,6
10991,10991,,2932,0,0,0
10992,10992,,2933,0,0,0
10993,10993,,3289,0,35,35
10994,10994,,3289,0,4,4
10995,10995,,3289,16,0,16
10996,10996,,3289,8,0,8
10997,10997,,2934,0,0,0
10998,10998,,2935,0,0,0
10999,10999,,2936,0,0,0
11000,11000,,2937,0,0,0
11001,11001,,2938,0,0,0
11002,11002,,2939,0,0,0
11003,11003,,3289,1,0,1
11004,11004,,3289,27,0,27
11005,11005,,3289,0,8,8
11006,11006,,3289,16,0,16
11007,11007,,2940,0,0,0
11008,11008,,2941,0,0,0
11009,11009,,2942,0,0,0
11010,11010,,3289,0,21,21
11011,11011,,2943,0,0,0
11012,11012,,2944,0,0,0
11013,11013,,2945,0,0,0
11014,11014,,2946,0,0,0
11015,11015,,2947,0,0,0
11016,11016,,3289,0,25,25
11017,11017,,2948,0,0,0
11018,11018,,3289,2,0,2
11019,11019,,3289,0,8,8
11020,11020,,3289,0,26,26
11021,11021,,3289,8,0,8
11022,11022,,3289,0,42,42
11023,11023,,3289,0,11,11
11024,11024,,3289,0,4,4
11025,11025,,2949,0,0,0
11026,11026,,2950,0,0,0
11027,11027,,3289,5,0,5
11028,11028,,3289,0,6,6
11029,11029,,3289,2,0,2
11030,11030,,3289,0,12,12
11031,11031,,2951,0,0,0
11032,11032,,2952,0,0,0
11033,11033,,2953,0,0,0
11034,11034,,2954,0,0,0
11035,11035,,3289,17,0,17
11036,11036,,2955,0,0,0
11037,11037,,2956,0,0,0
11038,11038,,2957,0,0,0
11039,11039,,3289,1,0,1
11040,11040,,3289,0,5,5
11041,11041,,2958,0,0,0
11042,11042,,3289,9,0,9
11043,11043,,3289,0,3,3
11044,11044,,2959,0,0,0
11045,11045,,3289,4,0,4
11046,11046,,2960,0,0,0
11047,11047,,2961,0,0,0
11048,11048,,2962,0,0,0
11049,11049,,2963,0,0,0
11050,11050,,2964,0,0,0
11051,11051,,3289,0,23,23
11052,11052,,2965,0,0,0
11053,11053,,2966,0,0,0
11054,11054,,2967,0,0,0
11055,11055,,3289,1,0,1
11056,11056,,2968,0,0,0
11057,11057,,2969,0,0,0
11058,11058,,3226,1,0,1
11059,11059,,3289,2,0,2
11060,11060,,2970,0,0,0
11061,11061,,2971,0,1,1
11062,11062,,2971,1,0,1
11063,11063,,3289,0,3,3
11064,11064,,3289,13,0,13
11065,11065,,3289,0,40,40
11066,11066,,3289,3,0,3
11067,11067,,2972,0,0,0
11068,11068,,3289,0,2,2
11069,11069,,2973,0,0,0
11070,11070,,3289,4,0,4
11071,11071,,3289,0,7,7
11072,11072,,2974,0,0,0
11073,11073,,3289,1,0,1
11074,11074,,3289,0,4,4
11075,11075,,2975,0,0,0
11076,11076,,2976,0,0,0
11077,11077,,2977,0,0,0
11078,11078,,2978,0,0,0
11079,11079,,2979,0,0,0
11080,11080,,3289,0,23,23
11081,11081,,3289,7,0,7
11082,11082,,3289,6,0,6
11083,11083,,2980,0,0,0
11084,11084,,3289,0,33,33
11085,11085,,2981,0,0,0
11086,11086,,2982,0,0,0
11087,11087,,3289,0,20,20
11088,11088,,3289,0,14,14
11089,11089,,3289,0,17,17
11090,11090,,2983,0,0,0
11091,11091,,2984,0,0,0
11092,11092,,3289,2,0,2
11093,11093,,3289,0,8,8
11094,11094,,2985,0,0,0
11095,11095,,2986,0,0,0
11096,11096,,3289,9,0,9
11097,11097,,2987,0,0,0
11098,11098,,1974,47,0,47
11099,11099,,2988,0,0,0
11100,11100,,2989,0,0,0
11101,11101,,2990,0,0,0
11102,11102,,2991,0,0,0
11103,11103,,2992,0,0,0
11104,11104,,3289,0,16,16
11105,11105,,3289,0,1,1
11106,11106,,3289,8,0,8
11107,11107,,2993,0,0,0
11108,11108,,2994,0,0,0
11109,11109,,2995,0,0,0
11110,11110,,2996,0,0,0
11111,11111,,2997,0,0,0
11112,11112,,3289,13,0,13
11113,11113,,2998,0,0,0
11114,11114,,3289,0,35,35
11115,11115,,2999,0,0,0
11116,11116,,3289,2,0,2
11117,11117,,3289,0,3,3
11118,11118,,3289,0,31,31
11119,11119,,3000,0,0,0
11120,11120,,3289,0,3,3
11121,11121,,3001,0,0,0
11122,11122,,3002,0,0,0
11123,11123,,3003,0,0,0
11124,11124,,3004,0,0,0
11125,11125,,3005,0,0,0
11126,11126,,3006,0,0,0
11127,11127,,3007,0,0,0
11128,11128,,3008,0,0,0
11129,11129,,3009,0,0,0
11130,11130,,3010,0,0,0
11131,11131,,3011,0,0,0
11132,11132,,3012,0,0,0
11133,11133,,3013,0,0,0
11134,11134,,3289,0,3,3
11135,11135,,3289,2,0,2
11136,11136,,3289,8,0,8
11137,11137,,3014,0,0,0
11138,11138,,3015,0,0,0
11139,11139,,3289,0,14,14
11140,11140,,3016,0,0,0
11141,11141,,3017,0,0,0
11142,11142,,3696,10,0,10
11143,11143,,3696,10,0,10
11144,11144,,3018,0,0,0
11145,11145,,3289,7,0,7
11146,11146,,3019,0,0,0
11147,11147,,3020,0,0,0
11148,11148,,3021,0,0,0
11149,11149,,3289,0,2,2
11150,11150,,3289,0,21,21
11151,11151,,3289,0,1,1
11152,11152,,3022,0,0,0
11153,11153,,3023,0,0,0
11154,11154,,3024,0,0,0
11155,11155,,3025,0,0,0
11156,11156,,3026,0,0,0
11157,11157,,3027,0,0,0
11158,11158,,3028,0,0,0
11159,11159,,3029,0,0,0
11160,11160,,3030,0,0,0
11161,11161,,3289,2,0,2
11162,11162,,3031,0,0,0
11163,11163,,3032,0,0,0
11164,11164,,3033,0,0,0
11165,11165,,3034,0,0,0
11166,11166,,3035,0,0,0
11167,11167,,3289,0,14,14
11168,11168,,3036,0,0,0
11169,11169,,3037,0,0,0
11170,11170,,3038,0,0,0
11171,11171,,3039,0,0,0
11172,11172,,3289,0,34,34
11173,11173,,3289,0,6,6
11174,11174,,3289,0,18,18
11175,11175,,3040,0,0,0
11176,11176,,3041,0,0,0
11177,11177,,3042,0,0,0
11178,11178,,3289,0,15,15
11179,11179,,3043,0,0,0
11180,11180,,3289,15,0,15
11181,11181,,3044,0,0,0
11182,11182,,3045,0,0,0
11183,11183,,3046,3,0,3
11184,11184,,3289,0,15,15
11185,11185,,3047,0,0,0
11186,11186,,3048,0,0,0
11187,11187,,3049,0,0,0
11188,11188,,3050,0,0,0
11189,11189,,3289,7,0,7
11190,11190,,3289,0,2,2
11191,11191,,3051,0,0,0
11192,11192,,3052,0,0,0
11193,11193,,3053,0,0,0
11194,11194,,3289,0,8,8
11195,11195,,3054,0,0,0
11196,11196,,3289,1,0,1
11197,11197,,3289,11,0,11
11198,11198,,3289,0,4,4
11199,11199,,3289,0,1,1
11200,11200,,3055,0,0,0
11201,11201,,3289,0,35,35
11202,11202,,3289,21,0,21
11203,11203,,3056,0,0,0
11204,11204,,3289,0,12,12
11205,11205,,3057,0,0,0
11206,11206,,3058,0,0,0
11207,11207,,3059,0,0,0
11208,11208,,3289,0,15,15
11209,11209,,3289,7,0,7
11210,11210,,3060,0,0,0
11211,11211,,3061,0,0,0
11212,11212,,3289,0,6,6
11213,11213,,3062,0,0,0
11214,11214,,3063,0,0,0
11215,11215,,3289,0,39,39
11216,11216,,3289,0,10,10
11217,11217,,3064,0,0,0
11218,11218,,3065,0,0,0
11219,11219,,3066,0,0,0
11220,11220,,3067,0,0,0
11221,11221,,3068,0,0,0
11222,11222,,3069,0,0,0
11223,11223,,3070,0,0,0
11224,11224,,3071,0,0,0
11225,11225,,3072,0,0,0
11226,11226,,3289,2,0,2
11227,11227,,3073,0,0,0
11228,11228,,3074,0,0,0
11229,11229,,3075,0,0,0
11230,11230,,3289,0,7,7
11231,11231,,3076,0,0,0
11232,11232,,3289,0,26,26
11233,11233,,3289,0,26,26
11234,11234,,3077,0,0,0
11235,11235,,3289,0,1,1
11236,11236,,3078,0,0,0
11237,11237,,3079,0,0,0
11238,11238,,3289,0,33,33
11239,11239,,3080,0,0,0
11240,11240,,3081,0,0,0
11241,11241,,3082,0,0,0
11242,11242,,3083,0,0,0
11243,11243,,3084,0,0,0
11244,11244,,3085,0,0,0
11245,11245,,3086,0,0,0
11246,11246,,3087,0,0,0
11247,11247,,3088,0,0,0
11248,11248,,3089,0,0,0
11249,11249,,3289,0,26,26
11250,11250,,3289,2,0,2
11251,11251,,3289,22,0,22
11252,11252,,3289,0,39,39
11253,11253,,3289,0,30,30
11254,11254,,3289,0,9,9
11255,11255,,3090,0,0,0
11256,11256,,3091,0,0,0
11257,11257,,3092,0,0,0
11258,11258,,3093,0,0,0
11259,11259,,3094,0,0,0
11260,11260,,3095,0,0,0
11261,11261,,3096,0,0,0
11262,11262,,3097,0,0,0
11263,11263,,3098,0,0,0
11264,11264,,3099,0,0,0
11265,11265,,3100,0,0,0
11266,11266,,3101,0,0,0
11267,11267,,3102,0,0,0
11268,11268,,3103,0,0,0
11269,11269,,3104,0,0,0
11270,11270,,3105,0,0,0
11271,11271,,3106,0,0,0
11272,11272,,3107,0,0,0
11273,11273,,3108,0,0,0
11274,11274,,3109,0,0,0
11275,11275,,3110,0,0,0
11276,11276,,3111,0,0,0
11277,11277,,3112,0,0,0
11278,11278,,3113,0,0,0
11279,11279,,3114,0,0,0
11280,11280,,3289,0,20,20
11281,11281,,3289,0,4,4
11282,11282,,3289,6,0,6
11283,11283,,3115,0,0,0
11284,11284,,3289,0,1,1
11285,11285,,3289,0,4,4
11286,11286,,3116,0,0,0
11287,11287,,3117,0,0,0
11288,11288,,3289,0,35,35
11289,11289,,3118,0,0,0
11290,11290,,3119,0,0,0
11291,11291,,3120,0,0,0
11292,11292,,3121,0,0,0
11293,11293,,3289,3,0,3
11294,11294,,3289,0,5,5
11295,11295,,3289,10,0,10
11296,11296,,3122,0,0,0
11297,11297,,3123,0,0,0
11298,11298,,3124,0,0,0
11299,11299,,3125,0,0,0
11300,11300,,3126,0,0,0
11301,11301,,3127,0,0,0
11302,11302,,3289,6,0,6
11303,11303,,3128,0,0,0
11304,11304,,3289,13,0,13
11305,11305,,3289,0,1,1
11306,11306,,3129,0,0,0
11307,11307,,3289,0,15,15
11308,11308,,3130,0,0,0
11309,11309,,3289,0,1,1
11310,11310,,3289,0,1,1
11311,11311,,3131,0,0,0
11312,11312,,3132,0,0,0
11313,11313,,3133,0,0,0
11314,11314,,3134,0,0,0
11315,11315,,3289,14,0,14
11316,11316,,3289,0,211,211
11317,11317,,3289,5,0,5
11318,11318,,3289,0,14,14
11319,11319,,3135,0,0,0
11320,11320,,3136,0,0,0
11321,11321,,3137,0,0,0
11322,11322,,3138,0,0,0
11323,11323,,3139,0,0,0
11324,11324,,3140,0,0,0
11325,11325,,3289,0,13,13
11326,11326,,3141,0,0,0
11327,11327,,3142,0,3,3
11328,11328,,3143,0,0,0
11329,11329,,3144,0,0,0
11330,11330,,3145,0,0,0
11331,11331,,3146,0,0,0
11332,11332,,3147,0,0,0
11333,11333,,3289,0,1,1
11334,11334,,3289,6,0,6
11335,11335,,3148,0,0,0
11336,11336,,3149,0,0,0
11337,11337,,3150,0,0,0
11338,11338,,3151,0,0,0
11339,11339,,3289,0,3,3
11340,11340,,3152,0,0,0
11341,11341,,3153,0,0,0
11342,11342,,3154,0,0,0
11343,11343,,3155,0,0,0
11344,11344,,3156,0,0,0
11345,11345,,3157,0,0,0
11346,11346,,3289,0,29,29
11347,11347,,3289,0,29,29
11348,11348,,3158,0,0,0
11349,11349,,3289,0,5,5
11350,11350,,3159,0,0,0
11351,11351,,3160,0,0,0
11352,11352,,3161,0,0,0
11353,11353,,3162,0,0,0
11354,11354,,3289,0,8,8
11355,11355,,3163,0,0,0
11356,11356,,3164,0,0,0
11357,11357,,3165,0,0,0
11358,11358,,3289,0,13,13
11359,11359,,3166,0,0,0
11360,11360,,3289,0,19,19
11361,11361,,3167,0,0,0
11362,11362,,3289,0,8,8
11363,11363,,3168,0,0,0
11364,11364,,3169,0,0,0
11365,11365,,3289,0,38,38
11366,11366,,3289,15,0,15
11367,11367,,3289,14,0,14
11368,11368,,3289,0,4,4
11369,11369,,3170,0,0,0
11370,11370,,3289,0,4,4
11371,11371,,3289,0,26,26
11372,11372,,3289,0,211,211
11373,11373,,3289,0,40,40
11374,11374,,3289,0,1,1
11375,11375,,3171,0,0,0
11376,11376,,3172,0,0,0
11377,11377,,3289,0,34,34
11378,11378,,3289,5,0,5
11379,11379,,3173,0,0,0
11380,11380,,3289,6,0,6
11381,11381,,3174,0,0,0
11382,11382,,3175,0,0,0
11383,11383,,3176,0,0,0
11384,11384,,3177,0,0,0
11385,11385,,3178,0,0,0
11386,11386,,3179,0,0,0
11387,11387,,3180,0,0,0
11388,11388,,3289,0,25,25
11389,11389,,3181,0,0,0
11390,11390,,3182,0,3,3
11391,11391,,3183,0,0,0
11392,11392,,3184,0,0,0
11393,11393,,3185,0,0,0
11394,11394,,3186,0,0,0
11395,11395,,3187,0,0,0
11396,11396,,3188,0,0,0
11397,11397,,3289,0,11,11
11398,11398,,3189,0,0,0
11399,11399,,3289,0,13,13
11400,11400,,3190,0,0,0
11401,11401,,3191,0,0,0
11402,11402,,3192,0,0,0
11403,11403,,3289,0,3,3
11404,11404,,3193,0,0,0
11405,11405,,3194,0,0,0
11406,11406,,3195,0,0,0
11407,11407,,3196,0,0,0
11408,11408,,3197,0,0,0
11409,11409,,3198,0,0,0
11410,11410,,3199,0,0,0
11411,11411,,3289,0,1,1
11412,11412,,3200,0,0,0
11413,11413,,3289,0,4,4
11414,11414,,3201,0,0,0
11415,11415,,3202,0,0,0
11416,11416,,3203,0,0,0
11417,11417,,3204,0,0,0
11418,11418,,261,0,3,3
11419,11419,,3289,0,21,21
11420,11420,,3205,0,0,0
11421,11421,,3696,2,0,2
11422,11422,,3289,0,19,19
11423,11423,,3206,0,0,0
11424,11424,,3207,0,0,0
11425,11425,,3289,0,2,2
11426,11426,,3208,0,0,0
11427,11427,,3209,0,0,0
11428,11428,,3210,0,0,0
11429,11429,,3211,0,0,0
11430,11430,,3212,0,0,0
11431,11431,,3213,0,0,0
11432,11432,,3214,0,1,1
11433,11433,,3215,0,0,0
11434,11434,,3216,0,0,0
11435,11435,,3217,0,0,0
11436,11436,,3289,3,0,3
11437,11437,,3218,0,0,0
11438,11438,,3219,0,0,0
11439,11439,,3289,0,7,7
11440,11440,,3220,0,0,0
11441,11441,,3221,0,0,0
11442,11442,,3222,0,0,0
11443,11443,,3289,0,33,33
11444,11444,,3223,0,0,0
11445,11445,,3224,0,0,0
11446,11446,,3225,0,0,0
11447,11447,,3226,0,1,1
11448,11448,,3227,0,0,0
11449,11449,,3228,0,0,0
11450,11450,,3289,6,0,6
11451,11451,,3229,0,0,0
11452,11452,,3289,0,20,20
11453,11453,,3230,0,0,0
11454,11454,,3231,0,0,0
11455,11455,,3232,0,0,0
11456,11456,,3233,0,0,0
11457,11457,,3234,0,0,0
11458,11458,,3289,0,11,11
11459,11459,,3235,0,0,0
11460,11460,,3236,0,0,0
11461,11461,,3289,0,19,19
11462,11462,,3237,0,0,0
11463,11463,,3289,0,1,1
11464,11464,,3238,0,0,0
11465,11465,,3239,0,0,0
11466,11466,,3289,4,0,4
11467,11467,,3240,0,0,0
11468,11468,,3241,0,0,0
11469,11469,,3289,0,11,11
11470,11470,,3242,0,0,0
11471,11471,,3243,0,0,0
11472,11472,,3244,0,0,0
11473,11473,,3245,0,0,0
11474,11474,,3289,0,31,31
11475,11475,,3246,0,0,0
11476,11476,,3247,0,0,0
11477,11477,,3289,0,31,31
11478,11478,,3289,7,0,7
11479,11479,,3289,0,26,26
11480,11480,,3289,0,16,16
11481,11481,,3248,0,0,0
11482,11482,,3249,0,0,0
11483,11483,,3250,0,0,0
11484,11484,,3289,0,2,2
11485,11485,,3251,0,0,0
11486,11486,,3252,0,0,0
11487,11487,,3253,0,0,0
11488,11488,,3289,0,17,17
11489,11489,,3289,3,0,3
11490,11490,,3289,0,4,4
11491,11491,,3254,0,0,0
11492,11492,,3255,0,0,0
11493,11493,,3289,0,13,13
11494,11494,,3256,0,0,0
11495,11495,,3257,0,0,0
11496,11496,,3289,13,0,13
11497,11497,,3289,0,18,18
11498,11498,,3289,0,4,4
11499,11499,,3289,0,18,18
11500,11500,,3289,0,18,18
11501,11501,,3258,0,0,0
11502,11502,,3259,0,0,0
11503,11503,,3260,0,0,0
11504,11504,,3289,0,1,1
11505,11505,,3289,0,20,20
11506,11506,,3289,0,6,6
11507,11507,,3261,0,0,0
11508,11508,,3289,0,4,4
11509,11509,,3289,0,5,5
11510,11510,,3262,0,0,0
11511,11511,,3289,1,0,1
11512,11512,,3263,0,0,0
11513,11513,,3289,0,18,18
11514,11514,,3289,0,7,7
11515,11515,,3264,0,0,0
11516,11516,,3265,0,0,0
11517,11517,,3289,0,14,14
11518,11518,,3289,0,3,3
11519,11519,,3289,0,21,21
11520,11520,,3266,0,0,0
11521,11521,,3267,0,0,0
11522,11522,,3289,0,23,23
11523,11523,,3289,0,22,22
11524,11524,,3289,0,16,16
11525,11525,,3289,3,0,3
11526,11526,,3268,0,0,0
11527,11527,,3289,0,29,29
11528,11528,,3269,0,0,0
11529,11529,,3289,0,26,26
11530,11530,,3270,0,0,0
11531,11531,,3271,0,0,0
11532,11532,,3272,0,0,0
11533,11533,,3273,0,0,0
11534,11534,,3274,0,0,0
11535,11535,,3289,0,35,35
11536,11536,,3289,5,0,5
11537,11537,,3275,0,0,0
11538,11538,,3276,0,0,0
11539,11539,,3277,0,0,0
11540,11540,,3278,0,0,0
11541,11541,,3289,0,33,33
11542,11542,,3279,0,5,5
11543,11543,,3279,5,0,5
11544,11544,,3280,0,0,0
11545,11545,,3281,0,0,0
11546,11546,,3282,0,0,0
11547,11547,,3289,0,9,9
11548,11548,,3289,0,5,5
11549,11549,,3283,0,2,2
11550,11550,,3284,0,0,0
11551,11551,,2110,6,0,6
11552,11552,,3285,0,0,0
11553,11553,,3286,0,0,0
11554,11554,,3287,0,1,1
11555,11555,,3288,0,0,0
11556,11556,,3644,1,0,1
11557,11557,,3289,0,52,52
11558,11558,,3290,0,0,0
11559,11559,,3291,0,0,0
11560,11560,,3289,0,28,28
11561,11561,,3289,0,1,1
11562,11562,,3289,0,21,21
11563,11563,,3289,0,34,34
11564,11564,,3289,4,0,4
11565,11565,,3292,0,0,0
11566,11566,,3293,0,0,0
11567,11567,,3294,0,0,0
11568,11568,,3289,0,22,22
11569,11569,,3289,5,0,5
11570,11570,,3289,0,7,7
11571,11571,,3289,0,37,37
11572,11572,,3295,0,0,0
11573,11573,,3296,0,0,0
11574,11574,,3297,0,0,0
11575,11575,,3298,0,0,0
11576,11576,,3299,0,0,0
11577,11577,,3300,0,0,0
11578,11578,,3301,0,0,0
11579,11579,,3289,0,11,11
11580,11580,,3289,0,36,36
11581,11581,,3289,0,14,14
11582,11582,,3302,0,0,0
11583,11583,,3289,0,13,13
11584,11584,,3303,0,0,0
11585,11585,,3304,0,0,0
11586,11586,,3289,19,0,19
11587,11587,,3289,0,30,30
11588,11588,,3305,0,0,0
11589,11589,,3306,0,5,5
11590,11590,,3307,0,0,0
11591,11591,,3308,0,0,0
11592,11592,,3309,0,0,0
11593,11593,,3310,0,0,0
11594,11594,,3311,0,0,0
11595,11595,,3289,0,42,42
11596,11596,,3289,32,0,32
11597,11597,,3289,0,26,26
11598,11598,,3312,0,0,0
11599,11599,,3313,0,0,0
11600,11600,,3314,0,0,0
11601,11601,,3315,0,0,0
11602,11602,,3316,0,0,0
11603,11603,,3289,0,24,24
11604,11604,,3317,0,0,0
11605,11605,,3318,0,0,0
11606,11606,,3319,0,0,0
11607,11607,,3289,0,9,9
11608,11608,,3320,0,0,0
11609,11609,,3289,0,23,23
11610,11610,,3321,0,0,0
11611,11611,,3322,0,0,0
11612,11612,,3289,1,0,1
11613,11613,,3323,0,0,0
11614,11614,,3324,0,0,0
11615,11615,,3325,0,0,0
11616,11616,,3289,0,10,10
11617,11617,,3289,0,31,31
11618,11618,,3289,0,8,8
11619,11619,,3326,0,0,0
11620,11620,,3327,0,0,0
11621,11621,,3289,0,20,20
11622,11622,,3328,0,0,0
11623,11623,,3329,0,0,0
11624,11624,,3330,0,0,0
11625,11625,,2110,0,30,30
11626,11626,,3289,0,18,18
11627,11627,,3289,2,0,2
11628,11628,,3331,0,0,0
11629,11629,,3289,0,8,8
11630,11630,,3332,0,0,0
11631,11631,,3333,0,0,0
11632,11632,,3334,0,0,0
11633,11633,,3335,0,0,0
11634,11634,,3289,0,16,16
11635,11635,,3336,0,0,0
11636,11636,,3337,0,0,0
11637,11637,,3338,0,0,0
11638,11638,,3339,0,0,0
11639,11639,,3289,0,19,19
11640,11640,,3340,0,0,0
11641,11641,,3341,0,4,4
11642,11642,,3342,0,0,0
11643,11643,,3289,5,0,5
11644,11644,,3343,0,0,0
11645,11645,,3344,0,0,0
11646,11646,,3345,0,0,0
11647,11647,,3289,0,3,3
11648,11648,,3346,0,0,0
11649,11649,,3347,0,0,0
11650,11650,,3348,0,0,0
11651,11651,,3289,0,2,2
11652,11652,,3349,0,0,0
11653,11653,,3350,0,0,0
11654,11654,,3351,0,0,0
11655,11655,,3352,0,0,0
11656,11656,,3289,0,34,34
11657,11657,,3353,0,0,0
11658,11658,,3354,0,0,0
11659,11659,,3355,0,0,0
11660,11660,,3289,0,26,26
11661,11661,,3356,0,0,0
11662,11662,,3289,3,0,3
11663,11663,,3357,0,0,0
11664,11664,,3289,0,39,39
11665,11665,,3358,0,0,0
11666,11666,,3289,0,9,9
11667,11667,,3359,0,0,0
11668,11668,,3289,0,9,9
11669,11669,,3360,0,0,0
11670,11670,,3289,0,10,10
11671,11671,,3361,0,0,0
11672,11672,,3362,0,0,0
11673,11673,,3363,0,0,0
11674,11674,,3364,0,0,0
11675,11675,,3365,0,0,0
11676,11676,,3289,0,14,14
11677,11677,,3366,0,0,0
11678,11678,,3367,0,0,0
11679,11679,,3289,0,3,3
11680,11680,,3368,0,0,0
11681,11681,,3369,0,0,0
11682,11682,,3289,0,30,30
11683,11683,,3370,0,0,0
11684,11684,,3289,0,2,2
11685,11685,,3371,0,0,0
11686,11686,,3372,0,0,0
11687,11687,,3373,0,0,0
11688,11688,,3374,0,0,0
11689,11689,,3375,0,0,0
11690,11690,,3376,0,0,0
11691,11691,,3289,0,1,1
11692,11692,,3289,0,28,28
11693,11693,,3289,0,25,25
11694,11694,,3289,0,10,10
11695,11695,,3289,0,38,38
11696,11696,,3289,0,27,27
11697,11697,,3289,0,7,7
11698,11698,,3377,0,0,0
11699,11699,,3289,0,3,3
11700,11700,,3289,0,30,30
11701,11701,,3289,0,1,1
11702,11702,,3289,1,0,1
11703,11703,,3289,0,28,28
11704,11704,,3378,0,0,0
11705,11705,,3379,0,0,0
11706,11706,,3380,0,0,0
11707,11707,,3381,0,0,0
11708,11708,,3382,0,0,0
11709,11709,,3383,0,0,0
11710,11710,,3384,0,0,0
11711,11711,,3385,0,0,0
11712,11712,,3386,0,0,0
11713,11713,,3387,0,0,0
11714,11714,,3388,0,0,0
11715,11715,,3389,0,0,0
11716,11716,,3390,0,0,0
11717,11717,,3391,0,0,0
11718,11718,,3392,0,0,0
11719,11719,,3393,0,0,0
11720,11720,,3394,0,0,0
11721,11721,,3289,0,21,21
11722,11722,,3289,4,0,4
11723,11723,,3289,0,31,31
11724,11724,,3395,0,0,0
11725,11725,,3396,0,0,0
11726,11726,,3397,0,0,0
11727,11727,,3398,0,0,0
11728,11728,,3399,0,0,0
11729,11729,,3400,0,0,0
11730,11730,,3401,0,0,0
11731,11731,,3402,0,0,0
11732,11732,,3403,0,0,0
11733,11733,,3289,0,1,1
11734,11734,,3289,0,2,2
11735,11735,,3289,0,3,3
11736,11736,,3404,0,0,0
11737,11737,,3405,0,2,2
11738,11738,,3406,0,0,0
11739,11739,,3289,0,14,14
11740,11740,,3289,0,3,3
11741,11741,,3289,0,8,8
11742,11742,,3289,11,0,11
11743,11743,,3407,0,0,0
11744,11744,,3408,0,0,0
11745,11745,,3289,0,1,1
11746,11746,,3289,0,2,2
11747,11747,,3409,0,0,0
11748,11748,,3410,0,0,0
11749,11749,,3411,0,0,0
11750,11750,,3289,0,30,30
11751,11751,,3289,3,0,3
11752,11752,,3412,0,0,0
11753,11753,,3289,0,24,24
11754,11754,,3289,0,1,1
11755,11755,,3289,0,37,37
11756,11756,,3289,0,7,7
11757,11757,,3413,0,0,0
11758,11758,,3289,0,9,9
11759,11759,,3414,0,0,0
11760,11760,,3289,0,3,3
11761,11761,,3415,0,0,0
11762,11762,,3416,0,0,0
11763,11763,,3417,0,0,0
11764,11764,,3289,0,6,6
11765,11765,,3418,0,0,0
11766,11766,,3419,0,0,0
11767,11767,,3289,5,0,5
11768,11768,,3420,0,0,0
11769,11769,,3421,0,0,0
11770,11770,,3289,0,19,19
11771,11771,,3289,0,1,1
11772,11772,,3289,0,3,3
11773,11773,,3422,0,0,0
11774,11774,,3289,0,7,7
11775,11775,,3423,0,0,0
11776,11776,,3424,0,0,0
11777,11777,,3289,0,30,30
11778,11778,,3425,0,0,0
11779,11779,,3426,0,0,0
11780,11780,,3427,0,0,0
11781,11781,,3428,0,0,0
11782,11782,,3429,0,0,0
11783,11783,,3289,0,17,17
11784,11784,,3430,0,0,0
11785,11785,,3431,0,0,0
11786,11786,,3432,0,0,0
11787,11787,,3289,0,15,15
11788,11788,,3433,0,0,0
11789,11789,,3434,0,0,0
11790,11790,,3289,0,3,3
11791,11791,,3435,0,0,0
11792,11792,,3436,0,0,0
11793,11793,,3437,0,0,0
11794,11794,,3438,0,0,0
11795,11795,,3439,0,0,0
11796,11796,,3440,0,0,0
11797,11797,,3289,0,6,6
11798,11798,,3289,0,5,5
11799,11799,,3441,0,0,0
11800,11800,,3289,0,23,23
11801,11801,,3442,0,0,0
11802,11802,,3289,0,18,18
11803,11803,,3289,0,9,9
11804,11804,,3443,0,0,0
11805,11805,,3289,0,7,7
11806,11806,,3289,0,10,10
11807,11807,,3444,0,0,0
11808,11808,,3445,0,0,0
11809,11809,,3446,0,0,0
11810,11810,,3447,0,0,0
11811,11811,,3289,0,21,21
11812,11812,,3289,0,9,9
11813,11813,,3448,0,0,0
11814,11814,,3449,0,0,0
11815,11815,,3450,0,0,0
11816,11816,,3451,0,0,0
11817,11817,,3452,0,0,0
11818,11818,,3453,0,0,0
11819,11819,,3454,0,0,0
11820,11820,,3455,0,0,0
11821,11821,,3456,0,0,0
11822,11822,,3457,0,0,0
11823,11823,,3289,0,7,7
11824,11824,,3289,0,17,17
11825,11825,,3458,0,0,0
11826,11826,,3289,0,1,1
11827,11827,,3459,0,0,0
11828,11828,,3460,0,0,0
11829,11829,,3461,0,0,0
11830,11830,,3462,0,0,0
11831,11831,,3289,0,54,54
11832,11832,,3289,19,0,19
11833,11833,,3463,0,0,0
11834,11834,,3464,0,0,0
11835,11835,,3465,0,0,0
11836,11836,,3466,0,0,0
11837,11837,,3467,0,0,0
11838,11838,,3468,0,0,0
11839,11839,,3469,0,0,0
11840,11840,,3470,0,0,0
11841,11841,,3289,0,19,19
11842,11842,,3471,0,0,0
11843,11843,,3289,0,8,8
11844,11844,,3472,0,0,0
11845,11845,,3473,0,0,0
11846,11846,,3474,0,0,0
11847,11847,,3475,0,0,0
11848,11848,,3476,0,0,0
11849,11849,,3477,0,0,0
11850,11850,,3478,0,0,0
11851,11851,,3479,0,0,0
11852,11852,,3480,0,0,0
11853,11853,,3481,0,0,0
11854,11854,,3482,0,0,0
11855,11855,,3483,0,0,0
11856,11856,,3484,0,0,0
11857,11857,,3289,1,0,1
11858,11858,,3289,0,3,3
11859,11859,,3485,0,0,0
11860,11860,,3486,0,0,0
11861,11861,,3487,0,0,0
11862,11862,,3488,0,0,0
11863,11863,,3489,0,0,0
11864,11864,,3289,0,18,18
11865,11865,,3490,0,0,0
11866,11866,,3289,0,23,23
11867,11867,,3491,0,0,0
11868,11868,,3289,0,8,8
11869,11869,,3289,0,5,5
11870,11870,,3289,0,12,12
11871,11871,,3696,0,10,10
11872,11872,,3289,0,8,8
11873,11873,,3492,0,0,0
11874,11874,,3289,0,8,8
11875,11875,,3493,0,0,0
11876,11876,,3289,0,6,6
11877,11877,,3494,0,0,0
11878,11878,,3289,0,8,8
11879,11879,,3495,0,0,0
11880,11880,,3496,0,0,0
11881,11881,,3497,0,0,0
11882,11882,,3498,0,0,0
11883,11883,,3499,0,0,0
11884,11884,,3500,0,0,0
11885,11885,,3501,0,0,0
11886,11886,,3502,0,0,0
11887,11887,,3283,0,2,2
11888,11888,,3289,0,35,35
11889,11889,,3503,0,0,0
11890,11890,,3504,0,0,0
11891,11891,,3505,0,0,0
11892,11892,,3289,0,16,16
11893,11893,,3506,0,0,0
11894,11894,,3507,0,0,0
11895,11895,,3508,0,0,0
11896,11896,,3509,0,0,0
11897,11897,,3289,0,5,5
11898,11898,,3510,0,0,0
11899,11899,,3289,0,7,7
11900,11900,,3511,0,0,0
11901,11901,,3289,0,2,2
11902,11902,,3512,0,0,0
11903,11903,,3289,3,0,3
11904,11904,,3513,0,0,0
11905,11905,,3514,0,0,0
11906,11906,,3515,0,0,0
11907,11907,,3516,0,0,0
11908,11908,,3289,0,12,12
11909,11909,,3517,0,0,0
11910,11910,,3518,0,0,0
11911,11911,,3289,0,35,35
11912,11912,,3519,0,0,0
11913,11913,,3520,0,0,0
11914,11914,,3289,0,30,30
11915,11915,,3521,0,0,0
11916,11916,,3289,0,2,2
11917,11917,,3522,0,0,0
11918,11918,,3523,0,0,0
11919,11919,,3524,0,0,0
11920,11920,,3525,0,0,0
11921,11921,,3526,0,0,0
11922,11922,,3527,0,0,0
11923,11923,,3289,0,25,25
11924,11924,,3289,0,23,23
11925,11925,,3528,0,0,0
11926,11926,,3529,0,0,0
11927,11927,,3289,0,2,2
11928,11928,,3530,0,0,0
11929,11929,,3531,0,0,0
11930,11930,,3532,0,0,0
11931,11931,,3289,0,16,16
11932,11932,,3533,0,0,0
11933,11933,,3289,0,16,16
11934,11934,,3534,0,0,0
11935,11935,,3535,0,0,0
11936,11936,,3289,0,14,14
11937,11937,,3536,0,0,0
11938,11938,,3289,0,1,1
11939,11939,,3289,0,8,8
11940,11940,,3537,0,0,0
11941,11941,,3538,0,0,0
11942,11942,,3289,0,27,27
11943,11943,,3539,0,0,0
11944,11944,,3540,0,0,0
11945,11945,,3541,0,0,0
11946,11946,,3542,0,0,0
11947,11947,,3289,0,1,1
11948,11948,,3289,8,0,8
11949,11949,,3543,0,0,0
11950,11950,,3544,0,0,0
11951,11951,,3545,0,0,0
11952,11952,,3289,0,7,7
11953,11953,,3546,0,0,0
11954,11954,,3547,0,0,0
11955,11955,,3289,0,17,17
11956,11956,,3289,0,29,29
11957,11957,,3289,0,2,2
11958,11958,,3289,0,10,10
11959,11959,,3548,0,0,0
11960,11960,,3549,0,0,0
11961,11961,,3550,0,0,0
11962,11962,,3551,0,0,0
11963,11963,,3552,0,0,0
11964,11964,,3553,0,0,0
11965,11965,,3554,0,0,0
11966,11966,,3289,0,4,4
11967,11967,,3289,0,20,20
11968,11968,,3555,0,0,0
11969,11969,,3289,0,6,6
11970,11970,,3289,0,2,2
11971,11971,,3556,0,0,0
11972,11972,,3289,0,17,17
11973,11973,,3289,0,8,8
11974,11974,,3289,0,5,5
11975,11975,,3289,0,23,23
11976,11976,,3289,0,8,8
11977,11977,,3557,0,0,0
11978,11978,,3558,0,0,0
11979,11979,,3559,0,0,0
11980,11980,,3560,0,0,0
11981,11981,,3561,0,0,0
11982,11982,,3289,0,6,6
11983,11983,,3289,0,5,5
11984,11984,,3289,0,3,3
11985,11985,,3289,0,22,22
11986,11986,,3562,0,0,0
11987,11987,,3289,0,14,14
11988,11988,,3289,0,28,28
11989,11989,,3563,0,0,0
11990,11990,,3564,0,0,0
11991,11991,,3565,0,0,0
11992,11992,,3566,0,0,0
11993,11993,,3567,0,3,3
11994,11994,,3567,3,0,3
11995,11995,,3568,0,0,0
11996,11996,,3569,0,0,0
11997,11997,,3289,0,4,4
11998,11998,,3289,0,1,1
11999,11999,,3570,0,0,0
12000,12000,,3571,0,0,0
12001,12001,,3289,0,44,44
12002,12002,,3572,0,0,0
12003,12003,,3573,0,0,0
12004,12004,,3289,0,3,3
12005,12005,,3574,0,0,0
12006,12006,,3575,0,0,0
12007,12007,,3576,0,0,0
12008,12008,,3577,0,0,0
12009,12009,,3289,0,6,6
12010,12010,,3578,0,0,0
12011,12011,,3289,0,26,26
12012,12012,,3289,0,18,18
12013,12013,,3579,0,0,0
12014,12014,,3580,0,0,0
12015,12015,,3581,0,0,0
12016,12016,,3289,0,23,23
12017,12017,,3582,0,0,0
12018,12018,,3583,0,0,0
12019,12019,,3289,0,12,12
12020,12020,,3584,0,0,0
12021,12021,,3289,0,5,5
12022,12022,,3289,0,4,4
12023,12023,,3585,0,0,0
12024,12024,,3586,0,0,0
12025,12025,,3587,0,0,0
12026,12026,,3289,0,24,24
12027,12027,,3588,0,0,0
12028,12028,,3589,0,0,0
12029,12029,,3289,0,1,1
12030,12030,,3590,0,0,0
12031,12031,,3591,0,0,0
12032,12032,,3592,0,0,0
12033,12033,,3593,0,0,0
12034,12034,,3594,0,0,0
12035,12035,,3595,0,0,0
12036,12036,,3289,0,6,6
12037,12037,,3596,0,0,0
12038,12038,,3597,0,5,5
12039,12039,,3598,0,0,0
12040,12040,,3599,0,0,0
12041,12041,,3600,0,0,0
12042,12042,,3601,0,0,0
12043,12043,,3289,2,0,2
12044,12044,,3289,0,2,2
12045,12045,,3602,0,0,0
12046,12046,,3603,0,0,0
12047,12047,,3604,0,0,0
12048,12048,,3605,0,0,0
12049,12049,,3606,0,0,0
12050,12050,,3607,0,0,0
12051,12051,,3608,0,0,0
12052,12052,,3609,0,0,0
12053,12053,,3610,0,0,0
12054,12054,,3611,0,0,0
12055,12055,,3289,0,25,25
12056,12056,,3612,0,0,0
12057,12057,,3289,0,28,28
12058,12058,,3289,0,22,22
12059,12059,,3613,0,0,0
12060,12060,,3289,0,7,7
12061,12061,,3614,0,0,0
12062,12062,,3615,0,0,0
12063,12063,,3616,0,0,0
12064,12064,,3617,0,0,0
12065,12065,,3618,0,0,0
12066,12066,,3289,3,0,3
12067,12067,,3289,0,16,16
12068,12068,,3289,0,4,4
12069,12069,,3619,0,0,0
12070,12070,,3620,0,0,0
12071,12071,,3621,0,0,0
12072,12072,,3622,0,0,0
12073,12073,,3623,0,1,1
12074,12074,,3624,0,0,0
12075,12075,,3289,0,19,19
12076,12076,,3625,0,0,0
12077,12077,,3289,0,19,19
12078,12078,,3289,0,27,27
12079,12079,,3289,0,4,4
12080,12080,,3626,0,0,0
12081,12081,,3627,0,0,0
12082,12082,,3289,0,15,15
12083,12083,,3289,0,15,15
12084,12084,,3289,0,4,4
12085,12085,,3628,0,0,0
12086,12086,,3629,0,0,0
12087,12087,,3630,0,0,0
12088,12088,,3289,0,29,29
12089,12089,,3631,0,0,0
12090,12090,,3289,0,42,42
12091,12091,,3632,0,0,0
12092,12092,,3633,0,0,0
12093,12093,,3289,0,19,19
12094,12094,,3634,0,0,0
12095,12095,,3635,0,0,0
12096,12096,,3636,0,1,1
12097,12097,,3637,0,0,0
12098,12098,,3638,0,0,0
12099,12099,,3289,0,2,2
12100,12100,,3289,0,21,21
12101,12101,,3639,0,0,0
12102,12102,,3289,0,12,12
12103,12103,,3640,0,0,0
12104,12104,,3641,0,0,0
12105,12105,,3289,0,2,2
12106,12106,,3642,0,0,0
12107,12107,,3643,0,0,0
12108,12108,,3644,0,1,1
12109,12109,,3645,0,0,0
12110,12110,,3646,0,0,0
12111,12111,,3647,0,0,0
12112,12112,,3289,0,6,6
12113,12113,,3648,0,0,0
12114,12114,,3649,0,0,0
12115,12115,,3289,0,2,2
12116,12116,,3650,0,0,0
12117,12117,,3651,0,0,0
12118,12118,,3289,0,21,21
12119,12119,,3652,0,0,0
12120,12120,,3653,0,0,0
12121,12121,,3289,0,33,33
12122,12122,,3654,0,0,0
12123,12123,,3655,0,0,0
12124,12124,,3656,0,0,0
12125,12125,,3657,0,0,0
12126,12126,,3658,0,0,0
12127,12127,,3659,0,0,0
12128,12128,,3660,0,2,2
12129,12129,,3661,0,0,0
12130,12130,,3662,0,0,0
12131,12131,,3663,0,0,0
12132,12132,,3664,0,0,0
12133,12133,,3665,0,0,0
12134,12134,,3666,0,0,0
12135,12135,,3667,0,0,0
12136,12136,,3668,0,0,0
12137,12137,,3669,0,0,0
12138,12138,,3670,0,0,0
12139,12139,,3671,0,0,0
12140,12140,,3289,0,6,6
12141,12141,,3672,0,0,0
12142,12142,,3673,0,0,0
12143,12143,,3674,0,0,0
12144,12144,,3289,0,6,6
12145,12145,,3675,0,0,0
12146,12146,,3676,0,0,0
12147,12147,,3677,0,0,0
12148,12148,,3678,0,0,0
12149,12149,,3679,0,0,0
12150,12150,,3680,0,0,0
12151,12151,,3681,0,0,0
12152,12152,,3682,0,0,0
12153,12153,,3683,0,0,0
12154,12154,,3684,0,0,0
12155,12155,,3685,0,0,0
12156,12156,,3686,0,0,0
12157,12157,,3687,0,0,0
12158,12158,,3289,0,34,34
12159,12159,,3688,0,0,0
12160,12160,,3689,0,0,0
12161,12161,,261,0,4,4
12162,12162,,3289,0,4,4
12163,12163,,3289,0,8,8
12164,12164,,3289,0,6,6
12165,12165,,3690,0,0,0
12166,12166,,3691,0,0,0
12167,12167,,3692,0,0,0
12168,12168,,3693,0,0,0
12169,12169,,3694,0,0,0
12170,12170,,3695,0,0,0
12171,12171,,3696,0,12,12
12172,12172,,3289,0,22,22
12173,12173,,3289,0,2,2
12174,12174,,3289,0,6,6
12175,12175,,3697,0,0,0
12176,12176,,3698,0,0,0
12177,12177,,3699,0,0,0
12178,12178,,3700,0,0,0
12179,12179,,3701,0,0,0
12180,12180,,3702,0,0,0
12181,12181,,3703,0,0,0
12182,12182,,3704,0,0,0
12183,12183,,3705,0,0,0
12184,12184,,3289,0,17,17
12185,12185,,3289,0,19,19
12186,12186,,3706,0,0,0
12187,12187,,3289,0,1,1
12188,12188,,3707,0,0,0
12189,12189,,3708,0,0,0
12190,12190,,3709,0,0,0
12191,12191,,3289,0,24,24
12192,12192,,3710,0,0,0
12193,12193,,3711,0,0,0
12194,12194,,3289,0,10,10
12195,12195,,3712,0,0,0
12196,12196,,3713,0,0,0
12197,12197,,3714,0,0,0
12198,12198,,3289,0,37,37
12199,12199,,3715,0,0,0
12200,12200,,3716,0,0,0
12201,12201,,3289,0,21,21
12202,12202,,3717,0,0,0
12203,12203,,3289,0,5,5
12204,12204,,3718,0,0,0
12205,12205,,3719,0,0,0
12206,12206,,3720,0,0,0
12207,12207,,3721,0,0,0
12208,12208,,3722,0,0,0
12209,12209,,3289,0,11,11
12210,12210,,3723,0,0,0
12211,12211,,3724,0,0,0
12212,12212,,3289,0,12,12
12213,12213,,3725,0,0,0
12214,12214,,3726,0,0,0
12215,12215,,3727,0,0,0
12216,12216,,3728,0,0,0
12217,12217,,3729,0,0,0
12218,12218,,3730,0,0,0
12219,12219,,3289,0,1,1
12220,12220,,3731,0,0,0
12221,12221,,3289,0,4,4
12222,12222,,3732,0,0,0
12223,12223,,3289,0,10,10
12224,12224,,3733,0,0,0
12225,12225,,3289,0,10,10
12226,12226,,3734,0,9,9
12227,12227,,3735,0,0,0
12228,12228,,3289,0,12,12
12229,12229,,3289,3,0,3
12230,12230,,3736,0,0,0
12231,12231,,3737,0,0,0
12232,12232,,3738,0,0,0
12233,12233,,3289,0,5,5
12234,12234,,3289,0,33,33
12235,12235,,3739,0,0,0
12236,12236,,3740,0,0,0
12237,12237,,3741,0,0,0
12238,12238,,3289,0,1,1
12239,12239,,3289,0,6,6
12240,12240,,3742,0,0,0
12241,12241,,3743,0,0,0
12242,12242,,3744,0,0,0
12243,12243,,3289,0,18,18
12244,12244,,3745,0,0,0
12245,12245,,3746,0,0,0
12246,12246,,3747,0,0,0
12247,12247,,3748,0,0,0
12248,12248,,3289,0,26,26
12249,12249,,3749,0,0,0
12250,12250,,3289,0,5,5
12251,12251,,3750,0,0,0
12252,12252,,3751,0,0,0
12253,12253,,3752,0,0,0
12254,12254,,3753,0,0,0
12255,12255,,3289,0,3,3
12256,12256,,3754,0,0,0
12257,12257,,3289,0,24,24
12258,12258,,3289,0,1,1
12259,12259,,3289,0,1,1
12260,12260,,3755,0,0,0
12261,12261,,3756,0,0,0
12262,12262,,3757,0,0,0
12263,12263,,3758,0,0,0
12264,12264,,3759,0,0,0
12265,12265,,3289,0,5,5
12266,12266,,3760,0,0,0
12267,12267,,3761,0,0,0
12268,12268,,3762,0,0,0
12269,12269,,3289,0,9,9
12270,12270,,3763,0,0,0
12271,12271,,3764,0,0,0
12272,12272,,3765,0,0,0
12273,12273,,3766,0,0,0
12274,12274,,3289,0,23,23
12275,12275,,3767,0,0,0
12276,12276,,3289,0,26,26
12277,12277,,3289,0,1,1
12278,12278,,3289,0,17,17
12279,12279,,3289,0,11,11
12280,12280,,3768,0,0,0
12281,12281,,3769,0,0,0
12282,12282,,3289,0,25,25
12283,12283,,3770,0,0,0
12284,12284,,3771,0,0,0
12285,12285,,3772,0,0,0
12286,12286,,3773,0,0,0
12287,12287,,3774,0,0,0
12288,12288,,3289,0,23,23
12289,12289,,3775,0,0,0
12290,12290,,3289,0,11,11
12291,12291,,3776,0,0,0
12292,12292,,3289,0,7,7
12293,12293,,3289,0,2,2
12294,12294,,3777,0,0,0
12295,12295,,3778,0,0,0
12296,12296,,3289,0,13,13
12297,12297,,3289,5,0,5
12298,12298,,3779,0,0,0
12299,12299,,3780,0,0,0
12300,12300,,3289,0,9,9
12301,12301,,3781,0,1,1
12302,12302,,3782,0,0,0
12303,12303,,3783,0,0,0
12304,12304,,3784,0,0,0
12305,12305,,3289,0,30,30
12306,12306,,3785,0,0,0
12307,12307,,3786,0,0,0
12308,12308,,3787,0,2,2
12309,12309,,3289,0,6,6
12310,12310,,3289,0,19,19
12311,12311,,3788,0,0,0
12312,12312,,3289,0,5,5
12313,12313,,3289,0,19,19
12314,12314,,3289,0,4,4
12315,12315,,3789,0,0,0
12316,12316,,3289,0,2,2
12317,12317,,3790,0,0,0
12318,12318,,3791,0,3,3
12319,12319,,3792,0,0,0
12320,12320,,3289,0,7,7
12321,12321,,3289,0,2,2
12322,12322,,3793,0,0,0
12323,12323,,3794,0,0,0
12324,12324,,3795,0,0,0
12325,12325,,3796,0,0,0
12326,12326,,3797,0,1,1
12327,12327,,3798,0,0,0
12328,12328,,3799,0,0,0
12329,12329,,3289,0,15,15
12330,12330,,3800,0,0,0
12331,12331,,3801,0,0,0
12332,12332,,3802,0,0,0
12333,12333,,3803,0,0,0
12334,12334,,3289,0,24,24
12335,12335,,3289,0,3,3
12336,12336,,3289,0,4,4
12337,12337,,3804,0,0,0
12338,12338,,3805,0,0,0
12339,12339,,3806,0,0,0
12340,12340,,3807,0,0,0
12341,12341,,3808,0,0,0
12342,12342,,3289,0,1,1
12343,12343,,3809,0,0,0
12344,12344,,3289,0,10,10
12345,12345,,3289,0,26,26
12346,12346,,3810,0,0,0
12347,12347,,3811,0,0,0
12348,12348,,3812,0,0,0
12349,12349,,3813,0,0,0
12350,12350,,3814,0,0,0
12351,12351,,3815,0,0,0
12352,12352,,3816,0,0,0
12353,12353,,3817,0,0,0
12354,12354,,3818,0,0,0
12355,12355,,3819,0,0,0
12356,12356,,3289,0,26,26
12357,12357,,3820,0,0,0
12358,12358,,3821,0,0,0
12359,12359,,3289,0,34,34
12360,12360,,3289,0,26,26
12361,12361,,3289,0,7,7
12362,12362,,3822,0,0,0
12363,12363,,3823,0,0,0
12364,12364,,3289,0,2,2
12365,12365,,3824,0,0,0
12366,12366,,3825,0,0,0
12367,12367,,3289,0,16,16
12368,12368,,3826,0,0,0
12369,12369,,3289,0,31,31
12370,12370,,3827,0,0,0
12371,12371,,3289,0,8,8
12372,12372,,3828,0,0,0
12373,12373,,3289,0,7,7
12374,12374,,3829,0,0,0
12375,12375,,3289,0,5,5
12376,12376,,3289,0,4,4
12377,12377,,3289,0,1,1
12378,12378,,3830,0,0,0
12379,12379,,3831,0,0,0
12380,12380,,3832,0,0,0
12381,12381,,3833,0,0,0
12382,12382,,3289,0,16,16
12383,12383,,3834,0,0,0
12384,12384,,3835,0,0,0
12385,12385,,3836,0,0,0
12386,12386,,3289,0,33,33
12387,12387,,3837,0,0,0
12388,12388,,3289,0,5,5
12389,12389,,3289,0,3,3
12390,12390,,3838,0,0,0
12391,12391,,3289,0,14,14
12392,12392,,3289,0,1,1
12393,12393,,3839,0,0,0
12394,12394,,3289,0,14,14
12395,12395,,3289,0,1,1
12396,12396,,3840,0,0,0
12397,12397,,3841,0,0,0
12398,12398,,3289,0,3,3
12399,12399,,3842,0,0,0
12400,12400,,3843,0,0,0
12401,12401,,3844,0,0,0
12402,12402,,3289,0,1,1
12403,12403,,3845,0,0,0
12404,12404,,3289,0,3,3
12405,12405,,3846,0,0,0
12406,12406,,3847,0,0,0
12407,12407,,3289,0,18,18
12408,12408,,3289,0,2,2
12409,12409,,3848,0,0,0
12410,12410,,3849,0,0,0
12411,12411,,3850,0,0,0
12412,12412,,3851,0,0,0
12413,12413,,3852,0,0,0
12414,12414,,3853,0,0,0
12415,12415,,3289,0,28,28
12416,12416,,3289,0,20,20
12417,12417,,3854,0,0,0
12418,12418,,3289,0,18,18
12419,12419,,3289,0,22,22
12420,12420,,3855,0,0,0
12421,12421,,3856,0,0,0
12422,12422,,3857,0,0,0
12423,12423,,3289,0,6,6
12424,12424,,3858,0,0,0
12425,12425,,3859,0,0,0
12426,12426,,3289,0,25,25
12427,12427,,3860,0,0,0
12428,12428,,3289,0,42,42
12429,12429,,3289,4,0,4
12430,12430,,3289,0,26,26
12431,12431,,3861,0,0,0
12432,12432,,3289,0,13,13
12433,12433,,3862,0,0,0
12434,12434,,3863,0,0,0
12435,12435,,3864,0,0,0
12436,12436,,3865,0,0,0
12437,12437,,3866,0,0,0
12438,12438,,3289,0,1,1
12439,12439,,3289,0,8,8
12440,12440,,3867,0,0,0
12441,12441,,3868,0,0,0
12442,12442,,3869,0,0,0
12443,12443,,3870,0,0,0
12444,12444,,3871,0,0,0
12445,12445,,3872,0,0,0
12446,12446,,3873,0,0,0
12447,12447,,3289,0,8,8
12448,12448,,3874,0,0,0
12449,12449,,3289,0,25,25
12450,12450,,3289,0,5,5
12451,12451,,3289,0,1,1
12452,12452,,3875,0,0,0
12453,12453,,3876,0,0,0
12454,12454,,3877,0,0,0
12455,12455,,3878,0,0,0
12456,12456,,3879,0,0,0
12457,12457,,3289,0,21,21
12458,12458,,3289,0,3,3
12459,12459,,3880,0,0,0
12460,12460,,3881,0,0,0
12461,12461,,3882,0,0,0
12462,12462,,3883,0,0,0
12463,12463,,3884,0,0,0
12464,12464,,3885,0,0,0
12465,12465,,3886,0,0,0
12466,12466,,3289,0,17,17
12467,12467,,3887,0,0,0
12468,12468,,3888,0,0,0
12469,12469,,3289,0,25,25
12470,12470,,3289,0,6,6
12471,12471,,3889,0,0,0
12472,12472,,3289,0,1,1
12473,12473,,3890,0,0,0
12474,12474,,3891,0,0,0
12475,12475,,3892,0,0,0
12476,12476,,3893,0,0,0
12477,12477,,3894,0,0,0
12478,12478,,3289,0,35,35
12479,12479,,3895,0,0,0
12480,12480,,3289,0,13,13
12481,12481,,3289,0,2,2
12482,12482,,3289,0,14,14
12483,12483,,3896,0,0,0
12484,12484,,3897,0,0,0
12485,12485,,3898,0,0,0
12486,12486,,3899,0,0,0
12487,12487,,3289,0,7,7
12488,12488,,3289,0,1,1
12489,12489,,3289,0,2,2
12490,12490,,3900,0,0,0
12491,12491,,3901,0,0,0
12492,12492,,3902,0,0,0
12493,12493,,3289,0,24,24
12494,12494,,3903,0,0,0
12495,12495,,3289,0,10,10
12496,12496,,3904,0,0,0
12497,12497,,3289,0,48,48
12498,12498,,3905,0,0,0
12499,12499,,3906,0,0,0
12500,12500,,3907,0,0,0
12501,12501,,1214,355,0,355
12502,12502,,1214,212,0,212
12503,12503,,1985,0,414,414
12504,12504,,427,17,0,17
12505,12505,,1974,377,0,377
12506,12506,,427,44,0,44
12507,12507,,1502,13,0,13
12508,12508,,1952,1750,0,1750
12509,12509,,1985,357,0,357
12510,12510,,427,365,0,365
12511,12511,,1952,2176,0,2176
12512,12512,,1985,0,6,6
12513,12513,,1499,0,203,203
12514,12514,,1502,305,0,305
12515,12515,,2074,359,0,359
12516,12516,,2008,346,0,346
12517,12517,,1998,8,0,8
12518,12518,,158,332,0,332
12519,12519,,427,207,0,207
12520,12520,,1985,682,0,682
12521,12521,,2110,88,0,88
12522,12522,,3908,0,0,0
12523,12523,,1998,211,0,211
12524,12524,,1985,192,0,192
12525,12525,,3913,212,0,212
12526,12526,,2008,361,0,361
12527,12527,,1974,159,0,159
12528,12528,,1974,0,198,198
12529,12529,,1974,62,0,62
12530,12530,,3909,0,0,0
12531,12531,,1502,179,0,179
12532,12532,,1974,740,0,740
12533,12533,,46,136,0,136
12534,12534,,1985,0,6,6
12535,12535,,1985,309,0,309
12536,12536,,1985,0,9,9
12537,12537,,3910,0,0,0
12538,12538,,1974,154,0,154
12539,12539,,261,373,0,373
12540,12540,,3911,0,0,0
12541,12541,,3912,399,0,399
12542,12542,,1998,9,0,9
12543,12543,,1985,168,0,168
12544,12544,,1985,354,0,354
12545,12545,,1985,0,340,340
12546,12546,,1203,8,0,8
12547,12547,,1952,264,0,264
12548,12548,,1998,0,11,11
12549,12549,,1998,9,0,9
12550,12550,,1985,0,7,7
12551,12551,,1839,203,0,203
12552,12552,,3913,0,211,211
12553,12553,,3914,403,0,403
