Id,Label,timeset,indegree,outdegree,degree,modularity_class
0,0,,14,16,30,96
1,1,,8,0,8,96
2,2,,38,43,81,171
3,3,,82,0,82,804
4,4,,0,3,3,113
5,5,,3,0,3,113
6,6,,0,3,3,74
7,7,,4,0,4,74
8,8,,0,3,3,46
9,9,,39,0,39,46
10,10,,0,25,25,204
11,11,,14,0,14,204
12,12,,0,1,1,21
13,13,,27,0,27,21
14,14,,64,35,99,27
15,15,,12,0,12,27
16,16,,2,3,5,73
17,17,,60,0,60,73
18,18,,0,12,12,204
19,19,,0,3,3,55
20,20,,7,0,7,55
21,21,,0,74,74,804
22,22,,4,0,4,260
23,23,,35,37,72,144
24,24,,3,0,3,73
25,25,,8,9,17,41
26,26,,11,0,11,41
27,27,,0,3,3,96
28,28,,28,0,28,47
29,29,,3,4,7,316
30,30,,50,0,50,316
31,31,,0,10,10,813
32,32,,5,0,5,813
33,33,,0,9,9,46
34,34,,0,1,1,0
35,35,,10,0,10,0
36,36,,0,4,4,46
37,37,,5,0,5,204
38,38,,0,5,5,215
39,39,,24,0,24,215
40,40,,7,7,14,57
41,41,,3,0,3,57
42,42,,0,1,1,77
43,43,,13,0,13,77
44,44,,0,1,1,21
45,45,,11,0,11,21
46,46,,1,2,3,260
47,47,,5,0,5,260
48,48,,21,22,43,46
49,49,,3,0,3,46
50,50,,3,4,7,19
51,51,,3,0,3,19
52,52,,0,3,3,46
53,53,,15,0,15,46
54,54,,4,5,9,21
55,55,,77,0,77,42
56,56,,30,51,81,33
57,57,,32,0,32,33
58,58,,65,67,132,27
59,59,,0,3,3,46
60,60,,2,0,2,46
61,61,,0,5,5,46
62,62,,45,46,91,56
63,63,,6,0,6,56
64,64,,16,17,33,804
65,65,,6,0,6,804
66,66,,6,7,13,67
67,67,,56,0,56,67
68,68,,47,49,96,46
69,69,,30,0,30,46
70,70,,12,13,25,96
71,71,,26,0,26,46
72,72,,0,5,5,280
73,73,,6,0,6,280
74,74,,0,1,1,46
75,75,,19,0,19,46
76,76,,61,9,70,19
77,77,,5,0,5,19
78,78,,34,32,66,59
79,79,,216,0,216,27
80,80,,5,6,11,124
81,81,,7,26,33,124
82,82,,17,18,35,55
83,83,,91,0,91,44
84,84,,55,56,111,73
85,85,,0,3,3,73
86,86,,4,0,4,73
87,87,,0,3,3,74
88,88,,10,11,21,46
89,89,,34,0,34,46
90,90,,0,19,19,216
91,91,,3,0,3,216
92,92,,0,35,35,804
93,93,,2,8,10,90
94,94,,9,0,9,46
95,95,,0,1,1,113
96,96,,4,0,4,113
97,97,,53,54,107,67
98,98,,56,57,113,28
99,99,,6,0,6,28
100,100,,5,10,15,27
101,101,,83,0,83,272
102,102,,6,8,14,260
103,103,,159,0,159,46
104,104,,0,1,1,113
105,105,,23,0,23,113
106,106,,26,25,51,29
107,107,,51,53,104,44
108,108,,0,6,6,46
109,109,,6,0,6,46
110,110,,0,4,4,27
111,111,,31,0,31,46
112,112,,15,16,31,14
113,113,,0,1,1,46
114,114,,10,12,22,73
115,115,,0,3,3,67
116,116,,0,3,3,67
117,117,,0,3,3,81
118,118,,3,0,3,81
119,119,,1,2,3,73
120,120,,13,12,25,73
121,121,,0,3,3,259
122,122,,0,1,1,67
123,123,,3,0,3,67
124,124,,31,12,43,67
125,125,,29,0,29,256
126,126,,0,3,3,42
127,127,,8,0,8,804
128,128,,21,22,43,55
129,129,,11,0,11,55
130,130,,0,35,35,204
131,131,,4,0,4,204
132,132,,0,80,80,204
133,133,,11,0,11,133
134,134,,10,11,21,43
135,135,,11,0,11,43
136,136,,0,26,26,804
137,137,,25,0,25,74
138,138,,20,21,41,260
139,139,,332,0,332,260
140,140,,0,3,3,46
141,141,,4,0,4,46
142,142,,16,17,33,152
143,143,,14,0,14,14
144,144,,25,26,51,38
145,145,,11,0,11,46
146,146,,21,22,43,30
147,147,,18,15,33,30
148,148,,18,20,38,27
149,149,,26,0,26,27
150,150,,21,22,43,19
151,151,,4,0,4,19
152,152,,2,3,5,39
153,153,,17,18,35,21
154,154,,7,8,15,46
155,155,,5,0,5,46
156,156,,0,14,14,216
157,157,,3,0,3,216
158,158,,6,7,13,27
159,159,,0,5,5,46
160,160,,0,31,31,216
161,161,,4,0,4,46
162,162,,11,12,23,15
163,163,,6,0,6,15
164,164,,45,46,91,5
165,165,,9,0,9,204
166,166,,11,13,24,316
167,167,,11,12,23,27
168,168,,39,0,39,27
169,169,,0,1,1,46
170,170,,4,0,4,46
171,171,,0,2,2,46
172,172,,0,1,1,49
173,173,,25,0,25,49
174,174,,8,9,17,46
175,175,,35,36,71,56
176,176,,10,0,10,56
177,177,,0,3,3,124
178,178,,11,12,23,47
179,179,,0,3,3,74
180,180,,15,17,32,27
181,181,,0,8,8,46
182,182,,0,5,5,46
183,183,,5,0,5,73
184,184,,13,14,27,73
185,185,,5,0,5,73
186,186,,35,36,71,81
187,187,,4,0,4,81
188,188,,55,56,111,187
189,189,,4,0,4,187
190,190,,14,15,29,54
191,191,,2,0,2,54
192,192,,8,9,17,0
193,193,,0,5,5,46
194,194,,6,0,6,815
195,195,,0,187,187,806
196,196,,37,13,50,90
197,197,,13,14,27,260
198,198,,0,103,103,804
199,199,,36,0,36,260
200,200,,16,17,33,56
201,201,,0,41,41,804
202,202,,4,0,4,239
203,203,,0,3,3,77
204,204,,20,21,41,113
205,205,,3,0,3,113
206,206,,0,1,1,58
207,207,,9,0,9,58
208,208,,0,108,108,73
209,209,,21,22,43,96
210,210,,11,0,11,96
211,211,,0,3,3,171
212,212,,5,0,5,171
213,213,,0,47,47,804
214,214,,8,0,8,44
215,215,,0,22,22,90
216,216,,0,2,2,280
217,217,,7,0,7,280
218,218,,0,3,3,49
219,219,,0,22,22,204
220,220,,3,0,3,204
221,221,,0,125,125,806
222,222,,7,0,7,806
223,223,,30,31,61,260
224,224,,14,0,14,260
225,225,,0,7,7,230
226,226,,32,33,65,19
227,227,,14,15,29,67
228,228,,6,0,6,46
229,229,,0,1,1,260
230,230,,6,0,6,260
231,231,,3,4,7,73
232,232,,25,26,51,14
233,233,,0,1,1,152
234,234,,4,138,142,152
235,235,,12,14,26,49
236,236,,0,63,63,815
237,237,,5,0,5,46
238,238,,0,3,3,44
239,239,,8,5,13,26
240,240,,27,0,27,29
241,241,,0,5,5,46
242,242,,0,48,48,216
243,243,,13,0,13,216
244,244,,10,11,21,90
245,245,,27,0,27,46
246,246,,0,25,25,806
247,247,,13,74,87,90
248,248,,0,3,3,55
249,249,,10,0,10,55
250,250,,0,25,25,33
251,251,,0,51,51,124
252,252,,0,4,4,46
253,253,,12,0,12,81
254,254,,9,46,55,260
255,255,,6,68,74,260
256,256,,0,1,1,260
257,257,,0,13,13,204
258,258,,23,0,23,255
259,259,,0,4,4,74
260,260,,8,9,17,260
261,261,,8,9,17,0
262,262,,0,3,3,90
263,263,,0,2,2,55
264,264,,13,14,27,77
265,265,,24,0,24,77
266,266,,0,64,64,815
267,267,,3,0,3,53
268,268,,25,26,51,14
269,269,,7,0,7,14
270,270,,25,27,52,46
271,271,,0,18,18,14
272,272,,4,5,9,56
273,273,,15,22,37,56
274,274,,0,29,29,216
275,275,,4,0,4,35
276,276,,0,5,5,46
277,277,,7,0,7,255
278,278,,0,7,7,14
279,279,,6,0,6,41
280,280,,0,3,3,272
281,281,,3,0,3,272
282,282,,0,31,31,818
283,283,,21,6,27,204
284,284,,0,7,7,230
285,285,,5,0,5,230
286,286,,0,168,168,90
287,287,,21,22,43,67
288,288,,0,2,2,113
289,289,,0,4,4,46
290,290,,5,0,5,46
291,291,,0,23,23,74
292,292,,3,0,3,74
293,293,,0,3,3,256
294,294,,0,5,5,46
295,295,,51,0,51,815
296,296,,0,1,1,46
297,297,,0,1,1,260
298,298,,0,5,5,43
299,299,,13,0,13,43
300,300,,0,10,10,204
301,301,,34,0,34,14
302,302,,0,2,2,260
303,303,,0,1,1,77
304,304,,14,15,29,113
305,305,,9,0,9,113
306,306,,0,4,4,804
307,307,,3,4,7,113
308,308,,26,0,26,113
309,309,,40,42,82,57
310,310,,5,0,5,57
311,311,,0,3,3,29
312,312,,24,25,49,49
313,313,,4,5,9,21
314,314,,0,18,18,40
315,315,,0,2,2,67
316,316,,2,0,2,67
317,317,,0,1,1,316
318,318,,6,7,13,316
319,319,,47,49,96,260
320,320,,33,34,67,67
321,321,,46,47,93,73
322,322,,0,14,14,216
323,323,,25,0,25,216
324,324,,0,1,1,316
325,325,,6,12,18,57
326,326,,0,3,3,55
327,327,,1,2,3,29
328,328,,4,0,4,29
329,329,,17,18,35,46
330,330,,9,0,9,46
331,331,,0,9,9,216
332,332,,6,0,6,42
333,333,,0,1,1,41
334,334,,0,5,5,46
335,335,,10,11,21,44
336,336,,4,0,4,44
337,337,,27,29,56,46
338,338,,5,6,11,260
339,339,,2,3,5,46
340,340,,0,4,4,74
341,341,,9,13,22,26
342,342,,3,0,3,26
343,343,,0,3,3,152
344,344,,0,4,4,113
345,345,,0,6,6,216
346,346,,11,0,11,216
347,347,,0,1,1,50
348,348,,6,0,6,50
349,349,,0,20,20,14
350,350,,48,50,98,301
351,351,,4,0,4,301
352,352,,8,10,18,260
353,353,,0,5,5,73
354,354,,15,16,31,41
355,355,,22,23,45,256
356,356,,2,4,6,11
357,357,,3,0,3,11
358,358,,0,41,41,216
359,359,,3,0,3,216
360,360,,1,2,3,77
361,361,,6,0,6,77
362,362,,29,62,91,81
363,363,,1,2,3,272
364,364,,3,0,3,272
365,365,,0,1,1,280
366,366,,3,0,3,280
367,367,,0,3,3,67
368,368,,19,1,20,124
369,369,,18,6,24,30
370,370,,7,0,7,30
371,371,,0,1,1,46
372,372,,0,64,64,806
373,373,,15,16,31,34
374,374,,37,39,76,44
375,375,,8,10,18,27
376,376,,3,0,3,37
377,377,,7,8,15,30
378,378,,0,1,1,46
379,379,,4,0,4,46
380,380,,32,33,65,19
381,381,,22,0,22,19
382,382,,1,2,3,27
383,383,,5,6,11,73
384,384,,11,0,11,113
385,385,,0,154,154,124
386,386,,9,0,9,74
387,387,,4,5,9,280
388,388,,26,0,26,280
389,389,,5,7,12,30
390,390,,21,0,21,30
391,391,,0,1,1,46
392,392,,3,0,3,46
393,393,,0,1,1,216
394,394,,17,18,35,152
395,395,,4,0,4,152
396,396,,38,40,78,260
397,397,,7,8,15,26
398,398,,0,2,2,79
399,399,,6,0,6,79
400,400,,13,14,27,144
401,401,,18,19,37,77
402,402,,11,0,11,77
403,403,,121,122,243,280
404,404,,0,93,93,806
405,405,,0,5,5,46
406,406,,0,4,4,46
407,407,,8,0,8,46
408,408,,0,16,16,152
409,409,,0,3,3,280
410,410,,3,0,3,280
411,411,,0,7,7,46
412,412,,0,7,7,46
413,413,,36,37,73,144
414,414,,4,0,4,144
415,415,,60,61,121,49
416,416,,3,4,7,301
417,417,,2,0,2,301
418,418,,0,5,5,46
419,419,,5,0,5,57
420,420,,13,19,32,40
421,421,,5,0,5,46
422,422,,15,16,31,77
423,423,,3,4,7,813
424,424,,78,0,78,813
425,425,,12,13,25,46
426,426,,6,0,6,46
427,427,,12,13,25,39
428,428,,3,0,3,39
429,429,,0,3,3,204
430,430,,0,3,3,67
431,431,,10,13,23,46
432,432,,8,0,8,806
433,433,,44,46,90,74
434,434,,20,21,41,96
435,435,,5,0,5,46
436,436,,0,17,17,14
437,437,,11,12,23,77
438,438,,8,0,8,77
439,439,,3,4,7,804
440,440,,20,21,41,35
441,441,,3,0,3,46
442,442,,0,81,81,804
443,443,,28,41,69,77
444,444,,11,12,23,46
445,445,,5,3,8,73
446,446,,4,0,4,73
447,447,,0,41,41,216
448,448,,0,5,5,204
449,449,,3,0,3,204
450,450,,0,83,83,204
451,451,,42,43,85,73
452,452,,0,1,1,77
453,453,,48,14,62,96
454,454,,8,0,8,46
455,455,,0,5,5,46
456,456,,3,0,3,255
457,457,,0,55,55,204
458,458,,0,6,6,77
459,459,,2,0,2,77
460,460,,44,67,111,48
461,461,,0,5,5,57
462,462,,0,35,35,255
463,463,,16,0,16,255
464,464,,3,4,7,19
465,465,,4,0,4,46
466,466,,0,71,71,255
467,467,,0,3,3,112
468,468,,0,4,4,46
469,469,,0,1,1,144
470,470,,8,0,8,144
471,471,,19,13,32,272
472,472,,19,20,39,55
473,473,,7,8,15,14
474,474,,0,3,3,260
475,475,,40,41,81,272
476,476,,1,2,3,27
477,477,,0,3,3,49
478,478,,7,0,7,49
479,479,,19,20,39,96
480,480,,3,0,3,96
481,481,,0,26,26,40
482,482,,22,23,45,67
483,483,,58,60,118,59
484,484,,54,56,110,46
485,485,,12,356,368,53
486,486,,12,13,25,46
487,487,,0,3,3,260
488,488,,5,6,11,81
489,489,,3,0,3,216
490,490,,13,14,27,49
491,491,,6,7,13,215
492,492,,0,1,1,813
493,493,,16,17,33,73
494,494,,8,10,18,47
495,495,,21,12,33,44
496,496,,4,0,4,133
497,497,,17,18,35,272
498,498,,0,14,14,248
499,499,,3,0,3,248
500,500,,16,18,34,29
501,501,,3,0,3,29
502,502,,0,120,120,272
503,503,,0,40,40,204
504,504,,0,15,15,77
505,505,,0,81,81,806
506,506,,0,1,1,52
507,507,,3,0,3,52
508,508,,0,1,1,316
509,509,,0,4,4,77
510,510,,3,0,3,77
511,511,,0,13,13,204
512,512,,13,15,28,41
513,513,,0,3,3,260
514,514,,0,1,1,77
515,515,,2,0,2,77
516,516,,5,28,33,73
517,517,,0,4,4,46
518,518,,0,3,3,316
519,519,,0,3,3,67
520,520,,4,0,4,67
521,521,,0,17,17,216
522,522,,0,2,2,67
523,523,,0,1,1,67
524,524,,4,0,4,67
525,525,,0,1,1,21
526,526,,0,1,1,33
527,527,,0,52,52,204
528,528,,0,3,3,67
529,529,,14,0,14,67
530,530,,0,1,1,316
531,531,,19,20,39,27
532,532,,6,7,13,41
533,533,,7,0,7,41
534,534,,0,3,3,42
535,535,,14,15,29,46
536,536,,0,1,1,77
537,537,,0,30,30,815
538,538,,20,21,41,73
539,539,,0,123,123,804
540,540,,11,0,11,55
541,541,,5,7,12,259
542,542,,8,0,8,259
543,543,,30,31,61,812
544,544,,5,0,5,812
545,545,,8,9,17,42
546,546,,0,3,3,53
547,547,,57,59,116,46
548,548,,21,22,43,215
549,549,,0,4,4,280
550,550,,3,0,3,280
551,551,,0,3,3,260
552,552,,42,3,45,804
553,553,,3,0,3,27
554,554,,0,63,63,26
555,555,,35,0,35,26
556,556,,0,2,2,113
557,557,,5,0,5,113
558,558,,0,1,1,46
559,559,,3,0,3,46
560,560,,46,48,94,27
561,561,,4,5,9,27
562,562,,0,6,6,19
563,563,,0,174,174,806
564,564,,1,2,3,14
565,565,,48,49,97,26
566,566,,0,3,3,262
567,567,,3,5,8,301
568,568,,40,41,81,56
569,569,,32,33,65,45
570,570,,0,4,4,46
571,571,,102,21,123,58
572,572,,0,9,9,280
573,573,,8,0,8,280
574,574,,0,1,1,14
575,575,,0,1,1,73
576,576,,20,22,42,256
577,577,,4,5,9,272
578,578,,0,7,7,204
579,579,,0,178,178,806
580,580,,5,6,11,27
581,581,,0,41,41,40
582,582,,3,0,3,40
583,583,,0,21,21,806
584,584,,0,1,1,280
585,585,,0,5,5,46
586,586,,3,0,3,46
587,587,,0,28,28,21
588,588,,3,4,7,27
589,589,,11,0,11,46
590,590,,0,1,1,55
591,591,,14,15,29,14
592,592,,0,6,6,46
593,593,,6,8,14,260
594,594,,3,9,12,37
595,595,,0,1,1,14
596,596,,17,18,35,25
597,597,,14,0,14,25
598,598,,0,46,46,804
599,599,,11,0,11,152
600,600,,0,38,38,239
601,601,,25,26,51,38
602,602,,17,0,17,38
603,603,,0,4,4,272
604,604,,17,18,35,44
605,605,,23,0,23,46
606,606,,22,24,46,112
607,607,,0,4,4,46
608,608,,7,0,7,46
609,609,,0,27,27,40
610,610,,3,0,3,40
611,611,,0,31,31,804
612,612,,0,297,297,806
613,613,,3,0,3,39
614,614,,0,1,1,38
615,615,,2,3,5,67
616,616,,6,3,9,46
617,617,,0,2,2,49
618,618,,4,6,10,27
619,619,,51,53,104,67
620,620,,3,0,3,67
621,621,,0,2,2,29
622,622,,0,3,3,74
623,623,,1,1,2,216
624,624,,8,0,8,216
625,625,,5,6,11,46
626,626,,7,0,7,46
627,627,,0,32,32,804
628,628,,2,0,2,260
629,629,,15,16,31,56
630,630,,0,46,46,216
631,631,,3,0,3,216
632,632,,62,64,126,260
633,633,,0,26,26,815
634,634,,11,12,23,43
635,635,,0,4,4,46
636,636,,0,4,4,260
637,637,,0,7,7,113
638,638,,6,0,6,113
639,639,,43,44,87,260
640,640,,7,9,16,27
641,641,,45,47,92,144
642,642,,5,0,5,144
643,643,,1,2,3,144
644,644,,9,0,9,144
645,645,,7,8,15,74
646,646,,0,2,2,813
647,647,,0,5,5,46
648,648,,19,0,19,46
649,649,,0,356,356,812
650,650,,5,0,5,812
651,651,,0,1,1,25
652,652,,0,4,4,301
653,653,,6,7,13,73
654,654,,0,3,3,77
655,655,,4,0,4,77
656,656,,0,49,49,67
657,657,,0,1,1,152
658,658,,6,0,6,152
659,659,,0,1,1,77
660,660,,0,6,6,46
661,661,,0,1,1,44
662,662,,3,0,3,44
663,663,,10,11,21,35
664,664,,4,0,4,35
665,665,,23,24,47,41
666,666,,0,1,1,41
667,667,,34,0,34,41
668,668,,10,11,21,57
669,669,,0,4,4,46
670,670,,26,27,53,1
671,671,,42,44,86,30
672,672,,5,0,5,30
673,673,,0,6,6,46
674,674,,15,0,15,46
675,675,,0,3,3,46
676,676,,27,28,55,113
677,677,,32,27,59,46
678,678,,0,3,3,272
679,679,,6,0,6,272
680,680,,9,10,19,41
681,681,,4,0,4,46
682,682,,0,97,97,216
683,683,,0,5,5,46
684,684,,30,31,61,79
685,685,,6,0,6,79
686,686,,0,3,3,113
687,687,,0,8,8,255
688,688,,19,20,39,44
689,689,,0,3,3,46
690,690,,55,103,158,815
691,691,,3,0,3,815
692,692,,0,4,4,46
693,693,,0,21,21,204
694,694,,5,0,5,204
695,695,,0,1,1,40
696,696,,3,0,3,40
697,697,,0,208,208,806
698,698,,6,7,13,171
699,699,,0,8,8,46
700,700,,6,7,13,73
701,701,,3,0,3,46
702,702,,10,11,21,27
703,703,,16,40,56,46
704,704,,0,4,4,22
705,705,,10,0,10,22
706,706,,0,1,1,41
707,707,,0,2,2,113
708,708,,0,155,155,804
709,709,,0,7,7,46
710,710,,3,0,3,46
711,711,,0,39,39,42
712,712,,26,27,53,19
713,713,,0,2,2,14
714,714,,4,3,7,113
715,715,,44,45,89,67
716,716,,8,21,29,27
717,717,,51,52,103,215
718,718,,0,14,14,30
719,719,,7,8,15,144
720,720,,18,19,37,19
721,721,,5,0,5,19
722,722,,6,7,13,46
723,723,,11,12,23,77
724,724,,0,4,4,46
725,725,,0,4,4,46
726,726,,12,10,22,26
727,727,,0,59,59,204
728,728,,0,23,23,40
729,729,,6,0,6,40
730,730,,0,3,3,28
731,731,,8,9,17,41
732,732,,0,6,6,19
733,733,,15,17,32,38
734,734,,0,4,4,46
735,735,,10,11,21,96
736,736,,5,0,5,144
737,737,,0,6,6,46
738,738,,4,0,4,46
739,739,,0,163,163,804
740,740,,3,0,3,121
741,741,,33,34,67,256
742,742,,45,46,91,90
743,743,,0,1,1,67
744,744,,4,0,4,67
745,745,,7,8,15,260
746,746,,25,26,51,255
747,747,,5,6,11,27
748,748,,5,14,19,215
749,749,,0,13,13,33
750,750,,11,12,23,259
751,751,,0,1,1,280
752,752,,0,1,1,42
753,753,,0,3,3,46
754,754,,24,25,49,280
755,755,,7,8,15,38
756,756,,10,3,13,46
757,757,,9,0,9,46
758,758,,0,3,3,67
759,759,,0,1,1,55
760,760,,42,44,86,260
761,761,,31,32,63,31
762,762,,4,0,4,31
763,763,,27,28,55,44
764,764,,5,0,5,216
765,765,,0,52,52,154
766,766,,9,10,19,216
767,767,,6,7,13,67
768,768,,10,12,22,42
769,769,,0,3,3,90
770,770,,5,0,5,806
771,771,,10,12,22,59
772,772,,0,4,4,67
773,773,,21,22,43,56
774,774,,59,60,119,16
775,775,,4,0,4,16
776,776,,0,1,1,67
777,777,,3,0,3,67
778,778,,0,20,20,216
779,779,,13,0,13,171
780,780,,17,18,35,29
781,781,,0,1,1,0
782,782,,10,12,22,14
783,783,,0,3,3,260
784,784,,5,6,11,259
785,785,,4,0,4,259
786,786,,0,3,3,67
787,787,,32,34,66,301
788,788,,0,25,25,216
789,789,,9,10,19,50
790,790,,0,1,1,2
791,791,,3,0,3,2
792,792,,16,17,33,50
793,793,,0,3,3,46
794,794,,0,17,17,152
795,795,,0,3,3,46
796,796,,42,44,86,25
797,797,,36,37,73,21
798,798,,6,0,6,21
799,799,,0,5,5,46
800,800,,0,77,77,804
801,801,,7,8,15,260
802,802,,0,3,3,46
803,803,,0,5,5,46
804,804,,17,19,36,55
805,805,,0,9,9,243
806,806,,6,0,6,255
807,807,,0,3,3,46
808,808,,4,0,4,46
809,809,,0,177,177,804
810,810,,3,0,3,805
811,811,,0,245,245,806
812,812,,7,0,7,806
813,813,,0,42,42,216
814,814,,13,14,27,144
815,815,,0,101,101,806
816,816,,0,3,3,260
817,817,,0,24,24,204
818,818,,4,0,4,204
819,819,,0,9,9,216
820,820,,8,9,17,43
821,821,,21,48,69,56
822,822,,0,135,135,815
823,823,,7,8,15,804
824,824,,25,27,52,58
825,825,,0,15,15,40
826,826,,3,0,3,40
827,827,,13,14,27,77
828,828,,10,20,30,79
829,829,,14,15,29,272
830,830,,0,5,5,46
831,831,,0,33,33,204
832,832,,0,2,2,74
833,833,,0,3,3,46
834,834,,0,8,8,74
835,835,,0,6,6,46
836,836,,13,0,13,46
837,837,,0,2,2,49
838,838,,6,0,6,49
839,839,,0,3,3,112
840,840,,0,17,17,813
841,841,,0,2,2,46
842,842,,0,1,1,260
843,843,,3,0,3,260
844,844,,0,32,32,216
845,845,,4,0,4,46
846,846,,0,35,35,204
847,847,,4,5,9,256
848,848,,11,0,11,806
849,849,,0,36,36,204
850,850,,10,11,21,46
851,851,,11,12,23,77
852,852,,8,0,8,77
853,853,,1,2,3,27
854,854,,0,5,5,46
855,855,,0,11,11,112
856,856,,14,9,23,46
857,857,,3,4,7,14
858,858,,4,5,9,46
859,859,,4,5,9,35
860,860,,6,8,14,260
861,861,,9,47,56,67
862,862,,12,12,24,316
863,863,,3,0,3,316
864,864,,0,1,1,260
865,865,,19,20,39,272
866,866,,4,0,4,272
867,867,,0,161,161,806
868,868,,0,3,3,256
869,869,,2,0,2,256
870,870,,50,41,91,260
871,871,,10,11,21,42
872,872,,0,115,115,141
873,873,,0,15,15,815
874,874,,17,18,35,29
875,875,,10,11,21,49
876,876,,0,3,3,73
877,877,,4,0,4,73
878,878,,0,191,191,805
879,879,,0,1,1,301
880,880,,4,0,4,301
881,881,,0,6,6,46
882,882,,9,10,19,56
883,883,,21,22,43,96
884,884,,21,22,43,39
885,885,,52,54,106,260
886,886,,54,55,109,813
887,887,,9,10,19,260
888,888,,0,37,37,67
889,889,,12,0,12,46
890,890,,0,5,5,46
891,891,,0,26,26,204
892,892,,4,0,4,204
893,893,,0,4,4,262
894,894,,7,0,7,262
895,895,,0,6,6,46
896,896,,0,1,1,812
897,897,,0,3,3,77
898,898,,5,0,5,77
899,899,,39,25,64,256
900,900,,37,52,89,17
901,901,,5,0,5,17
902,902,,0,64,64,204
903,903,,11,12,23,38
904,904,,4,2,6,73
905,905,,37,39,76,144
906,906,,0,1,1,41
907,907,,11,12,23,77
908,908,,19,20,39,46
909,909,,0,1,1,46
910,910,,0,3,3,73
911,911,,0,358,358,66
912,912,,62,1,63,26
913,913,,0,9,9,280
914,914,,3,0,3,280
915,915,,46,69,115,55
916,916,,37,38,75,12
917,917,,12,0,12,806
918,918,,5,2,7,37
919,919,,0,1,1,67
920,920,,3,4,7,27
921,921,,0,35,35,806
922,922,,0,1,1,46
923,923,,6,0,6,46
924,924,,0,4,4,280
925,925,,5,0,5,280
926,926,,6,7,13,144
927,927,,0,4,4,46
928,928,,3,0,3,46
929,929,,46,48,94,77
930,930,,8,9,17,280
931,931,,20,21,41,73
932,932,,31,32,63,31
933,933,,11,12,23,272
934,934,,0,35,35,804
935,935,,3,0,3,216
936,936,,7,8,15,21
937,937,,0,25,25,204
938,938,,37,38,75,152
939,939,,0,14,14,813
940,940,,4,0,4,813
941,941,,0,25,25,25
942,942,,0,1,1,272
943,943,,6,8,14,57
944,944,,50,52,102,171
945,945,,10,0,10,171
946,946,,0,4,4,46
947,947,,0,1,1,67
948,948,,37,38,75,73
949,949,,0,1,1,806
950,950,,0,1,1,46
951,951,,5,6,11,25
952,952,,0,10,10,33
953,953,,6,7,13,46
954,954,,8,9,17,216
955,955,,0,93,93,806
956,956,,24,25,49,37
957,957,,47,74,121,23
958,958,,0,2,2,46
959,959,,10,0,10,46
960,960,,5,47,52,3
961,961,,0,5,5,46
962,962,,21,22,43,47
963,963,,15,16,31,14
964,964,,17,4,21,280
965,965,,7,9,16,27
966,966,,0,16,16,204
967,967,,0,4,4,46
968,968,,0,9,9,813
969,969,,13,14,27,47
970,970,,0,3,3,25
971,971,,7,0,7,25
972,972,,4,72,76,171
973,973,,0,20,20,14
974,974,,0,10,10,46
975,975,,23,0,23,96
976,976,,0,1,1,171
977,977,,6,7,13,260
978,978,,0,1,1,90
979,979,,28,29,57,14
980,980,,0,37,37,187
981,981,,2,4,6,41
982,982,,23,24,47,133
983,983,,0,1,1,260
984,984,,21,22,43,34
985,985,,12,0,12,34
986,986,,4,5,9,272
987,987,,15,16,31,113
988,988,,10,11,21,77
989,989,,0,7,7,46
990,990,,0,4,4,46
991,991,,0,3,3,77
992,992,,14,15,29,280
993,993,,7,8,15,46
994,994,,0,159,159,806
995,995,,3,0,3,806
996,996,,32,33,65,44
997,997,,0,6,6,46
998,998,,0,168,168,806
999,999,,0,3,3,77
1000,1000,,0,1,1,21
1001,1001,,0,4,4,272
1002,1002,,0,2,2,42
1003,1003,,16,18,34,26
1004,1004,,11,0,11,804
1005,1005,,19,20,39,260
1006,1006,,5,0,5,260
1007,1007,,59,62,121,47
1008,1008,,10,0,10,804
1009,1009,,38,39,77,46
1010,1010,,49,12,61,262
1011,1011,,0,5,5,46
1012,1012,,0,53,53,121
1013,1013,,30,31,61,33
1014,1014,,0,1,1,113
1015,1015,,71,31,102,113
1016,1016,,26,4,30,46
1017,1017,,2,3,5,813
1018,1018,,4,6,10,29
1019,1019,,0,5,5,216
1020,1020,,2,0,2,216
1021,1021,,0,3,3,96
1022,1022,,10,11,21,144
1023,1023,,0,5,5,46
1024,1024,,10,3,13,30
1025,1025,,0,12,12,804
1026,1026,,3,0,3,58
1027,1027,,0,1,1,46
1028,1028,,16,0,16,46
1029,1029,,40,42,82,19
1030,1030,,54,55,109,124
1031,1031,,7,8,15,74
1032,1032,,3,0,3,74
1033,1033,,7,8,15,57
1034,1034,,0,3,3,67
1035,1035,,14,15,29,14
1036,1036,,21,22,43,30
1037,1037,,28,29,57,14
1038,1038,,62,64,126,260
1039,1039,,19,20,39,260
1040,1040,,3,0,3,260
1041,1041,,0,1,1,19
1042,1042,,10,0,10,19
1043,1043,,0,3,3,46
1044,1044,,6,0,6,46
1045,1045,,0,2,2,804
1046,1046,,22,23,45,256
1047,1047,,3,0,3,256
1048,1048,,0,5,5,46
1049,1049,,0,19,19,804
1050,1050,,58,60,118,40
1051,1051,,0,1,1,67
1052,1052,,3,0,3,67
1053,1053,,0,7,7,280
1054,1054,,0,5,5,67
1055,1055,,0,2,2,33
1056,1056,,0,14,14,216
1057,1057,,2,19,21,27
1058,1058,,0,3,3,67
1059,1059,,0,15,15,216
1060,1060,,3,0,3,216
1061,1061,,0,55,55,58
1062,1062,,0,5,5,46
1063,1063,,17,18,35,152
1064,1064,,0,3,3,77
1065,1065,,5,0,5,77
1066,1066,,0,3,3,42
1067,1067,,0,2,2,204
1068,1068,,21,22,43,19
1069,1069,,19,27,46,96
1070,1070,,87,89,176,43
1071,1071,,5,0,5,43
1072,1072,,0,54,54,204
1073,1073,,0,5,5,46
1074,1074,,3,4,7,21
1075,1075,,6,7,13,27
1076,1076,,0,3,3,301
1077,1077,,3,0,3,301
1078,1078,,0,1,1,46
1079,1079,,0,89,89,216
1080,1080,,3,0,3,39
1081,1081,,24,3,27,280
1082,1082,,0,4,4,46
1083,1083,,35,36,71,56
1084,1084,,0,1,1,260
1085,1085,,0,43,43,216
1086,1086,,24,25,49,27
1087,1087,,0,34,34,90
1088,1088,,6,7,13,74
1089,1089,,0,4,4,46
1090,1090,,13,14,27,260
1091,1091,,0,3,3,77
1092,1092,,4,0,4,77
1093,1093,,41,43,84,58
1094,1094,,2,0,2,58
1095,1095,,38,39,77,804
1096,1096,,31,32,63,46
1097,1097,,0,1,1,260
1098,1098,,2,3,5,260
1099,1099,,36,37,73,0
1100,1100,,0,1,1,113
1101,1101,,23,25,48,46
1102,1102,,0,16,16,31
1103,1103,,3,0,3,31
1104,1104,,5,44,49,40
1105,1105,,66,15,81,47
1106,1106,,12,13,25,272
1107,1107,,0,4,4,46
1108,1108,,2,3,5,260
1109,1109,,0,5,5,27
1110,1110,,3,0,3,27
1111,1111,,0,2,2,260
1112,1112,,16,17,33,56
1113,1113,,0,4,4,46
1114,1114,,12,13,25,41
1115,1115,,7,0,7,41
1116,1116,,0,47,47,813
1117,1117,,356,358,714,7
1118,1118,,4,0,4,7
1119,1119,,40,41,81,280
1120,1120,,11,0,11,46
1121,1121,,54,55,109,280
1122,1122,,36,38,74,30
1123,1123,,47,48,95,46
1124,1124,,0,25,25,38
1125,1125,,0,3,3,46
1126,1126,,61,38,99,316
1127,1127,,0,24,24,204
1128,1128,,0,4,4,46
1129,1129,,25,26,51,30
1130,1130,,8,0,8,46
1131,1131,,3,4,7,27
1132,1132,,8,9,17,19
1133,1133,,0,3,3,47
1134,1134,,0,3,3,67
1135,1135,,3,0,3,67
1136,1136,,0,28,28,124
1137,1137,,0,7,7,46
1138,1138,,0,3,3,113
1139,1139,,65,66,131,256
1140,1140,,0,23,23,806
1141,1141,,0,4,4,46
1142,1142,,3,0,3,46
1143,1143,,0,5,5,77
1144,1144,,9,0,9,77
1145,1145,,9,10,19,29
1146,1146,,16,18,34,67
1147,1147,,8,9,17,96
1148,1148,,11,12,23,77
1149,1149,,16,17,33,73
1150,1150,,0,3,3,216
1151,1151,,7,8,15,216
1152,1152,,0,31,31,216
1153,1153,,3,0,3,40
1154,1154,,57,58,115,4
1155,1155,,0,1,1,243
1156,1156,,3,0,3,243
1157,1157,,0,4,4,301
1158,1158,,4,0,4,301
1159,1159,,11,12,23,144
1160,1160,,0,5,5,152
1161,1161,,63,66,129,280
1162,1162,,0,2,2,152
1163,1163,,9,30,39,44
1164,1164,,10,0,10,44
1165,1165,,6,7,13,27
1166,1166,,13,102,115,28
1167,1167,,13,15,28,46
1168,1168,,0,100,100,806
1169,1169,,0,3,3,73
1170,1170,,0,3,3,46
1171,1171,,9,10,19,35
1172,1172,,8,9,17,113
1173,1173,,3,0,3,113
1174,1174,,0,37,37,255
1175,1175,,0,192,192,806
1176,1176,,3,0,3,806
1177,1177,,17,18,35,67
1178,1178,,5,0,5,67
1179,1179,,0,5,5,46
1180,1180,,85,87,172,44
1181,1181,,11,12,23,46
1182,1182,,22,24,46,43
1183,1183,,1,3,4,27
1184,1184,,0,1,1,67
1185,1185,,0,22,22,204
1186,1186,,5,6,11,813
1187,1187,,20,21,41,42
1188,1188,,0,1,1,46
1189,1189,,28,31,59,46
1190,1190,,0,2,2,272
1191,1191,,1,2,3,21
1192,1192,,0,3,3,46
1193,1193,,11,20,31,14
1194,1194,,0,56,56,204
1195,1195,,44,45,89,46
1196,1196,,91,93,184,77
1197,1197,,0,1,1,30
1198,1198,,4,0,4,30
1199,1199,,0,3,3,260
1200,1200,,0,1,1,77
1201,1201,,20,21,41,67
1202,1202,,5,7,12,14
1203,1203,,0,2,2,259
1204,1204,,3,0,3,259
1205,1205,,0,56,56,40
1206,1206,,0,12,12,14
1207,1207,,0,1,1,804
1208,1208,,0,203,203,806
1209,1209,,3,0,3,806
1210,1210,,30,31,61,260
1211,1211,,3,68,71,30
1212,1212,,6,7,13,316
1213,1213,,31,33,64,29
1214,1214,,2,3,5,46
1215,1215,,0,1,1,255
1216,1216,,0,4,4,67
1217,1217,,0,3,3,46
1218,1218,,2,20,22,96
1219,1219,,0,4,4,79
1220,1220,,0,197,197,806
1221,1221,,6,7,13,57
1222,1222,,7,0,7,57
1223,1223,,2,14,16,47
1224,1224,,9,0,9,259
1225,1225,,10,11,21,216
1226,1226,,0,1,1,27
1227,1227,,0,3,3,90
1228,1228,,0,29,29,22
1229,1229,,5,0,5,22
1230,1230,,45,46,91,5
1231,1231,,19,21,40,42
1232,1232,,42,43,85,74
1233,1233,,0,29,29,804
1234,1234,,7,8,15,46
1235,1235,,24,26,50,27
1236,1236,,0,3,3,204
1237,1237,,0,22,22,216
1238,1238,,55,35,90,19
1239,1239,,0,3,3,316
1240,1240,,0,3,3,171
1241,1241,,5,0,5,171
1242,1242,,0,15,15,216
1243,1243,,4,0,4,216
1244,1244,,44,46,90,67
1245,1245,,0,3,3,74
1246,1246,,0,4,4,46
1247,1247,,62,25,87,27
1248,1248,,0,1,1,21
1249,1249,,88,89,177,259
1250,1250,,0,3,3,113
1251,1251,,0,5,5,46
1252,1252,,0,1,1,316
1253,1253,,0,3,3,46
1254,1254,,2,3,5,96
1255,1255,,0,1,1,14
1256,1256,,8,9,17,41
1257,1257,,0,151,151,65
1258,1258,,0,3,3,67
1259,1259,,38,42,80,34
1260,1260,,5,2,7,44
1261,1261,,0,2,2,29
1262,1262,,86,83,169,6
1263,1263,,10,11,21,216
1264,1264,,25,26,51,67
1265,1265,,0,4,4,41
1266,1266,,7,0,7,41
1267,1267,,0,6,6,46
1268,1268,,30,31,61,260
1269,1269,,1,2,3,77
1270,1270,,49,5,54,15
1271,1271,,13,14,27,25
1272,1272,,5,0,5,25
1273,1273,,0,2,2,46
1274,1274,,0,2,2,73
1275,1275,,0,45,45,804
1276,1276,,0,1,1,46
1277,1277,,5,0,5,46
1278,1278,,39,27,66,49
1279,1279,,45,124,169,55
1280,1280,,0,7,7,46
1281,1281,,3,4,7,813
1282,1282,,13,15,28,44
1283,1283,,63,64,127,67
1284,1284,,0,3,3,67
1285,1285,,7,8,15,77
1286,1286,,31,32,63,29
1287,1287,,7,0,7,29
1288,1288,,17,18,35,124
1289,1289,,6,0,6,124
1290,1290,,2,1,3,67
1291,1291,,0,49,49,804
1292,1292,,5,0,5,50
1293,1293,,98,100,198,59
1294,1294,,0,52,52,90
1295,1295,,0,4,4,46
1296,1296,,0,227,227,804
1297,1297,,0,5,5,46
1298,1298,,0,4,4,33
1299,1299,,35,36,71,34
1300,1300,,4,5,9,260
1301,1301,,1,2,3,813
1302,1302,,0,1,1,29
1303,1303,,7,0,7,29
1304,1304,,0,1,1,260
1305,1305,,36,37,73,55
1306,1306,,0,17,17,216
1307,1307,,0,5,5,46
1308,1308,,39,40,79,30
1309,1309,,8,9,17,30
1310,1310,,0,4,4,46
1311,1311,,0,3,3,27
1312,1312,,0,1,1,14
1313,1313,,0,18,18,216
1314,1314,,0,3,3,58
1315,1315,,0,13,13,804
1316,1316,,3,0,3,804
1317,1317,,0,1,1,67
1318,1318,,9,11,20,30
1319,1319,,6,7,13,171
1320,1320,,5,6,11,77
1321,1321,,0,3,3,259
1322,1322,,5,6,11,27
1323,1323,,0,10,10,216
1324,1324,,4,0,4,39
1325,1325,,0,3,3,27
1326,1326,,49,50,99,51
1327,1327,,3,0,3,51
1328,1328,,0,138,138,804
1329,1329,,4,0,4,804
1330,1330,,3,4,7,27
1331,1331,,5,7,12,46
1332,1332,,55,56,111,73
1333,1333,,5,6,11,46
1334,1334,,20,22,42,280
1335,1335,,3,0,3,280
1336,1336,,0,2,2,239
1337,1337,,3,0,3,239
1338,1338,,0,7,7,204
1339,1339,,0,63,63,40
1340,1340,,4,0,4,50
1341,1341,,100,15,115,28
1342,1342,,0,1,1,46
1343,1343,,0,1,1,316
1344,1344,,4,0,4,316
1345,1345,,6,7,13,46
1346,1346,,0,7,7,216
1347,1347,,0,2,2,280
1348,1348,,0,4,4,46
1349,1349,,4,0,4,46
1350,1350,,2,47,49,255
1351,1351,,7,8,15,813
1352,1352,,12,13,25,272
1353,1353,,0,1,1,33
1354,1354,,72,73,145,260
1355,1355,,0,57,57,813
1356,1356,,0,4,4,46
1357,1357,,5,0,5,46
1358,1358,,0,2,2,67
1359,1359,,0,7,7,46
1360,1360,,0,3,3,40
1361,1361,,18,0,18,46
1362,1362,,5,6,11,27
1363,1363,,0,6,6,46
1364,1364,,7,8,15,51
1365,1365,,27,17,44,46
1366,1366,,0,4,4,46
1367,1367,,5,6,11,49
1368,1368,,0,33,33,22
1369,1369,,0,3,3,55
1370,1370,,9,10,19,41
1371,1371,,0,1,1,27
1372,1372,,85,83,168,33
1373,1373,,28,29,57,260
1374,1374,,0,18,18,813
1375,1375,,12,20,32,272
1376,1376,,0,34,34,815
1377,1377,,178,2,180,7
1378,1378,,77,16,93,8
1379,1379,,44,138,182,29
1380,1380,,0,3,3,46
1381,1381,,0,3,3,46
1382,1382,,0,29,29,42
1383,1383,,0,4,4,42
1384,1384,,16,17,33,59
1385,1385,,13,0,13,59
1386,1386,,0,5,5,46
1387,1387,,0,4,4,46
1388,1388,,0,5,5,46
1389,1389,,14,5,19,30
1390,1390,,0,3,3,46
1391,1391,,0,5,5,46
1392,1392,,0,3,3,73
1393,1393,,5,0,5,73
1394,1394,,11,13,24,41
1395,1395,,3,4,7,301
1396,1396,,0,5,5,46
1397,1397,,0,54,54,204
1398,1398,,13,14,27,49
1399,1399,,54,56,110,144
1400,1400,,6,7,13,25
1401,1401,,4,0,4,25
1402,1402,,35,36,71,124
1403,1403,,5,0,5,124
1404,1404,,0,10,10,46
1405,1405,,5,0,5,19
1406,1406,,9,10,19,0
1407,1407,,0,4,4,44
1408,1408,,36,38,74,29
1409,1409,,0,96,96,216
1410,1410,,0,7,7,812
1411,1411,,0,87,87,90
1412,1412,,36,37,73,187
1413,1413,,7,0,7,187
1414,1414,,0,4,4,260
1415,1415,,25,26,51,113
1416,1416,,28,29,57,55
1417,1417,,5,0,5,55
1418,1418,,5,6,11,46
1419,1419,,7,8,15,14
1420,1420,,0,4,4,46
1421,1421,,3,0,3,46
1422,1422,,26,27,53,9
1423,1423,,42,44,86,47
1424,1424,,0,3,3,67
1425,1425,,3,0,3,67
1426,1426,,0,3,3,804
1427,1427,,0,9,9,77
1428,1428,,3,0,3,77
1429,1429,,0,207,207,806
1430,1430,,0,116,116,34
1431,1431,,0,3,3,67
1432,1432,,4,0,4,67
1433,1433,,0,2,2,90
1434,1434,,0,45,45,215
1435,1435,,0,1,1,260
1436,1436,,16,17,33,35
1437,1437,,3,0,3,35
1438,1438,,0,1,1,73
1439,1439,,4,0,4,73
1440,1440,,2,4,6,57
1441,1441,,0,3,3,46
1442,1442,,2,3,5,47
1443,1443,,0,17,17,14
1444,1444,,0,1,1,804
1445,1445,,92,33,125,260
1446,1446,,9,10,19,0
1447,1447,,44,10,54,27
1448,1448,,0,3,3,77
1449,1449,,14,19,33,152
1450,1450,,3,0,3,152
1451,1451,,0,3,3,113
1452,1452,,76,47,123,113
1453,1453,,3,4,7,144
1454,1454,,5,0,5,152
1455,1455,,17,18,35,46
1456,1456,,34,102,136,804
1457,1457,,0,5,5,260
1458,1458,,6,0,6,74
1459,1459,,0,6,6,46
1460,1460,,14,15,29,77
1461,1461,,0,5,5,46
1462,1462,,0,3,3,124
1463,1463,,0,8,8,46
1464,1464,,0,2,2,41
1465,1465,,20,21,41,67
1466,1466,,3,4,7,262
1467,1467,,14,15,29,272
1468,1468,,0,177,177,804
1469,1469,,3,0,3,804
1470,1470,,36,37,73,27
1471,1471,,4,6,10,79
1472,1472,,0,1,1,113
1473,1473,,0,1,1,90
1474,1474,,10,12,22,280
1475,1475,,6,7,13,27
1476,1476,,0,1,1,46
1477,1477,,39,40,79,67
1478,1478,,28,0,28,44
1479,1479,,7,8,15,26
1480,1480,,10,11,21,43
1481,1481,,3,4,7,260
1482,1482,,0,1,1,46
1483,1483,,3,0,3,46
1484,1484,,0,4,4,46
1485,1485,,0,3,3,67
1486,1486,,0,1,1,124
1487,1487,,4,0,4,124
1488,1488,,58,59,117,10
1489,1489,,0,4,4,46
1490,1490,,0,41,41,46
1491,1491,,0,3,3,46
1492,1492,,0,3,3,81
1493,1493,,9,0,9,81
1494,1494,,2,44,46,44
1495,1495,,0,8,8,46
1496,1496,,0,3,3,74
1497,1497,,0,5,5,46
1498,1498,,7,8,15,46
1499,1499,,0,1,1,77
1500,1500,,37,137,174,316
1501,1501,,0,4,4,46
1502,1502,,0,8,8,77
1503,1503,,0,2,2,216
1504,1504,,12,13,25,46
1505,1505,,0,17,17,813
1506,1506,,51,38,89,17
1507,1507,,4,6,10,57
1508,1508,,30,3,33,262
1509,1509,,0,3,3,216
1510,1510,,0,189,189,806
1511,1511,,3,2,5,216
1512,1512,,53,54,107,67
1513,1513,,8,15,23,46
1514,1514,,9,10,19,280
1515,1515,,0,4,4,46
1516,1516,,0,3,3,301
1517,1517,,0,18,18,239
1518,1518,,4,0,4,55
1519,1519,,0,1,1,38
1520,1520,,29,30,59,27
1521,1521,,0,5,5,40
1522,1522,,0,4,4,67
1523,1523,,0,5,5,33
1524,1524,,0,5,5,46
1525,1525,,10,11,21,316
1526,1526,,0,5,5,316
1527,1527,,41,43,84,30
1528,1528,,0,1,1,29
1529,1529,,0,110,110,11
1530,1530,,0,12,12,187
1531,1531,,15,16,31,77
1532,1532,,0,20,20,124
1533,1533,,28,41,69,804
1534,1534,,37,38,75,12
1535,1535,,0,207,207,806
1536,1536,,6,7,13,260
1537,1537,,21,22,43,260
1538,1538,,7,0,7,260
1539,1539,,0,1,1,113
1540,1540,,3,0,3,113
1541,1541,,0,3,3,46
1542,1542,,22,23,45,77
1543,1543,,33,111,144,32
1544,1544,,63,65,128,14
1545,1545,,0,3,3,67
1546,1546,,39,15,54,56
1547,1547,,3,0,3,56
1548,1548,,10,11,21,55
1549,1549,,0,3,3,301
1550,1550,,0,38,38,216
1551,1551,,0,5,5,46
1552,1552,,0,3,3,152
1553,1553,,0,1,1,204
1554,1554,,0,3,3,44
1555,1555,,0,3,3,53
1556,1556,,3,0,3,53
1557,1557,,0,101,101,806
1558,1558,,11,12,23,27
1559,1559,,14,15,29,272
1560,1560,,67,19,86,35
1561,1561,,3,0,3,35
1562,1562,,21,52,73,46
1563,1563,,0,4,4,46
1564,1564,,13,8,21,73
1565,1565,,12,13,25,67
1566,1566,,0,62,62,815
1567,1567,,0,1,1,260
1568,1568,,89,56,145,37
1569,1569,,4,0,4,37
1570,1570,,6,7,13,260
1571,1571,,0,1,1,804
1572,1572,,6,0,6,804
1573,1573,,0,23,23,813
1574,1574,,0,55,55,804
1575,1575,,0,3,3,260
1576,1576,,0,1,1,815
1577,1577,,7,0,7,815
1578,1578,,0,3,3,46
1579,1579,,0,34,34,14
1580,1580,,3,0,3,216
1581,1581,,4,5,9,21
1582,1582,,4,5,9,27
1583,1583,,41,42,83,81
1584,1584,,0,3,3,29
1585,1585,,0,4,4,19
1586,1586,,14,7,21,41
1587,1587,,0,51,51,804
1588,1588,,0,2,2,260
1589,1589,,11,1,12,152
1590,1590,,2,3,5,316
1591,1591,,11,81,92,14
1592,1592,,0,3,3,79
1593,1593,,0,3,3,46
1594,1594,,0,3,3,44
1595,1595,,4,6,10,81
1596,1596,,3,0,3,81
1597,1597,,26,27,53,59
1598,1598,,30,2,32,27
1599,1599,,51,52,103,34
1600,1600,,10,11,21,21
1601,1601,,2,5,7,152
1602,1602,,0,3,3,133
1603,1603,,3,178,181,133
1604,1604,,71,73,144,26
1605,1605,,0,7,7,113
1606,1606,,14,15,29,46
1607,1607,,0,1,1,259
1608,1608,,42,43,85,73
1609,1609,,0,3,3,41
1610,1610,,20,19,39,27
1611,1611,,0,3,3,187
1612,1612,,35,37,72,144
1613,1613,,0,21,21,216
1614,1614,,21,22,43,39
1615,1615,,73,42,115,57
1616,1616,,0,1,1,41
1617,1617,,4,0,4,41
1618,1618,,7,16,23,37
1619,1619,,0,2,2,272
1620,1620,,53,50,103,280
1621,1621,,0,3,3,67
1622,1622,,7,0,7,67
1623,1623,,0,1,1,216
1624,1624,,3,8,11,46
1625,1625,,0,344,344,815
1626,1626,,20,21,41,38
1627,1627,,14,15,29,67
1628,1628,,0,3,3,46
1629,1629,,9,10,19,280
1630,1630,,7,8,15,804
1631,1631,,35,36,71,124
1632,1632,,1,2,3,260
1633,1633,,0,296,296,806
1634,1634,,0,7,7,46
1635,1635,,0,2,2,46
1636,1636,,5,0,5,46
1637,1637,,28,29,57,260
1638,1638,,0,1,1,216
1639,1639,,0,4,4,46
1640,1640,,0,2,2,815
1641,1641,,3,0,3,815
1642,1642,,70,71,141,260
1643,1643,,28,29,57,256
1644,1644,,36,37,73,29
1645,1645,,0,20,20,813
1646,1646,,0,87,87,804
1647,1647,,0,38,38,813
1648,1648,,0,6,6,46
1649,1649,,1,2,3,804
1650,1650,,0,15,15,204
1651,1651,,0,30,30,813
1652,1652,,44,45,89,46
1653,1653,,0,4,4,46
1654,1654,,4,0,4,113
1655,1655,,0,4,4,301
1656,1656,,20,21,41,96
1657,1657,,0,2,2,272
1658,1658,,8,9,17,144
1659,1659,,7,0,7,144
1660,1660,,0,1,1,33
1661,1661,,0,2,2,96
1662,1662,,28,30,58,215
1663,1663,,1,2,3,46
1664,1664,,1,0,1,46
1665,1665,,23,25,48,73
1666,1666,,0,3,3,152
1667,1667,,16,0,16,46
1668,1668,,10,11,21,46
1669,1669,,0,18,18,204
1670,1670,,0,6,6,74
1671,1671,,0,10,10,804
1672,1672,,0,18,18,14
1673,1673,,0,2,2,216
1674,1674,,5,0,5,216
1675,1675,,0,67,67,204
1676,1676,,4,5,9,39
1677,1677,,0,1,1,46
1678,1678,,1,3,4,280
1679,1679,,0,31,31,216
1680,1680,,0,1,1,2
1681,1681,,0,1,1,77
1682,1682,,29,30,59,272
1683,1683,,0,1,1,21
1684,1684,,7,10,17,37
1685,1685,,1,2,3,813
1686,1686,,66,4,70,30
1687,1687,,0,1,1,21
1688,1688,,0,6,6,46
1689,1689,,0,3,3,152
1690,1690,,5,6,11,77
1691,1691,,0,5,5,79
1692,1692,,0,5,5,46
1693,1693,,0,3,3,152
1694,1694,,0,3,3,112
1695,1695,,28,29,57,46
1696,1696,,3,0,3,46
1697,1697,,5,6,11,25
1698,1698,,0,1,1,42
1699,1699,,0,54,54,813
1700,1700,,39,40,79,113
1701,1701,,0,7,7,46
1702,1702,,0,1,1,813
1703,1703,,7,8,15,260
1704,1704,,2,0,2,260
1705,1705,,0,6,6,230
1706,1706,,3,4,7,27
1707,1707,,37,38,75,260
1708,1708,,6,7,13,113
1709,1709,,0,3,3,152
1710,1710,,8,9,17,55
1711,1711,,15,16,31,50
1712,1712,,0,5,5,46
1713,1713,,36,38,74,21
1714,1714,,0,114,114,216
1715,1715,,6,7,13,27
1716,1716,,51,52,103,256
1717,1717,,0,1,1,272
1718,1718,,69,70,139,42
1719,1719,,4,13,17,144
1720,1720,,8,9,17,260
1721,1721,,0,9,9,46
1722,1722,,12,13,25,39
1723,1723,,4,0,4,39
1724,1724,,0,5,5,260
1725,1725,,6,7,13,27
1726,1726,,0,7,7,46
1727,1727,,0,6,6,46
1728,1728,,0,3,3,67
1729,1729,,0,3,3,46
1730,1730,,107,2,109,34
1731,1731,,0,3,3,74
1732,1732,,23,24,47,35
1733,1733,,7,63,70,19
1734,1734,,0,4,4,113
1735,1735,,0,35,35,204
1736,1736,,0,41,41,804
1737,1737,,0,1,1,260
1738,1738,,57,77,134,44
1739,1739,,0,1,1,14
1740,1740,,28,29,57,25
1741,1741,,10,11,21,26
1742,1742,,0,1,1,251
1743,1743,,3,0,3,251
1744,1744,,0,177,177,804
1745,1745,,11,13,24,260
1746,1746,,0,6,6,46
1747,1747,,0,17,17,204
1748,1748,,0,18,18,204
1749,1749,,4,9,13,26
1750,1750,,0,3,3,77
1751,1751,,9,11,20,67
1752,1752,,44,46,90,812
1753,1753,,10,0,10,812
1754,1754,,0,169,169,108
1755,1755,,15,16,31,113
1756,1756,,39,32,71,262
1757,1757,,0,1,1,27
1758,1758,,0,6,6,216
1759,1759,,0,10,10,230
1760,1760,,42,43,85,74
1761,1761,,0,1,1,90
1762,1762,,45,47,92,59
1763,1763,,0,2,2,27
1764,1764,,42,19,61,27
1765,1765,,0,9,9,204
1766,1766,,63,65,128,55
1767,1767,,0,34,34,216
1768,1768,,0,2,2,14
1769,1769,,0,3,3,77
1770,1770,,0,3,3,46
1771,1771,,0,3,3,67
1772,1772,,0,3,3,112
1773,1773,,0,4,4,67
1774,1774,,43,45,88,216
1775,1775,,0,6,6,46
1776,1776,,41,32,73,19
1777,1777,,21,22,43,113
1778,1778,,6,7,13,272
1779,1779,,21,23,44,67
1780,1780,,0,9,9,14
1781,1781,,19,20,39,215
1782,1782,,17,18,35,44
1783,1783,,0,56,56,90
1784,1784,,0,42,42,813
1785,1785,,0,158,158,806
1786,1786,,0,3,3,113
1787,1787,,29,10,39,44
1788,1788,,0,2,2,260
1789,1789,,0,221,221,806
1790,1790,,71,73,144,26
1791,1791,,0,3,3,260
1792,1792,,10,46,56,47
1793,1793,,0,6,6,46
1794,1794,,59,60,119,14
1795,1795,,0,4,4,46
1796,1796,,0,3,3,77
1797,1797,,7,8,15,30
1798,1798,,0,3,3,813
1799,1799,,0,1,1,27
1800,1800,,0,2,2,30
1801,1801,,108,49,157,47
1802,1802,,31,108,139,260
1803,1803,,12,13,25,27
1804,1804,,0,64,64,815
1805,1805,,0,44,44,216
1806,1806,,0,2,2,215
1807,1807,,3,0,3,215
1808,1808,,3,4,7,44
1809,1809,,0,2,2,73
1810,1810,,0,45,45,804
1811,1811,,0,1,1,77
1812,1812,,54,55,109,804
1813,1813,,0,54,54,813
1814,1814,,20,21,41,96
1815,1815,,12,13,25,133
1816,1816,,0,2,2,133
1817,1817,,3,0,3,133
1818,1818,,0,1,1,26
1819,1819,,0,1,1,113
1820,1820,,3,0,3,113
1821,1821,,0,2,2,46
1822,1822,,11,12,23,144
1823,1823,,0,3,3,67
1824,1824,,0,1,1,113
1825,1825,,0,2,2,280
1826,1826,,0,4,4,216
1827,1827,,0,19,19,215
1828,1828,,0,3,3,18
1829,1829,,4,0,4,18
1830,1830,,0,3,3,41
1831,1831,,0,1,1,2
1832,1832,,6,7,13,30
1833,1833,,20,21,41,113
1834,1834,,0,7,7,204
1835,1835,,3,0,3,204
1836,1836,,70,71,141,27
1837,1837,,0,4,4,239
1838,1838,,25,26,51,255
1839,1839,,11,12,23,256
1840,1840,,6,9,15,152
1841,1841,,0,1,1,256
1842,1842,,0,5,5,46
1843,1843,,17,69,86,35
1844,1844,,8,0,8,35
1845,1845,,0,1,1,124
1846,1846,,34,34,68,272
1847,1847,,22,24,46,256
1848,1848,,0,31,31,815
1849,1849,,52,53,105,50
1850,1850,,0,5,5,46
1851,1851,,1,2,3,260
1852,1852,,98,99,197,13
1853,1853,,5,19,24,30
1854,1854,,0,6,6,46
1855,1855,,0,4,4,46
1856,1856,,7,8,15,171
1857,1857,,0,5,5,804
1858,1858,,0,170,170,90
1859,1859,,0,3,3,46
1860,1860,,19,20,39,42
1861,1861,,7,40,47,216
1862,1862,,49,50,99,67
1863,1863,,21,22,43,255
1864,1864,,0,99,99,806
1865,1865,,25,26,51,30
1866,1866,,20,21,41,73
1867,1867,,0,4,4,259
1868,1868,,2,3,5,55
1869,1869,,0,22,22,21
1870,1870,,0,4,4,46
1871,1871,,0,2,2,260
1872,1872,,40,41,81,19
1873,1873,,47,49,96,260
1874,1874,,29,3,32,19
1875,1875,,5,6,11,39
1876,1876,,0,1,1,46
1877,1877,,0,1,1,46
1878,1878,,14,15,29,272
1879,1879,,6,7,13,46
1880,1880,,7,0,7,46
1881,1881,,0,1,1,113
1882,1882,,40,41,81,280
1883,1883,,0,4,4,46
1884,1884,,0,3,3,41
1885,1885,,0,1,1,19
1886,1886,,46,48,94,27
1887,1887,,0,6,6,46
1888,1888,,0,8,8,255
1889,1889,,23,24,47,58
1890,1890,,0,1,1,67
1891,1891,,18,24,42,255
1892,1892,,1,2,3,29
1893,1893,,4,5,9,26
1894,1894,,0,1,1,0
1895,1895,,25,1,26,272
1896,1896,,0,3,3,171
1897,1897,,0,3,3,113
1898,1898,,0,4,4,255
1899,1899,,24,25,49,37
1900,1900,,0,4,4,46
1901,1901,,0,61,61,74
1902,1902,,3,0,3,74
1903,1903,,0,1,1,96
1904,1904,,0,3,3,46
1905,1905,,0,54,54,40
1906,1906,,13,15,28,49
1907,1907,,0,3,3,27
1908,1908,,0,5,5,804
1909,1909,,0,49,49,804
1910,1910,,36,37,73,46
1911,1911,,0,3,3,42
1912,1912,,0,8,8,25
1913,1913,,0,5,5,46
1914,1914,,0,4,4,46
1915,1915,,0,2,2,46
1916,1916,,3,4,7,26
1917,1917,,18,19,37,67
1918,1918,,3,4,7,260
1919,1919,,1,3,4,46
1920,1920,,0,13,13,804
1921,1921,,26,27,53,77
1922,1922,,0,3,3,67
1923,1923,,21,22,43,90
1924,1924,,0,27,27,67
1925,1925,,10,11,21,260
1926,1926,,7,8,15,171
1927,1927,,0,2,2,272
1928,1928,,14,15,29,112
1929,1929,,7,0,7,112
1930,1930,,17,23,40,44
1931,1931,,0,4,4,46
1932,1932,,7,6,13,255
1933,1933,,0,4,4,46
1934,1934,,5,0,5,171
1935,1935,,26,28,54,152
1936,1936,,0,3,3,38
1937,1937,,0,3,3,113
1938,1938,,0,3,3,46
1939,1939,,7,6,13,39
1940,1940,,21,22,43,215
1941,1941,,33,34,67,216
1942,1942,,0,51,51,40
1943,1943,,6,7,13,46
1944,1944,,0,3,3,280
1945,1945,,4,0,4,280
1946,1946,,14,15,29,19
1947,1947,,0,1,1,204
1948,1948,,6,7,13,90
1949,1949,,10,11,21,25
1950,1950,,0,3,3,46
1951,1951,,3,4,7,46
1952,1952,,0,1,1,216
1953,1953,,3,0,3,216
1954,1954,,24,25,49,49
1955,1955,,0,4,4,804
1956,1956,,2,0,2,804
1957,1957,,3,4,7,262
1958,1958,,7,4,11,46
1959,1959,,0,9,9,813
1960,1960,,0,7,7,46
1961,1961,,0,2,2,46
1962,1962,,0,1,1,46
1963,1963,,0,4,4,74
1964,1964,,3,4,7,67
1965,1965,,0,1,1,53
1966,1966,,0,5,5,46
1967,1967,,0,3,3,27
1968,1968,,15,16,31,813
1969,1969,,0,128,128,806
1970,1970,,20,21,41,42
1971,1971,,69,2,71,316
1972,1972,,47,49,96,81
1973,1973,,0,3,3,67
1974,1974,,0,180,180,804
1975,1975,,49,41,90,215
1976,1976,,0,4,4,262
1977,1977,,0,6,6,46
1978,1978,,47,48,95,260
1979,1979,,0,300,300,812
1980,1980,,0,53,53,152
1981,1981,,8,9,17,46
1982,1982,,8,0,8,46
1983,1983,,63,64,127,14
1984,1984,,20,21,41,38
1985,1985,,0,1,1,301
1986,1986,,0,36,36,804
1987,1987,,2,4,6,57
1988,1988,,59,60,119,14
1989,1989,,45,78,123,113
1990,1990,,0,1,1,171
1991,1991,,0,1,1,260
1992,1992,,76,152,228,815
1993,1993,,0,7,7,46
1994,1994,,0,3,3,73
1995,1995,,4,5,9,260
1996,1996,,15,9,24,96
1997,1997,,51,53,104,67
1998,1998,,33,35,68,272
1999,1999,,0,3,3,272
2000,2000,,0,10,10,46
2001,2001,,0,56,56,46
2002,2002,,1,75,76,49
2003,2003,,0,27,27,152
2004,2004,,6,0,6,152
2005,2005,,0,11,11,14
2006,2006,,1,2,3,14
2007,2007,,12,11,23,46
2008,2008,,3,6,9,41
2009,2009,,4,0,4,77
2010,2010,,0,207,207,806
2011,2011,,9,11,20,58
2012,2012,,0,4,4,46
2013,2013,,0,1,1,27
2014,2014,,26,27,53,27
2015,2015,,0,15,15,815
2016,2016,,22,23,45,46
2017,2017,,0,7,7,204
2018,2018,,19,21,40,260
2019,2019,,0,1,1,44
2020,2020,,0,2,2,26
2021,2021,,0,7,7,33
2022,2022,,0,3,3,35
2023,2023,,0,6,6,46
2024,2024,,11,13,24,15
2025,2025,,0,9,9,30
2026,2026,,23,24,47,815
2027,2027,,0,3,3,113
2028,2028,,6,14,20,27
2029,2029,,0,16,16,204
2030,2030,,45,46,91,77
2031,2031,,7,8,15,77
2032,2032,,0,3,3,112
2033,2033,,0,2,2,67
2034,2034,,32,33,65,280
2035,2035,,0,1,1,316
2036,2036,,0,30,30,77
2037,2037,,0,187,187,806
2038,2038,,0,67,67,204
2039,2039,,11,12,23,30
2040,2040,,0,1,1,67
2041,2041,,0,43,43,81
2042,2042,,3,4,7,44
2043,2043,,22,66,88,27
2044,2044,,0,3,3,42
2045,2045,,20,21,41,73
2046,2046,,59,60,119,16
2047,2047,,23,24,47,260
2048,2048,,0,67,67,255
2049,2049,,3,0,3,41
2050,2050,,12,6,18,55
2051,2051,,0,25,25,804
2052,2052,,0,286,286,806
2053,2053,,3,0,3,46
2054,2054,,0,6,6,243
2055,2055,,3,4,7,90
2056,2056,,0,1,1,43
2057,2057,,0,15,15,152
2058,2058,,0,64,64,804
2059,2059,,4,0,4,804
2060,2060,,19,13,32,67
2061,2061,,0,5,5,171
2062,2062,,0,4,4,46
2063,2063,,2,3,5,67
2064,2064,,0,5,5,46
2065,2065,,21,22,43,113
2066,2066,,0,3,3,46
2067,2067,,11,12,23,77
2068,2068,,0,1,1,46
2069,2069,,16,18,34,50
2070,2070,,3,0,3,50
2071,2071,,14,15,29,113
2072,2072,,0,3,3,46
2073,2073,,3,0,3,46
2074,2074,,0,3,3,73
2075,2075,,0,3,3,216
2076,2076,,0,19,19,204
2077,2077,,20,21,41,39
2078,2078,,0,3,3,96
2079,2079,,0,9,9,33
2080,2080,,0,1,1,74
2081,2081,,28,29,57,46
2082,2082,,38,20,58,804
2083,2083,,0,5,5,46
2084,2084,,44,45,89,57
2085,2085,,0,21,21,216
2086,2086,,3,0,3,46
2087,2087,,0,5,5,19
2088,2088,,11,12,23,41
2089,2089,,0,16,16,31
2090,2090,,13,14,27,25
2091,2091,,0,7,7,46
2092,2092,,21,22,43,216
2093,2093,,24,65,89,40
2094,2094,,0,4,4,46
2095,2095,,1,2,3,813
2096,2096,,0,5,5,46
2097,2097,,43,45,88,44
2098,2098,,0,3,3,73
2099,2099,,10,11,21,27
2100,2100,,0,3,3,256
2101,2101,,36,38,74,27
2102,2102,,0,3,3,152
2103,2103,,47,48,95,14
2104,2104,,7,8,15,38
2105,2105,,0,4,4,46
2106,2106,,0,1,1,44
2107,2107,,0,3,3,316
2108,2108,,11,14,25,27
2109,2109,,7,14,21,73
2110,2110,,10,11,21,49
2111,2111,,0,2,2,46
2112,2112,,0,3,3,113
2113,2113,,8,10,18,260
2114,2114,,0,15,15,813
2115,2115,,0,4,4,73
2116,2116,,0,357,357,805
2117,2117,,0,21,21,815
2118,2118,,56,57,113,804
2119,2119,,0,1,1,260
2120,2120,,28,29,57,46
2121,2121,,68,6,74,57
2122,2122,,3,0,3,46
2123,2123,,0,11,11,204
2124,2124,,0,3,3,46
2125,2125,,21,22,43,301
2126,2126,,2,0,2,301
2127,2127,,37,38,75,38
2128,2128,,0,3,3,113
2129,2129,,0,122,122,804
2130,2130,,12,13,25,280
2131,2131,,0,11,11,46
2132,2132,,33,34,67,96
2133,2133,,5,0,5,96
2134,2134,,0,3,3,29
2135,2135,,13,14,27,171
2136,2136,,0,3,3,113
2137,2137,,52,53,105,27
2138,2138,,0,37,37,216
2139,2139,,0,25,25,818
2140,2140,,0,61,61,216
2141,2141,,3,0,3,216
2142,2142,,0,6,6,46
2143,2143,,33,64,97,216
2144,2144,,0,1,1,260
2145,2145,,0,51,51,804
2146,2146,,5,8,13,255
2147,2147,,0,3,3,77
2148,2148,,0,3,3,74
2149,2149,,11,2,13,27
2150,2150,,0,1,1,38
2151,2151,,41,42,83,30
2152,2152,,0,3,3,239
2153,2153,,34,35,69,813
2154,2154,,5,6,11,77
2155,2155,,0,211,211,806
2156,2156,,0,4,4,260
2157,2157,,0,6,6,46
2158,2158,,12,13,25,37
2159,2159,,16,18,34,26
2160,2160,,17,19,36,152
2161,2161,,10,12,22,47
2162,2162,,3,0,3,47
2163,2163,,14,39,53,256
2164,2164,,19,20,39,44
2165,2165,,0,3,3,113
2166,2166,,1,2,3,14
2167,2167,,0,18,18,216
2168,2168,,4,5,9,30
2169,2169,,7,9,16,27
2170,2170,,14,15,29,30
2171,2171,,29,32,61,49
2172,2172,,0,7,7,301
2173,2173,,44,45,89,812
2174,2174,,0,3,3,113
2175,2175,,56,57,113,14
2176,2176,,0,21,21,804
2177,2177,,0,38,38,216
2178,2178,,0,6,6,46
2179,2179,,59,108,167,42
2180,2180,,0,18,18,22
2181,2181,,0,5,5,262
2182,2182,,29,30,59,272
2183,2183,,0,3,3,46
2184,2184,,0,3,3,46
2185,2185,,0,1,1,44
2186,2186,,0,207,207,806
2187,2187,,4,5,9,260
2188,2188,,12,13,25,19
2189,2189,,0,3,3,216
2190,2190,,7,8,15,14
2191,2191,,0,6,6,46
2192,2192,,0,2,2,46
2193,2193,,23,24,47,256
2194,2194,,22,23,45,39
2195,2195,,10,12,22,41
2196,2196,,54,55,109,17
2197,2197,,0,3,3,44
2198,2198,,91,32,123,27
2199,2199,,0,33,33,21
2200,2200,,54,56,110,259
2201,2201,,0,109,109,806
2202,2202,,2,3,5,49
2203,2203,,0,3,3,316
2204,2204,,0,9,9,46
2205,2205,,0,3,3,46
2206,2206,,0,3,3,41
2207,2207,,21,22,43,90
2208,2208,,0,1,1,28
2209,2209,,0,6,6,46
2210,2210,,0,3,3,46
2211,2211,,0,1,1,73
2212,2212,,30,31,61,49
2213,2213,,0,4,4,77
2214,2214,,0,3,3,77
2215,2215,,0,3,3,46
2216,2216,,4,0,4,46
2217,2217,,0,2,2,96
2218,2218,,0,2,2,46
2219,2219,,0,3,3,77
2220,2220,,0,166,166,806
2221,2221,,3,5,8,57
2222,2222,,0,3,3,74
2223,2223,,0,2,2,46
2224,2224,,41,42,83,19
2225,2225,,0,1,1,133
2226,2226,,33,36,69,29
2227,2227,,0,29,29,30
2228,2228,,3,4,7,46
2229,2229,,0,1,1,46
2230,2230,,0,4,4,46
2231,2231,,8,9,17,19
2232,2232,,15,16,31,813
2233,2233,,6,7,13,204
2234,2234,,11,12,23,215
2235,2235,,36,37,73,73
2236,2236,,0,6,6,46
2237,2237,,0,3,3,260
2238,2238,,0,5,5,259
2239,2239,,0,10,10,14
2240,2240,,2,0,2,14
2241,2241,,0,65,65,255
2242,2242,,5,6,11,47
2243,2243,,0,10,10,46
2244,2244,,50,51,101,77
2245,2245,,8,9,17,260
2246,2246,,10,11,21,29
2247,2247,,0,1,1,73
2248,2248,,0,21,21,804
2249,2249,,0,2,2,804
2250,2250,,0,4,4,46
2251,2251,,0,9,9,19
2252,2252,,0,70,70,804
2253,2253,,13,14,27,67
2254,2254,,0,5,5,46
2255,2255,,14,16,30,152
2256,2256,,0,3,3,46
2257,2257,,0,1,1,260
2258,2258,,8,9,17,55
2259,2259,,0,3,3,47
2260,2260,,45,40,85,41
2261,2261,,5,6,11,813
2262,2262,,2,3,5,55
2263,2263,,0,3,3,46
2264,2264,,0,4,4,44
2265,2265,,23,24,47,272
2266,2266,,0,49,49,813
2267,2267,,5,8,13,39
2268,2268,,19,21,40,14
2269,2269,,0,35,35,204
2270,2270,,0,4,4,67
2271,2271,,0,18,18,77
2272,2272,,3,0,3,46
2273,2273,,2,3,5,46
2274,2274,,0,2,2,81
2275,2275,,31,32,63,262
2276,2276,,0,4,4,46
2277,2277,,7,3,10,90
2278,2278,,8,10,18,44
2279,2279,,30,29,59,34
2280,2280,,0,3,3,113
2281,2281,,20,9,29,27
2282,2282,,15,16,31,272
2283,2283,,1,2,3,46
2284,2284,,0,4,4,46
2285,2285,,29,31,60,56
2286,2286,,0,3,3,67
2287,2287,,3,5,8,27
2288,2288,,0,29,29,239
2289,2289,,0,269,269,806
2290,2290,,1,2,3,272
2291,2291,,31,31,62,113
2292,2292,,43,44,87,260
2293,2293,,0,3,3,260
2294,2294,,0,190,190,806
2295,2295,,4,7,11,260
2296,2296,,9,10,19,41
2297,2297,,40,42,82,272
2298,2298,,36,22,58,15
2299,2299,,0,34,34,216
2300,2300,,0,15,15,216
2301,2301,,22,23,45,46
2302,2302,,0,5,5,22
2303,2303,,5,6,11,55
2304,2304,,9,10,19,216
2305,2305,,22,23,45,46
2306,2306,,5,0,5,46
2307,2307,,0,3,3,77
2308,2308,,0,1,1,204
2309,2309,,3,0,3,204
2310,2310,,23,24,47,58
2311,2311,,0,3,3,124
2312,2312,,0,1,1,25
2313,2313,,0,64,64,272
2314,2314,,0,1,1,113
2315,2315,,0,3,3,53
2316,2316,,6,0,6,53
2317,2317,,0,2,2,204
2318,2318,,0,1,1,50
2319,2319,,0,13,13,804
2320,2320,,0,4,4,46
2321,2321,,0,14,14,216
2322,2322,,3,0,3,216
2323,2323,,0,5,5,46
2324,2324,,0,8,8,152
2325,2325,,9,10,19,50
2326,2326,,0,1,1,77
2327,2327,,0,2,2,46
2328,2328,,18,19,37,260
2329,2329,,0,1,1,152
2330,2330,,3,0,3,152
2331,2331,,0,1,1,74
2332,2332,,5,6,11,77
2333,2333,,0,3,3,77
2334,2334,,13,3,16,47
2335,2335,,0,115,115,90
2336,2336,,0,6,6,46
2337,2337,,22,24,46,259
2338,2338,,0,26,26,204
2339,2339,,0,5,5,110
2340,2340,,1,180,181,110
2341,2341,,0,192,192,806
2342,2342,,0,1,1,113
2343,2343,,0,20,20,804
2344,2344,,0,4,4,18
2345,2345,,0,7,7,46
2346,2346,,0,3,3,46
2347,2347,,0,1,1,46
2348,2348,,0,38,38,204
2349,2349,,39,40,79,30
2350,2350,,1,2,3,804
2351,2351,,39,41,80,44
2352,2352,,66,93,159,96
2353,2353,,41,42,83,272
2354,2354,,0,10,10,216
2355,2355,,8,9,17,280
2356,2356,,0,1,1,47
2357,2357,,0,6,6,41
2358,2358,,9,11,20,46
2359,2359,,0,3,3,67
2360,2360,,0,9,9,46
2361,2361,,0,3,3,67
2362,2362,,0,3,3,77
2363,2363,,0,3,3,42
2364,2364,,6,7,13,43
2365,2365,,0,3,3,260
2366,2366,,0,1,1,73
2367,2367,,79,81,160,260
2368,2368,,1,2,3,77
2369,2369,,0,4,4,46
2370,2370,,3,0,3,46
2371,2371,,0,207,207,806
2372,2372,,43,24,67,73
2373,2373,,0,4,4,44
2374,2374,,71,77,148,215
2375,2375,,33,34,67,260
2376,2376,,15,17,32,27
2377,2377,,60,62,122,41
2378,2378,,58,59,117,42
2379,2379,,0,25,25,204
2380,2380,,13,14,27,260
2381,2381,,0,2,2,272
2382,2382,,2,3,5,73
2383,2383,,0,4,4,46
2384,2384,,0,22,22,260
2385,2385,,0,6,6,46
2386,2386,,0,5,5,46
2387,2387,,65,66,131,27
2388,2388,,0,55,55,316
2389,2389,,0,39,39,804
2390,2390,,3,4,7,260
2391,2391,,42,44,86,25
2392,2392,,46,47,93,73
2393,2393,,0,3,3,77
2394,2394,,19,21,40,41
2395,2395,,4,5,9,25
2396,2396,,0,5,5,46
2397,2397,,0,1,1,46
2398,2398,,0,181,181,804
2399,2399,,10,11,21,21
2400,2400,,0,30,30,204
2401,2401,,25,26,51,260
2402,2402,,0,3,3,46
2403,2403,,38,39,77,39
2404,2404,,0,1,1,14
2405,2405,,28,29,57,77
2406,2406,,0,4,4,46
2407,2407,,52,9,61,36
2408,2408,,3,0,3,36
2409,2409,,0,3,3,46
2410,2410,,0,1,1,804
2411,2411,,0,1,1,46
2412,2412,,0,425,425,804
2413,2413,,0,31,31,813
2414,2414,,29,30,59,30
2415,2415,,4,0,4,46
2416,2416,,14,15,29,24
2417,2417,,3,0,3,24
2418,2418,,0,195,195,805
2419,2419,,0,16,16,216
2420,2420,,55,56,111,187
2421,2421,,0,9,9,40
2422,2422,,11,12,23,259
2423,2423,,9,2,11,46
2424,2424,,17,18,35,152
2425,2425,,41,42,83,58
2426,2426,,3,0,3,58
2427,2427,,7,8,15,260
2428,2428,,60,63,123,49
2429,2429,,11,12,23,46
2430,2430,,0,33,33,21
2431,2431,,0,29,29,204
2432,2432,,50,51,101,204
2433,2433,,0,1,1,46
2434,2434,,27,28,55,113
2435,2435,,0,28,28,25
2436,2436,,72,59,131,815
2437,2437,,6,7,13,46
2438,2438,,0,3,3,29
2439,2439,,36,37,73,256
2440,2440,,0,31,31,813
2441,2441,,0,6,6,804
2442,2442,,0,3,3,77
2443,2443,,0,10,10,804
2444,2444,,0,5,5,46
2445,2445,,0,4,4,46
2446,2446,,3,4,7,73
2447,2447,,0,5,5,46
2448,2448,,20,22,42,50
2449,2449,,0,2,2,67
2450,2450,,2,3,5,813
2451,2451,,0,3,3,67
2452,2452,,0,3,3,74
2453,2453,,0,3,3,260
2454,2454,,0,4,4,19
2455,2455,,11,12,23,43
2456,2456,,0,4,4,74
2457,2457,,31,32,63,216
2458,2458,,0,14,14,216
2459,2459,,4,5,9,42
2460,2460,,0,35,35,21
2461,2461,,0,4,4,316
2462,2462,,0,14,14,216
2463,2463,,33,34,67,96
2464,2464,,0,1,1,56
2465,2465,,21,22,43,79
2466,2466,,13,14,27,77
2467,2467,,8,24,32,27
2468,2468,,14,20,34,216
2469,2469,,0,4,4,260
2470,2470,,53,55,108,260
2471,2471,,26,27,53,38
2472,2472,,0,16,16,813
2473,2473,,49,50,99,113
2474,2474,,0,3,3,815
2475,2475,,0,4,4,46
2476,2476,,52,53,105,20
2477,2477,,20,26,46,49
2478,2478,,54,55,109,41
2479,2479,,3,4,7,260
2480,2480,,62,35,97,216
2481,2481,,5,40,45,27
2482,2482,,0,6,6,27
2483,2483,,24,25,49,67
2484,2484,,21,22,43,79
2485,2485,,9,10,19,77
2486,2486,,0,3,3,144
2487,2487,,0,3,3,44
2488,2488,,122,47,169,55
2489,2489,,17,18,35,113
2490,2490,,0,55,55,804
2491,2491,,63,65,128,55
2492,2492,,0,3,3,81
2493,2493,,0,10,10,243
2494,2494,,24,25,49,38
2495,2495,,0,1,1,25
2496,2496,,0,2,2,46
2497,2497,,23,24,47,35
2498,2498,,5,6,11,77
2499,2499,,4,5,9,280
2500,2500,,3,4,7,21
2501,2501,,0,3,3,77
2502,2502,,1,2,3,77
2503,2503,,0,7,7,46
2504,2504,,50,50,100,46
2505,2505,,0,3,3,260
2506,2506,,17,18,35,21
2507,2507,,38,40,78,35
2508,2508,,0,1,1,56
2509,2509,,0,30,30,21
2510,2510,,0,2,2,77
2511,2511,,0,9,9,187
2512,2512,,0,4,4,260
2513,2513,,16,17,33,43
2514,2514,,38,39,77,35
2515,2515,,0,3,3,216
2516,2516,,0,22,22,204
2517,2517,,0,1,1,49
2518,2518,,3,0,3,49
2519,2519,,18,20,38,260
2520,2520,,7,8,15,57
2521,2521,,6,0,6,57
2522,2522,,0,3,3,259
2523,2523,,0,1,1,46
2524,2524,,9,10,19,35
2525,2525,,3,0,3,35
2526,2526,,6,7,13,256
2527,2527,,58,74,132,815
2528,2528,,0,13,13,74
2529,2529,,8,9,17,73
2530,2530,,4,0,4,73
2531,2531,,46,47,93,152
2532,2532,,0,26,26,813
2533,2533,,0,12,12,216
2534,2534,,0,18,18,204
2535,2535,,4,5,9,204
2536,2536,,0,4,4,47
2537,2537,,0,4,4,216
2538,2538,,0,1,1,260
2539,2539,,0,71,71,804
2540,2540,,16,17,33,124
2541,2541,,4,5,9,260
2542,2542,,0,38,38,804
2543,2543,,0,6,6,46
2544,2544,,0,1,1,113
2545,2545,,48,50,98,316
2546,2546,,0,59,59,124
2547,2547,,4,5,9,813
2548,2548,,0,2,2,46
2549,2549,,17,4,21,67
2550,2550,,12,13,25,46
2551,2551,,0,5,5,46
2552,2552,,16,17,33,55
2553,2553,,0,2,2,19
2554,2554,,6,7,13,47
2555,2555,,0,1,1,46
2556,2556,,4,0,4,46
2557,2557,,14,17,31,144
2558,2558,,0,30,30,804
2559,2559,,10,11,21,27
2560,2560,,8,9,17,56
2561,2561,,1,2,3,46
2562,2562,,0,163,163,806
2563,2563,,3,0,3,806
2564,2564,,38,39,77,39
2565,2565,,0,3,3,46
2566,2566,,8,9,17,73
2567,2567,,22,27,49,112
2568,2568,,0,205,205,806
2569,2569,,9,46,55,27
2570,2570,,21,22,43,144
2571,2571,,0,3,3,144
2572,2572,,10,11,21,77
2573,2573,,4,6,10,81
2574,2574,,0,3,3,74
2575,2575,,0,56,56,90
2576,2576,,8,55,63,67
2577,2577,,46,6,52,77
2578,2578,,8,53,61,36
2579,2579,,0,61,61,255
2580,2580,,0,2,2,255
2581,2581,,0,3,3,216
2582,2582,,32,34,66,301
2583,2583,,4,5,9,27
2584,2584,,3,4,7,27
2585,2585,,7,8,15,21
2586,2586,,0,77,77,804
2587,2587,,0,5,5,46
2588,2588,,0,36,36,804
2589,2589,,0,7,7,46
2590,2590,,5,6,11,73
2591,2591,,0,4,4,46
2592,2592,,51,52,103,34
2593,2593,,0,3,3,44
2594,2594,,12,13,25,96
2595,2595,,0,3,3,29
2596,2596,,18,20,38,46
2597,2597,,0,3,3,73
2598,2598,,18,79,97,301
2599,2599,,0,3,3,26
2600,2600,,0,3,3,46
2601,2601,,2,11,13,30
2602,2602,,4,0,4,30
2603,2603,,73,4,77,49
2604,2604,,0,11,11,804
2605,2605,,0,4,4,26
2606,2606,,0,4,4,46
2607,2607,,0,3,3,260
2608,2608,,58,60,118,49
2609,2609,,0,38,38,22
2610,2610,,0,6,6,46
2611,2611,,9,10,19,260
2612,2612,,36,37,73,73
2613,2613,,79,12,91,14
2614,2614,,0,3,3,19
2615,2615,,0,1,1,28
2616,2616,,3,27,30,46
2617,2617,,28,30,58,55
2618,2618,,17,18,35,67
2619,2619,,0,5,5,19
2620,2620,,106,33,139,260
2621,2621,,29,29,58,215
2622,2622,,0,180,180,66
2623,2623,,0,28,28,21
2624,2624,,0,4,4,35
2625,2625,,58,60,118,59
2626,2626,,0,5,5,251
2627,2627,,0,22,22,113
2628,2628,,8,9,17,171
2629,2629,,0,41,41,804
2630,2630,,0,2,2,46
2631,2631,,0,11,11,204
2632,2632,,3,0,3,204
2633,2633,,1,2,3,144
2634,2634,,0,3,3,46
2635,2635,,0,3,3,34
2636,2636,,82,83,165,77
2637,2637,,11,12,23,43
2638,2638,,17,4,21,27
2639,2639,,3,4,7,90
2640,2640,,5,6,11,124
2641,2641,,0,3,3,90
2642,2642,,0,99,99,804
2643,2643,,16,17,33,55
2644,2644,,0,17,17,813
2645,2645,,0,2,2,813
2646,2646,,3,5,8,216
2647,2647,,35,70,105,280
2648,2648,,26,28,54,26
2649,2649,,66,12,78,67
2650,2650,,11,12,23,272
2651,2651,,0,59,59,804
2652,2652,,0,4,4,38
2653,2653,,2,0,2,38
2654,2654,,0,3,3,113
2655,2655,,24,25,49,804
2656,2656,,40,41,81,316
2657,2657,,4,5,9,316
2658,2658,,7,8,15,39
2659,2659,,0,1,1,46
2660,2660,,9,11,20,27
2661,2661,,0,1,1,272
2662,2662,,0,28,28,216
2663,2663,,45,47,92,25
2664,2664,,16,17,33,35
2665,2665,,0,1,1,77
2666,2666,,0,1,1,73
2667,2667,,23,24,47,133
2668,2668,,19,4,23,38
2669,2669,,0,1,1,260
2670,2670,,0,32,32,27
2671,2671,,2,3,5,49
2672,2672,,15,16,31,50
2673,2673,,0,23,23,216
2674,2674,,8,9,17,171
2675,2675,,0,4,4,46
2676,2676,,0,3,3,113
2677,2677,,0,2,2,46
2678,2678,,14,16,30,46
2679,2679,,0,1,1,77
2680,2680,,2,3,5,33
2681,2681,,0,3,3,77
2682,2682,,0,17,17,33
2683,2683,,26,27,53,19
2684,2684,,0,1,1,26
2685,2685,,32,33,65,280
2686,2686,,4,5,9,14
2687,2687,,5,7,12,59
2688,2688,,12,0,12,46
2689,2689,,0,4,4,46
2690,2690,,0,1,1,44
2691,2691,,0,8,8,46
2692,2692,,26,28,54,27
2693,2693,,0,1,1,74
2694,2694,,4,5,9,67
2695,2695,,0,3,3,74
2696,2696,,3,0,3,74
2697,2697,,28,29,57,804
2698,2698,,0,189,189,812
2699,2699,,75,59,134,44
2700,2700,,21,22,43,56
2701,2701,,0,30,30,216
2702,2702,,0,4,4,251
2703,2703,,28,29,57,260
2704,2704,,0,8,8,216
2705,2705,,15,15,30,96
2706,2706,,0,18,18,813
2707,2707,,0,17,17,804
2708,2708,,11,12,23,30
2709,2709,,0,1,1,29
2710,2710,,3,4,7,26
2711,2711,,28,29,57,256
2712,2712,,28,29,57,55
2713,2713,,19,21,40,46
2714,2714,,0,3,3,255
2715,2715,,0,3,3,113
2716,2716,,19,21,40,256
2717,2717,,55,56,111,35
2718,2718,,8,9,17,46
2719,2719,,54,56,110,124
2720,2720,,7,9,16,27
2721,2721,,0,1,1,77
2722,2722,,57,59,116,41
2723,2723,,36,37,73,55
2724,2724,,0,10,10,46
2725,2725,,0,17,17,812
2726,2726,,0,5,5,46
2727,2727,,0,5,5,46
2728,2728,,0,3,3,255
2729,2729,,3,0,3,255
2730,2730,,45,47,92,59
2731,2731,,0,3,3,46
2732,2732,,3,4,7,113
2733,2733,,0,56,56,40
2734,2734,,0,125,125,81
2735,2735,,0,10,10,77
2736,2736,,0,33,33,22
2737,2737,,8,2,10,58
2738,2738,,0,15,15,804
2739,2739,,0,38,38,215
2740,2740,,10,11,21,216
2741,2741,,4,5,9,804
2742,2742,,3,4,7,96
2743,2743,,0,29,29,804
2744,2744,,0,3,3,152
2745,2745,,0,1,1,50
2746,2746,,0,3,3,27
2747,2747,,5,6,11,14
2748,2748,,0,1,1,46
2749,2749,,24,25,49,280
2750,2750,,15,16,31,49
2751,2751,,1,2,3,171
2752,2752,,0,4,4,27
2753,2753,,0,1,1,46
2754,2754,,38,39,77,46
2755,2755,,3,4,7,77
2756,2756,,0,3,3,30
2757,2757,,0,49,49,813
2758,2758,,0,4,4,124
2759,2759,,27,28,55,259
2760,2760,,0,4,4,46
2761,2761,,65,36,101,81
2762,2762,,3,0,3,81
2763,2763,,0,3,3,815
2764,2764,,0,3,3,280
2765,2765,,0,5,5,46
2766,2766,,16,17,33,43
2767,2767,,0,4,4,46
2768,2768,,0,5,5,46
2769,2769,,0,1,1,248
2770,2770,,22,24,46,29
2771,2771,,0,1,1,813
2772,2772,,7,8,15,14
2773,2773,,29,30,59,27
2774,2774,,0,41,41,40
2775,2775,,18,19,37,272
2776,2776,,3,4,7,67
2777,2777,,38,39,77,171
2778,2778,,0,5,5,46
2779,2779,,0,1,1,73
2780,2780,,0,39,39,259
2781,2781,,24,26,50,27
2782,2782,,0,3,3,46
2783,2783,,2,0,2,46
2784,2784,,0,5,5,46
2785,2785,,5,6,11,256
2786,2786,,0,5,5,46
2787,2787,,78,21,99,301
2788,2788,,6,7,13,74
2789,2789,,0,7,7,46
2790,2790,,13,16,29,44
2791,2791,,0,44,44,812
2792,2792,,10,11,21,43
2793,2793,,0,1,1,27
2794,2794,,0,3,3,113
2795,2795,,0,2,2,171
2796,2796,,0,3,3,46
2797,2797,,0,3,3,27
2798,2798,,21,22,43,255
2799,2799,,5,0,5,255
2800,2800,,0,17,17,40
2801,2801,,17,19,36,49
2802,2802,,0,69,69,18
2803,2803,,1,2,3,260
2804,2804,,0,4,4,171
2805,2805,,0,4,4,46
2806,2806,,4,6,10,46
2807,2807,,24,25,49,49
2808,2808,,4,6,10,81
2809,2809,,41,42,83,19
2810,2810,,3,0,3,19
2811,2811,,8,9,17,256
2812,2812,,0,39,39,804
2813,2813,,0,13,13,57
2814,2814,,0,18,18,77
2815,2815,,21,1,22,90
2816,2816,,30,31,61,73
2817,2817,,0,3,3,46
2818,2818,,0,1,1,25
2819,2819,,0,7,7,260
2820,2820,,0,1,1,46
2821,2821,,10,11,21,96
2822,2822,,14,16,30,67
2823,2823,,36,38,74,256
2824,2824,,0,4,4,27
2825,2825,,0,3,3,46
2826,2826,,0,3,3,44
2827,2827,,8,9,17,204
2828,2828,,0,1,1,260
2829,2829,,3,0,3,260
2830,2830,,10,12,22,27
2831,2831,,0,6,6,216
2832,2832,,0,1,1,14
2833,2833,,3,35,38,804
2834,2834,,0,2,2,46
2835,2835,,3,0,3,46
2836,2836,,0,5,5,46
2837,2837,,10,11,21,30
2838,2838,,0,3,3,316
2839,2839,,0,5,5,46
2840,2840,,0,2,2,144
2841,2841,,47,49,96,81
2842,2842,,22,23,45,152
2843,2843,,19,20,39,49
2844,2844,,0,3,3,46
2845,2845,,0,4,4,57
2846,2846,,0,1,1,316
2847,2847,,0,3,3,33
2848,2848,,0,22,22,813
2849,2849,,0,1,1,46
2850,2850,,0,3,3,73
2851,2851,,29,73,102,113
2852,2852,,0,1,1,46
2853,2853,,3,0,3,46
2854,2854,,4,64,68,27
2855,2855,,0,1,1,260
2856,2856,,73,48,121,23
2857,2857,,0,270,270,806
2858,2858,,0,144,144,67
2859,2859,,0,15,15,216
2860,2860,,0,88,88,204
2861,2861,,10,11,21,35
2862,2862,,0,4,4,21
2863,2863,,24,25,49,44
2864,2864,,19,20,39,259
2865,2865,,3,0,3,259
2866,2866,,8,10,18,204
2867,2867,,0,1,1,280
2868,2868,,0,2,2,50
2869,2869,,12,14,26,41
2870,2870,,0,1,1,46
2871,2871,,0,4,4,46
2872,2872,,3,4,7,27
2873,2873,,0,34,34,216
2874,2874,,5,6,11,37
2875,2875,,3,0,3,37
2876,2876,,12,3,15,144
2877,2877,,0,3,3,67
2878,2878,,0,6,6,46
2879,2879,,0,8,8,46
2880,2880,,0,46,46,239
2881,2881,,72,73,145,260
2882,2882,,0,1,1,124
2883,2883,,52,53,105,50
2884,2884,,0,25,25,216
2885,2885,,23,24,47,41
2886,2886,,14,15,29,24
2887,2887,,3,4,7,96
2888,2888,,8,9,17,73
2889,2889,,0,3,3,113
2890,2890,,0,1,1,14
2891,2891,,0,1,1,77
2892,2892,,22,23,45,43
2893,2893,,0,1,1,316
2894,2894,,0,224,224,804
2895,2895,,7,8,15,73
2896,2896,,0,2,2,316
2897,2897,,0,24,24,813
2898,2898,,0,1,1,216
2899,2899,,14,15,29,280
2900,2900,,2,3,5,44
2901,2901,,51,23,74,46
2902,2902,,38,44,82,46
2903,2903,,6,8,14,56
2904,2904,,51,52,103,256
2905,2905,,4,5,9,21
2906,2906,,50,51,101,57
2907,2907,,0,4,4,280
2908,2908,,37,38,75,74
2909,2909,,0,2,2,67
2910,2910,,12,14,26,259
2911,2911,,0,298,298,806
2912,2912,,29,31,60,45
2913,2913,,0,3,3,42
2914,2914,,0,35,35,44
2915,2915,,26,27,53,77
2916,2916,,0,2,2,77
2917,2917,,15,16,31,44
2918,2918,,0,3,3,46
2919,2919,,9,11,20,67
2920,2920,,0,4,4,46
2921,2921,,0,2,2,804
2922,2922,,2,0,2,804
2923,2923,,6,7,13,25
2924,2924,,3,0,3,74
2925,2925,,2,3,5,260
2926,2926,,0,13,13,42
2927,2927,,0,3,3,74
2928,2928,,0,4,4,46
2929,2929,,0,3,3,73
2930,2930,,54,8,62,171
2931,2931,,4,5,9,813
2932,2932,,0,1,1,77
2933,2933,,0,13,13,21
2934,2934,,0,29,29,239
2935,2935,,0,3,3,204
2936,2936,,0,3,3,29
2937,2937,,55,56,111,44
2938,2938,,4,5,9,260
2939,2939,,35,75,110,81
2940,2940,,71,72,143,42
2941,2941,,23,24,47,815
2942,2942,,11,12,23,46
2943,2943,,0,1,1,280
2944,2944,,3,4,7,40
2945,2945,,12,13,25,133
2946,2946,,0,2,2,40
2947,2947,,8,11,19,44
2948,2948,,0,4,4,46
2949,2949,,7,8,15,26
2950,2950,,3,0,3,26
2951,2951,,9,10,19,74
2952,2952,,5,7,12,47
2953,2953,,0,1,1,316
2954,2954,,35,36,71,34
2955,2955,,1,3,4,27
2956,2956,,0,3,3,113
2957,2957,,24,25,49,40
2958,2958,,0,189,189,812
2959,2959,,0,54,54,255
2960,2960,,47,51,98,46
2961,2961,,0,5,5,22
2962,2962,,0,3,3,77
2963,2963,,0,1,1,813
2964,2964,,4,74,78,42
2965,2965,,8,9,17,260
2966,2966,,8,9,17,46
2967,2967,,28,30,58,256
2968,2968,,10,11,21,29
2969,2969,,0,23,23,204
2970,2970,,0,4,4,46
2971,2971,,0,1,1,44
2972,2972,,0,2,2,272
2973,2973,,0,5,5,46
2974,2974,,24,26,50,44
2975,2975,,0,1,1,42
2976,2976,,6,7,13,204
2977,2977,,0,106,106,806
2978,2978,,17,44,61,804
2979,2979,,0,3,3,43
2980,2980,,63,64,127,67
2981,2981,,0,3,3,46
2982,2982,,14,15,29,67
2983,2983,,0,3,3,46
2984,2984,,3,5,8,41
2985,2985,,0,1,1,27
2986,2986,,24,26,50,27
2987,2987,,77,41,118,81
2988,2988,,0,35,35,804
2989,2989,,40,41,81,316
2990,2990,,0,3,3,259
2991,2991,,0,9,9,204
2992,2992,,0,1,1,46
2993,2993,,0,4,4,46
2994,2994,,5,1,6,74
2995,2995,,28,29,57,46
2996,2996,,15,16,31,56
2997,2997,,14,15,29,19
2998,2998,,0,56,56,204
2999,2999,,3,0,3,42
3000,3000,,25,26,51,67
3001,3001,,0,1,1,73
3002,3002,,0,1,1,22
3003,3003,,4,14,18,55
3004,3004,,0,3,3,67
3005,3005,,0,1,1,44
3006,3006,,2,3,5,33
3007,3007,,0,3,3,29
3008,3008,,26,28,54,47
3009,3009,,18,19,37,27
3010,3010,,44,45,89,74
3011,3011,,0,42,42,67
3012,3012,,0,3,3,59
3013,3013,,5,6,11,27
3014,3014,,0,8,8,215
3015,3015,,0,1,1,152
3016,3016,,0,2,2,280
3017,3017,,7,79,86,77
3018,3018,,0,31,31,124
3019,3019,,41,75,116,57
3020,3020,,4,5,9,256
3021,3021,,13,15,28,46
3022,3022,,0,3,3,46
3023,3023,,0,4,4,152
3024,3024,,15,15,30,44
3025,3025,,0,1,1,67
3026,3026,,18,19,37,77
3027,3027,,0,2,2,46
3028,3028,,5,6,11,804
3029,3029,,0,8,8,44
3030,3030,,0,3,3,255
3031,3031,,0,4,4,301
3032,3032,,0,133,133,806
3033,3033,,0,187,187,806
3034,3034,,2,3,5,47
3035,3035,,0,1,1,0
3036,3036,,0,3,3,30
3037,3037,,47,49,96,44
3038,3038,,8,9,17,260
3039,3039,,0,40,40,204
3040,3040,,0,19,19,21
3041,3041,,13,14,27,73
3042,3042,,0,282,282,815
3043,3043,,16,17,33,804
3044,3044,,7,8,15,26
3045,3045,,0,8,8,112
3046,3046,,0,5,5,46
3047,3047,,2,4,6,19
3048,3048,,37,38,75,259
3049,3049,,24,25,49,38
3050,3050,,0,70,70,804
3051,3051,,2,3,5,113
3052,3052,,0,9,9,46
3053,3053,,41,43,84,55
3054,3054,,1,2,3,21
3055,3055,,0,3,3,67
3056,3056,,0,1,1,46
3057,3057,,52,58,110,260
3058,3058,,0,40,40,21
3059,3059,,0,3,3,56
3060,3060,,0,1,1,316
3061,3061,,0,1,1,260
3062,3062,,7,8,15,46
3063,3063,,0,1,1,67
3064,3064,,7,8,15,316
3065,3065,,0,30,30,804
3066,3066,,13,15,28,30
3067,3067,,5,6,11,216
3068,3068,,0,6,6,46
3069,3069,,0,3,3,67
3070,3070,,26,28,54,26
3071,3071,,0,3,3,74
3072,3072,,0,2,2,230
3073,3073,,12,13,25,280
3074,3074,,66,67,133,216
3075,3075,,48,4,52,46
3076,3076,,0,7,7,46
3077,3077,,10,11,21,41
3078,3078,,0,5,5,46
3079,3079,,6,7,13,260
3080,3080,,39,40,79,113
3081,3081,,5,7,12,260
3082,3082,,0,3,3,19
3083,3083,,0,4,4,55
3084,3084,,0,3,3,81
3085,3085,,16,18,34,29
3086,3086,,0,2,2,46
3087,3087,,0,4,4,46
3088,3088,,52,53,105,44
3089,3089,,29,31,60,216
3090,3090,,0,74,74,216
3091,3091,,0,13,13,204
3092,3092,,0,178,178,806
3093,3093,,0,3,3,77
3094,3094,,0,1,1,216
3095,3095,,0,3,3,73
3096,3096,,0,3,3,27
3097,3097,,0,1,1,812
3098,3098,,4,0,4,812
3099,3099,,6,55,61,171
3100,3100,,0,4,4,46
3101,3101,,0,3,3,255
3102,3102,,22,23,45,67
3103,3103,,52,53,105,46
3104,3104,,0,1,1,42
3105,3105,,61,62,123,316
3106,3106,,0,1,1,260
3107,3107,,0,2,2,272
3108,3108,,0,3,3,34
3109,3109,,24,25,49,272
3110,3110,,3,4,7,144
3111,3111,,45,22,67,27
3112,3112,,0,17,17,31
3113,3113,,32,33,65,44
3114,3114,,0,6,6,301
3115,3115,,0,5,5,46
3116,3116,,28,29,57,260
3117,3117,,0,47,47,804
3118,3118,,0,4,4,46
3119,3119,,0,11,11,804
3120,3120,,0,7,7,46
3121,3121,,0,4,4,46
3122,3122,,21,22,43,55
3123,3123,,57,53,110,260
3124,3124,,52,57,109,46
3125,3125,,0,3,3,42
3126,3126,,11,13,24,42
3127,3127,,0,4,4,77
3128,3128,,66,20,86,47
3129,3129,,0,3,3,124
3130,3130,,2,3,5,316
3131,3131,,16,18,34,67
3132,3132,,24,25,49,113
3133,3133,,1,2,3,144
3134,3134,,0,5,5,46
3135,3135,,0,6,6,46
3136,3136,,0,58,58,21
3137,3137,,0,1,1,46
3138,3138,,28,29,57,46
3139,3139,,0,1,1,81
3140,3140,,58,59,117,67
3141,3141,,0,9,9,248
3142,3142,,0,1,1,144
3143,3143,,0,3,3,260
3144,3144,,0,4,4,46
3145,3145,,13,14,27,171
3146,3146,,0,1,1,256
3147,3147,,0,41,41,204
3148,3148,,110,34,144,32
3149,3149,,10,11,21,144
3150,3150,,0,1,1,46
3151,3151,,29,31,60,216
3152,3152,,0,3,3,216
3153,3153,,17,19,36,40
3154,3154,,0,3,3,187
3155,3155,,8,9,17,43
3156,3156,,5,6,11,14
3157,3157,,3,4,7,77
3158,3158,,13,15,28,256
3159,3159,,8,9,17,77
3160,3160,,0,10,10,216
3161,3161,,3,4,7,14
3162,3162,,0,5,5,46
3163,3163,,42,14,56,216
3164,3164,,0,1,1,113
3165,3165,,0,2,2,280
3166,3166,,0,7,7,46
3167,3167,,0,1,1,52
3168,3168,,28,29,57,74
3169,3169,,2,0,2,74
3170,3170,,0,3,3,46
3171,3171,,0,4,4,46
3172,3172,,5,6,11,41
3173,3173,,0,4,4,152
3174,3174,,0,2,2,815
3175,3175,,62,6,68,27
3176,3176,,0,31,31,204
3177,3177,,0,3,3,216
3178,3178,,6,6,12,30
3179,3179,,56,57,113,14
3180,3180,,0,5,5,301
3181,3181,,71,77,148,46
3182,3182,,23,24,47,73
3183,3183,,12,14,26,19
3184,3184,,51,53,104,67
3185,3185,,14,15,29,46
3186,3186,,28,45,73,33
3187,3187,,5,9,14,46
3188,3188,,23,25,48,41
3189,3189,,20,21,41,35
3190,3190,,0,1,1,804
3191,3191,,4,0,4,804
3192,3192,,0,2,2,46
3193,3193,,0,5,5,46
3194,3194,,0,2,2,67
3195,3195,,0,39,39,804
3196,3196,,0,56,56,40
3197,3197,,0,1,1,55
3198,3198,,0,3,3,96
3199,3199,,0,18,18,33
3200,3200,,10,11,21,58
3201,3201,,0,1,1,66
3202,3202,,3,0,3,66
3203,3203,,0,1,1,204
3204,3204,,19,20,39,259
3205,3205,,0,7,7,230
3206,3206,,0,1,1,113
3207,3207,,17,19,36,44
3208,3208,,0,3,3,46
3209,3209,,0,3,3,67
3210,3210,,21,22,43,34
3211,3211,,51,99,150,42
3212,3212,,0,40,40,204
3213,3213,,66,67,133,216
3214,3214,,11,13,24,26
3215,3215,,18,12,30,14
3216,3216,,24,25,49,804
3217,3217,,0,167,167,806
3218,3218,,5,6,11,59
3219,3219,,0,3,3,272
3220,3220,,0,169,169,40
3221,3221,,0,30,30,813
3222,3222,,0,22,22,216
3223,3223,,0,4,4,316
3224,3224,,0,31,31,204
3225,3225,,5,6,11,55
3226,3226,,1,70,71,316
3227,3227,,33,57,90,19
3228,3228,,29,30,59,56
3229,3229,,53,54,107,27
3230,3230,,39,8,47,216
3231,3231,,0,6,6,46
3232,3232,,2,6,8,73
3233,3233,,0,1,1,25
3234,3234,,0,13,13,187
3235,3235,,0,3,3,113
3236,3236,,48,49,97,144
3237,3237,,0,16,16,40
3238,3238,,4,15,19,30
3239,3239,,0,36,36,804
3240,3240,,0,13,13,216
3241,3241,,3,5,8,46
3242,3242,,7,8,15,35
3243,3243,,0,12,12,239
3244,3244,,0,3,3,26
3245,3245,,0,37,37,22
3246,3246,,28,29,57,55
3247,3247,,0,4,4,46
3248,3248,,0,2,2,804
3249,3249,,0,3,3,124
3250,3250,,3,0,3,124
3251,3251,,0,17,17,33
3252,3252,,11,8,19,36
3253,3253,,0,6,6,46
3254,3254,,0,7,7,46
3255,3255,,71,5,76,171
3256,3256,,1,2,3,260
3257,3257,,0,55,55,804
3258,3258,,0,1,1,46
3259,3259,,13,14,27,67
3260,3260,,0,3,3,171
3261,3261,,45,46,91,77
3262,3262,,0,23,23,818
3263,3263,,0,3,3,46
3264,3264,,3,0,3,46
3265,3265,,0,31,31,804
3266,3266,,0,3,3,46
3267,3267,,0,5,5,96
3268,3268,,0,19,19,804
3269,3269,,0,1,1,46
3270,3270,,7,2,9,37
3271,3271,,1,2,3,46
3272,3272,,5,70,75,57
3273,3273,,45,46,91,56
3274,3274,,2,3,5,96
3275,3275,,0,31,31,204
3276,3276,,0,1,1,804
3277,3277,,3,4,7,41
3278,3278,,11,12,23,38
3279,3279,,0,2,2,21
3280,3280,,0,7,7,77
3281,3281,,0,3,3,74
3282,3282,,5,6,11,260
3283,3283,,3,54,57,27
3284,3284,,19,21,40,46
3285,3285,,81,87,168,33
3286,3286,,47,48,95,14
3287,3287,,13,14,27,49
3288,3288,,9,10,19,272
3289,3289,,0,1,1,47
3290,3290,,58,59,117,40
3291,3291,,47,48,95,259
3292,3292,,0,2,2,46
3293,3293,,48,50,98,26
3294,3294,,0,4,4,46
3295,3295,,0,7,7,67
3296,3296,,14,15,29,152
3297,3297,,0,3,3,124
3298,3298,,0,1,1,44
3299,3299,,13,14,27,260
3300,3300,,0,1,1,73
3301,3301,,13,14,27,73
3302,3302,,48,23,71,59
3303,3303,,6,7,13,46
3304,3304,,0,2,2,46
3305,3305,,0,1,1,113
3306,3306,,27,29,56,44
3307,3307,,0,3,3,46
3308,3308,,1,2,3,260
3309,3309,,0,3,3,113
3310,3310,,5,6,11,55
3311,3311,,0,7,7,46
3312,3312,,17,18,35,280
3313,3313,,8,8,16,55
3314,3314,,4,6,10,46
3315,3315,,0,1,1,73
3316,3316,,0,1,1,21
3317,3317,,0,4,4,39
3318,3318,,2,11,13,46
3319,3319,,15,16,31,46
3320,3320,,0,1,1,19
3321,3321,,0,51,51,67
3322,3322,,0,1,1,260
3323,3323,,21,22,43,260
3324,3324,,0,1,1,27
3325,3325,,0,3,3,55
3326,3326,,0,1,1,57
3327,3327,,0,3,3,113
3328,3328,,0,3,3,53
3329,3329,,48,49,97,301
3330,3330,,5,7,12,259
3331,3331,,3,5,8,40
3332,3332,,0,5,5,46
3333,3333,,0,4,4,113
3334,3334,,6,6,12,113
3335,3335,,10,11,21,59
3336,3336,,0,4,4,46
3337,3337,,0,3,3,46
3338,3338,,33,34,67,96
3339,3339,,0,29,29,804
3340,3340,,56,57,113,42
3341,3341,,5,5,10,41
3342,3342,,0,222,222,805
3343,3343,,22,23,45,39
3344,3344,,44,46,90,46
3345,3345,,31,33,64,260
3346,3346,,12,14,26,77
3347,3347,,0,17,17,804
3348,3348,,1,2,3,14
3349,3349,,0,46,46,813
3350,3350,,10,11,21,260
3351,3351,,8,9,17,44
3352,3352,,0,37,37,239
3353,3353,,0,5,5,46
3354,3354,,15,16,31,44
3355,3355,,23,24,47,260
3356,3356,,29,31,60,44
3357,3357,,21,22,43,144
3358,3358,,13,14,27,73
3359,3359,,29,131,160,27
3360,3360,,55,56,111,35
3361,3361,,0,4,4,46
3362,3362,,12,13,25,46
3363,3363,,0,3,3,280
3364,3364,,0,76,76,260
3365,3365,,0,3,3,96
3366,3366,,10,11,21,133
3367,3367,,0,5,5,46
3368,3368,,37,38,75,73
3369,3369,,13,14,27,27
3370,3370,,0,3,3,47
3371,3371,,0,5,5,46
3372,3372,,7,8,15,73
3373,3373,,4,5,9,30
3374,3374,,0,2,2,216
3375,3375,,0,1,1,44
3376,3376,,65,66,131,256
3377,3377,,0,6,6,46
3378,3378,,29,30,59,804
3379,3379,,7,7,14,46
3380,3380,,10,11,21,90
3381,3381,,0,3,3,113
3382,3382,,31,32,63,30
3383,3383,,0,3,3,113
3384,3384,,0,16,16,204
3385,3385,,0,24,24,806
3386,3386,,0,25,25,204
3387,3387,,7,8,15,14
3388,3388,,17,18,35,272
3389,3389,,0,1,1,46
3390,3390,,0,33,33,21
3391,3391,,8,9,17,113
3392,3392,,0,5,5,46
3393,3393,,0,196,196,79
3394,3394,,0,4,4,77
3395,3395,,0,113,113,806
3396,3396,,0,4,4,216
3397,3397,,0,7,7,46
3398,3398,,0,4,4,204
3399,3399,,0,4,4,113
3400,3400,,0,10,10,46
3401,3401,,0,4,4,42
3402,3402,,0,3,3,81
3403,3403,,0,2,2,804
3404,3404,,0,2,2,56
3405,3405,,0,41,41,14
3406,3406,,0,2,2,77
3407,3407,,10,11,21,33
3408,3408,,0,79,79,204
3409,3409,,7,8,15,37
3410,3410,,0,7,7,46
3411,3411,,5,6,11,46
3412,3412,,10,12,22,67
3413,3413,,3,18,21,280
3414,3414,,0,3,3,46
3415,3415,,2,0,2,46
3416,3416,,93,63,156,815
3417,3417,,0,7,7,46
3418,3418,,0,3,3,77
3419,3419,,0,4,4,81
3420,3420,,0,3,3,67
3421,3421,,0,22,22,67
3422,3422,,15,16,31,46
3423,3423,,0,4,4,46
3424,3424,,0,20,20,804
3425,3425,,0,5,5,46
3426,3426,,0,15,15,40
3427,3427,,9,6,15,81
3428,3428,,0,3,3,216
3429,3429,,0,4,4,67
3430,3430,,37,93,130,40
3431,3431,,7,8,15,216
3432,3432,,11,12,23,47
3433,3433,,0,5,5,43
3434,3434,,0,1,1,46
3435,3435,,0,3,3,124
3436,3436,,0,4,4,46
3437,3437,,0,5,5,46
3438,3438,,1,2,3,171
3439,3439,,56,57,113,28
3440,3440,,0,5,5,804
3441,3441,,0,4,4,46
3442,3442,,0,41,41,216
3443,3443,,0,2,2,260
3444,3444,,30,32,62,57
3445,3445,,0,3,3,46
3446,3446,,0,1,1,50
3447,3447,,0,3,3,43
3448,3448,,0,2,2,81
3449,3449,,33,53,86,804
3450,3450,,0,98,98,804
3451,3451,,0,1,1,46
3452,3452,,0,19,19,813
3453,3453,,10,11,21,46
3454,3454,,13,14,27,30
3455,3455,,31,43,74,19
3456,3456,,0,3,3,67
3457,3457,,47,48,95,44
3458,3458,,19,20,39,42
3459,3459,,5,6,11,77
3460,3460,,0,45,45,804
3461,3461,,0,3,3,255
3462,3462,,0,3,3,46
3463,3463,,10,7,17,57
3464,3464,,5,6,11,259
3465,3465,,4,12,16,73
3466,3466,,0,14,14,187
3467,3467,,0,3,3,27
3468,3468,,0,4,4,46
3469,3469,,4,5,9,113
3470,3470,,16,17,33,124
3471,3471,,28,29,57,74
3472,3472,,0,49,49,804
3473,3473,,0,2,2,46
3474,3474,,71,73,144,46
3475,3475,,12,13,25,46
3476,3476,,33,34,67,96
3477,3477,,46,47,93,152
3478,3478,,0,3,3,204
3479,3479,,0,6,6,46
3480,3480,,0,3,3,46
3481,3481,,0,8,8,216
3482,3482,,0,3,3,67
3483,3483,,10,11,21,73
3484,3484,,0,2,2,73
3485,3485,,52,7,59,96
3486,3486,,40,41,81,56
3487,3487,,0,3,3,19
3488,3488,,58,59,117,49
3489,3489,,0,3,3,73
3490,3490,,0,2,2,56
3491,3491,,7,8,15,14
3492,3492,,3,5,8,57
3493,3493,,45,46,91,90
3494,3494,,0,221,221,806
3495,3495,,6,7,13,21
3496,3496,,0,14,14,804
3497,3497,,57,58,115,56
3498,3498,,65,49,114,27
3499,3499,,0,4,4,46
3500,3500,,0,11,11,260
3501,3501,,0,4,4,804
3502,3502,,0,2,2,272
3503,3503,,0,3,3,46
3504,3504,,10,11,21,27
3505,3505,,0,1,1,74
3506,3506,,0,29,29,239
3507,3507,,3,4,7,133
3508,3508,,0,3,3,260
3509,3509,,13,14,27,215
3510,3510,,18,19,37,46
3511,3511,,0,127,127,90
3512,3512,,0,12,12,815
3513,3513,,0,16,16,216
3514,3514,,47,67,114,27
3515,3515,,16,32,48,25
3516,3516,,10,12,22,260
3517,3517,,3,5,8,27
3518,3518,,0,9,9,46
3519,3519,,0,1,1,152
3520,3520,,3,4,7,260
3521,3521,,0,5,5,46
3522,3522,,15,18,33,260
3523,3523,,0,1,1,280
3524,3524,,4,5,9,113
3525,3525,,24,25,49,272
3526,3526,,4,5,9,14
3527,3527,,0,59,59,216
3528,3528,,18,19,37,27
3529,3529,,0,1,1,49
3530,3530,,0,40,40,216
3531,3531,,0,3,3,25
3532,3532,,37,39,76,74
3533,3533,,0,3,3,259
3534,3534,,45,46,91,25
3535,3535,,17,18,35,55
3536,3536,,54,56,110,259
3537,3537,,27,7,34,73
3538,3538,,10,11,21,26
3539,3539,,0,2,2,73
3540,3540,,0,3,3,74
3541,3541,,0,6,6,46
3542,3542,,0,7,7,46
3543,3543,,13,15,28,36
3544,3544,,0,3,3,113
3545,3545,,0,1,1,204
3546,3546,,0,40,40,813
3547,3547,,31,32,63,46
3548,3548,,54,55,109,813
3549,3549,,0,4,4,133
3550,3550,,54,56,110,41
3551,3551,,20,40,60,256
3552,3552,,20,21,41,39
3553,3553,,7,8,15,77
3554,3554,,26,14,40,41
3555,3555,,0,1,1,46
3556,3556,,0,2,2,41
3557,3557,,0,19,19,204
3558,3558,,0,1,1,77
3559,3559,,29,31,60,45
3560,3560,,19,3,22,96
3561,3561,,0,3,3,46
3562,3562,,0,21,21,67
3563,3563,,77,9,86,77
3564,3564,,0,4,4,96
3565,3565,,0,47,47,204
3566,3566,,4,6,10,44
3567,3567,,0,3,3,260
3568,3568,,19,11,30,79
3569,3569,,0,50,50,67
3570,3570,,47,48,95,259
3571,3571,,0,2,2,260
3572,3572,,0,4,4,73
3573,3573,,11,5,16,73
3574,3574,,6,7,13,43
3575,3575,,0,6,6,46
3576,3576,,31,32,63,262
3577,3577,,0,244,244,67
3578,3578,,0,1,1,37
3579,3579,,4,0,4,37
3580,3580,,0,18,18,804
3581,3581,,0,2,2,27
3582,3582,,21,22,43,47
3583,3583,,0,1,1,33
3584,3584,,0,9,9,25
3585,3585,,0,2,2,112
3586,3586,,0,6,6,73
3587,3587,,0,5,5,255
3588,3588,,2,0,2,255
3589,3589,,0,7,7,46
3590,3590,,0,3,3,144
3591,3591,,0,65,65,804
3592,3592,,0,274,274,804
3593,3593,,0,3,3,133
3594,3594,,0,132,132,806
3595,3595,,0,4,4,46
3596,3596,,0,1,1,46
3597,3597,,4,5,9,272
3598,3598,,37,38,75,260
3599,3599,,0,5,5,46
3600,3600,,0,91,91,216
3601,3601,,0,1,1,280
3602,3602,,25,33,58,46
3603,3603,,0,3,3,280
3604,3604,,3,20,23,38
3605,3605,,68,47,115,55
3606,3606,,0,1,1,46
3607,3607,,49,51,100,113
3608,3608,,0,3,3,19
3609,3609,,49,51,100,262
3610,3610,,0,3,3,152
3611,3611,,16,18,34,47
3612,3612,,0,21,21,216
3613,3613,,0,3,3,46
3614,3614,,0,1,1,113
3615,3615,,0,4,4,77
3616,3616,,0,35,35,804
3617,3617,,14,15,29,67
3618,3618,,1,2,3,804
3619,3619,,0,4,4,46
3620,3620,,0,14,14,239
3621,3621,,27,28,55,53
3622,3622,,6,7,13,144
3623,3623,,40,52,92,260
3624,3624,,66,45,111,48
3625,3625,,0,1,1,90
3626,3626,,0,16,16,204
3627,3627,,3,4,7,49
3628,3628,,7,8,15,144
3629,3629,,0,3,3,46
3630,3630,,4,5,9,44
3631,3631,,3,4,7,49
3632,3632,,46,3,49,255
3633,3633,,0,1,1,77
3634,3634,,58,59,117,19
3635,3635,,5,6,11,27
3636,3636,,41,43,84,55
3637,3637,,4,5,9,42
3638,3638,,0,1,1,50
3639,3639,,33,34,67,256
3640,3640,,8,9,17,256
3641,3641,,0,3,3,73
3642,3642,,7,9,16,216
3643,3643,,30,32,62,260
3644,3644,,26,27,53,260
3645,3645,,25,26,51,260
3646,3646,,5,6,11,216
3647,3647,,0,31,31,813
3648,3648,,49,50,99,51
3649,3649,,33,34,67,96
3650,3650,,5,6,11,55
3651,3651,,4,5,9,27
3652,3652,,0,4,4,144
3653,3653,,40,52,92,42
3654,3654,,0,44,44,152
3655,3655,,6,7,13,42
3656,3656,,3,4,7,260
3657,3657,,33,34,67,67
3658,3658,,127,2,129,316
3659,3659,,0,93,93,14
3660,3660,,0,1,1,47
3661,3661,,6,7,13,90
3662,3662,,27,28,55,46
3663,3663,,22,23,45,40
3664,3664,,52,54,106,59
3665,3665,,0,22,22,216
3666,3666,,0,12,12,243
3667,3667,,121,122,243,280
3668,3668,,36,37,73,187
3669,3669,,0,7,7,77
3670,3670,,0,4,4,46
3671,3671,,0,1,1,27
3672,3672,,0,3,3,29
3673,3673,,41,42,83,81
3674,3674,,0,33,33,124
3675,3675,,1,2,3,813
3676,3676,,0,2,2,52
3677,3677,,7,7,14,56
3678,3678,,6,7,13,42
3679,3679,,10,11,21,59
3680,3680,,0,2,2,815
3681,3681,,0,12,12,216
3682,3682,,0,3,3,260
3683,3683,,30,31,61,260
3684,3684,,0,17,17,14
3685,3685,,9,10,19,216
3686,3686,,0,2,2,57
3687,3687,,0,3,3,260
3688,3688,,0,3,3,46
3689,3689,,0,1,1,813
3690,3690,,6,8,14,46
3691,3691,,0,1,1,21
3692,3692,,25,26,51,113
3693,3693,,0,28,28,22
3694,3694,,6,7,13,260
3695,3695,,0,5,5,46
3696,3696,,0,3,3,46
3697,3697,,0,2,2,46
3698,3698,,0,10,10,22
3699,3699,,0,2,2,67
3700,3700,,0,1,1,14
3701,3701,,11,12,23,43
3702,3702,,0,4,4,260
3703,3703,,2,31,33,262
3704,3704,,63,4,67,26
3705,3705,,20,21,41,96
3706,3706,,0,207,207,806
3707,3707,,0,42,42,204
3708,3708,,33,34,67,260
3709,3709,,0,20,20,804
3710,3710,,9,10,19,40
3711,3711,,10,11,21,133
3712,3712,,0,1,1,22
3713,3713,,23,24,47,41
3714,3714,,0,2,2,46
3715,3715,,0,3,3,46
3716,3716,,0,1,1,21
3717,3717,,0,14,14,216
3718,3718,,30,31,61,812
3719,3719,,9,10,19,59
3720,3720,,6,7,13,30
3721,3721,,10,11,21,73
3722,3722,,6,15,21,41
3723,3723,,0,7,7,262
3724,3724,,0,8,8,46
3725,3725,,0,35,35,216
3726,3726,,0,38,38,815
3727,3727,,4,5,9,56
3728,3728,,0,3,3,73
3729,3729,,33,34,67,804
3730,3730,,0,4,4,46
3731,3731,,0,2,2,46
3732,3732,,27,28,55,215
3733,3733,,0,3,3,46
3734,3734,,0,191,191,806
3735,3735,,34,35,69,813
3736,3736,,59,8,67,67
3737,3737,,0,3,3,260
3738,3738,,51,6,57,216
3739,3739,,0,3,3,260
3740,3740,,0,3,3,216
3741,3741,,0,3,3,46
3742,3742,,0,1,1,46
3743,3743,,0,19,19,216
3744,3744,,0,3,3,204
3745,3745,,24,25,49,67
3746,3746,,4,10,14,81
3747,3747,,0,53,53,152
3748,3748,,14,15,29,54
3749,3749,,0,4,4,25
3750,3750,,0,11,11,804
3751,3751,,29,30,59,30
3752,3752,,60,60,120,47
3753,3753,,24,25,49,27
3754,3754,,0,6,6,46
3755,3755,,42,44,86,260
3756,3756,,7,8,15,813
3757,3757,,0,208,208,806
3758,3758,,0,63,63,74
3759,3759,,0,40,40,216
3760,3760,,0,3,3,260
3761,3761,,0,8,8,46
3762,3762,,17,19,36,55
3763,3763,,15,126,141,47
3764,3764,,131,133,264,37
3765,3765,,37,38,75,259
3766,3766,,0,41,41,90
3767,3767,,0,4,4,255
3768,3768,,0,1,1,804
3769,3769,,28,29,57,33
3770,3770,,45,12,57,47
3771,3771,,14,15,29,112
3772,3772,,1,2,3,260
3773,3773,,0,1,1,260
3774,3774,,0,36,36,813
3775,3775,,13,14,27,49
3776,3776,,13,14,27,77
3777,3777,,38,15,53,256
3778,3778,,30,31,61,79
3779,3779,,0,3,3,204
3780,3780,,0,3,3,67
3781,3781,,8,9,17,56
3782,3782,,0,1,1,46
3783,3783,,0,91,91,812
3784,3784,,21,22,43,216
3785,3785,,40,42,82,57
3786,3786,,0,29,29,21
3787,3787,,0,48,48,67
3788,3788,,10,12,22,58
3789,3789,,20,26,46,59
3790,3790,,50,52,102,171
3791,3791,,54,55,109,144
3792,3792,,13,14,27,30
3793,3793,,0,5,5,44
3794,3794,,16,17,33,59
3795,3795,,10,11,21,316
3796,3796,,0,3,3,152
3797,3797,,0,224,224,806
3798,3798,,0,3,3,46
3799,3799,,0,268,268,806
3800,3800,,16,20,36,50
3801,3801,,36,37,73,0
3802,3802,,0,4,4,272
3803,3803,,0,27,27,804
3804,3804,,0,5,5,46
3805,3805,,0,1,1,38
3806,3806,,0,67,67,806
3807,3807,,19,20,39,49
3808,3808,,0,29,29,60
3809,3809,,21,0,21,60
3810,3810,,0,42,42,61
3811,3811,,38,0,38,61
3812,3812,,0,147,147,77
3813,3813,,92,0,92,77
3814,3814,,24,0,24,46
3815,3815,,26,0,26,90
3816,3816,,51,0,51,79
3817,3817,,0,7,7,62
3818,3818,,7,0,7,62
3819,3819,,7,0,7,30
3820,3820,,0,40,40,63
3821,3821,,40,0,40,63
3822,3822,,45,0,45,152
3823,3823,,322,0,322,67
3824,3824,,38,0,38,152
3825,3825,,0,2,2,77
3826,3826,,4,0,4,77
3827,3827,,31,0,31,90
3828,3828,,20,0,20,152
3829,3829,,0,24,24,67
3830,3830,,19,0,19,67
3831,3831,,101,0,101,124
3832,3832,,0,2,2,64
3833,3833,,2,0,2,64
3834,3834,,6,0,6,255
3835,3835,,0,48,48,67
3836,3836,,23,0,23,67
3837,3837,,31,0,31,152
3838,3838,,0,110,110,90
3839,3839,,43,0,43,90
3840,3840,,148,0,148,65
3841,3841,,2,0,2,255
3842,3842,,0,86,86,152
3843,3843,,32,0,32,152
3844,3844,,0,22,22,124
3845,3845,,14,0,14,77
3846,3846,,534,0,534,66
3847,3847,,4,0,4,61
3848,3848,,255,0,255,67
3849,3849,,0,0,0,68
3850,3850,,47,0,47,67
3851,3851,,34,0,34,112
3852,3852,,86,0,86,90
3853,3853,,39,0,39,90
3854,3854,,0,53,53,124
3855,3855,,30,0,30,124
3856,3856,,0,0,0,69
3857,3857,,0,0,0,70
3858,3858,,127,0,127,90
3859,3859,,0,35,35,71
3860,3860,,56,0,56,71
3861,3861,,0,3,3,46
3862,3862,,0,0,0,72
3863,3863,,0,17,17,124
3864,3864,,11,0,11,124
3865,3865,,33,0,33,67
3866,3866,,0,18,18,112
3867,3867,,11,0,11,112
3868,3868,,22,0,22,18
3869,3869,,0,1,1,67
3870,3870,,262,0,262,67
3871,3871,,68,0,68,152
3872,3872,,52,0,52,67
3873,3873,,0,20,20,75
3874,3874,,20,0,20,75
3875,3875,,0,12,12,67
3876,3876,,0,4,4,79
3877,3877,,0,4,4,90
3878,3878,,128,0,128,90
3879,3879,,0,79,79,76
3880,3880,,79,0,79,76
3881,3881,,8,0,8,280
3882,3882,,0,12,12,152
3883,3883,,11,0,11,260
3884,3884,,60,0,60,67
3885,3885,,48,0,48,77
3886,3886,,17,0,17,113
3887,3887,,7,0,7,124
3888,3888,,0,13,13,77
3889,3889,,30,0,30,77
3890,3890,,50,0,50,124
3891,3891,,0,25,25,124
3892,3892,,10,0,10,124
3893,3893,,0,26,26,152
3894,3894,,47,0,47,152
3895,3895,,29,0,29,90
3896,3896,,0,0,0,78
3897,3897,,44,0,44,79
3898,3898,,0,3,3,80
3899,3899,,3,0,3,80
3900,3900,,0,155,155,67
3901,3901,,0,92,92,121
3902,3902,,69,0,69,121
3903,3903,,0,142,142,152
3904,3904,,29,0,29,152
3905,3905,,17,169,186,112
3906,3906,,20,0,20,112
3907,3907,,0,183,183,82
3908,3908,,95,0,95,82
3909,3909,,22,0,22,90
3910,3910,,23,0,23,67
3911,3911,,0,10,10,83
3912,3912,,10,0,10,83
3913,3913,,6,0,6,112
3914,3914,,0,4,4,255
3915,3915,,6,0,6,255
3916,3916,,0,29,29,101
3917,3917,,13,0,13,101
3918,3918,,0,0,0,84
3919,3919,,0,0,0,85
3920,3920,,0,6,6,86
3921,3921,,6,0,6,86
3922,3922,,0,28,28,152
3923,3923,,22,0,22,152
3924,3924,,115,0,115,124
3925,3925,,3,0,3,67
3926,3926,,0,28,28,67
3927,3927,,25,0,25,67
3928,3928,,0,5,5,149
3929,3929,,12,0,12,149
3930,3930,,0,0,0,87
3931,3931,,49,0,49,90
3932,3932,,0,61,61,90
3933,3933,,21,0,21,90
3934,3934,,0,24,24,133
3935,3935,,9,0,9,133
3936,3936,,0,55,55,77
3937,3937,,157,0,157,77
3938,3938,,6,0,6,90
3939,3939,,0,40,40,152
3940,3940,,9,0,9,152
3941,3941,,50,0,50,81
3942,3942,,0,223,223,112
3943,3943,,122,0,122,112
3944,3944,,30,0,30,90
3945,3945,,0,23,23,88
3946,3946,,23,0,23,88
3947,3947,,0,46,46,77
3948,3948,,33,0,33,77
3949,3949,,0,0,0,89
3950,3950,,219,0,219,90
3951,3951,,0,14,14,124
3952,3952,,0,26,26,67
3953,3953,,18,0,18,67
3954,3954,,44,0,44,67
3955,3955,,0,6,6,91
3956,3956,,6,0,6,91
3957,3957,,33,0,33,152
3958,3958,,0,34,34,67
3959,3959,,0,30,30,112
3960,3960,,48,0,48,112
3961,3961,,0,22,22,92
3962,3962,,22,0,22,92
3963,3963,,0,26,26,93
3964,3964,,26,0,26,93
3965,3965,,40,0,40,81
3966,3966,,0,131,131,152
3967,3967,,173,0,173,152
3968,3968,,0,2,2,67
3969,3969,,6,0,6,67
3970,3970,,0,79,79,94
3971,3971,,69,0,69,94
3972,3972,,0,12,12,67
3973,3973,,5,0,5,67
3974,3974,,0,41,41,67
3975,3975,,29,0,29,67
3976,3976,,25,0,25,152
3977,3977,,8,0,8,90
3978,3978,,0,0,0,95
3979,3979,,2,0,2,96
3980,3980,,0,9,9,97
3981,3981,,9,0,9,97
3982,3982,,0,3,3,98
3983,3983,,3,0,3,98
3984,3984,,0,53,53,99
3985,3985,,52,0,52,99
3986,3986,,0,27,27,74
3987,3987,,33,0,33,74
3988,3988,,0,30,30,90
3989,3989,,0,32,32,152
3990,3990,,0,6,6,100
3991,3991,,6,0,6,100
3992,3992,,0,30,30,79
3993,3993,,72,0,72,79
3994,3994,,5,0,5,152
3995,3995,,2,0,2,67
3996,3996,,0,2,2,46
3997,3997,,10,0,10,67
3998,3998,,0,30,30,67
3999,3999,,0,30,30,112
4000,4000,,6,0,6,77
4001,4001,,16,0,16,101
4002,4002,,67,0,67,112
4003,4003,,6,0,6,67
4004,4004,,12,0,12,113
4005,4005,,4,0,4,112
4006,4006,,45,0,45,79
4007,4007,,0,21,21,152
4008,4008,,28,0,28,152
4009,4009,,0,0,0,102
4010,4010,,0,0,0,103
4011,4011,,21,0,21,46
4012,4012,,15,0,15,77
4013,4013,,37,0,37,90
4014,4014,,0,33,33,152
4015,4015,,0,4,4,136
4016,4016,,2,0,2,136
4017,4017,,0,2,2,104
4018,4018,,2,0,2,104
4019,4019,,0,14,14,77
4020,4020,,16,0,16,77
4021,4021,,0,2,2,105
4022,4022,,2,0,2,105
4023,4023,,0,5,5,67
4024,4024,,6,0,6,67
4025,4025,,87,0,87,82
4026,4026,,30,0,30,124
4027,4027,,97,0,97,112
4028,4028,,91,0,91,90
4029,4029,,0,34,34,106
4030,4030,,34,0,34,106
4031,4031,,0,42,42,90
4032,4032,,82,0,82,90
4033,4033,,32,0,32,112
4034,4034,,0,0,0,107
4035,4035,,24,0,24,152
4036,4036,,0,6,6,67
4037,4037,,127,0,127,121
4038,4038,,0,66,66,112
4039,4039,,166,0,166,108
4040,4040,,0,41,41,109
4041,4041,,41,0,41,109
4042,4042,,8,0,8,154
4043,4043,,2,0,2,110
4044,4044,,0,12,12,124
4045,4045,,0,178,178,66
4046,4046,,0,37,37,152
4047,4047,,40,0,40,152
4048,4048,,0,28,28,111
4049,4049,,28,0,28,111
4050,4050,,0,23,23,77
4051,4051,,4,0,4,260
4052,4052,,0,18,18,112
4053,4053,,0,15,15,113
4054,4054,,9,0,9,113
4055,4055,,15,5,20,124
4056,4056,,0,20,20,113
4057,4057,,24,0,24,113
4058,4058,,0,27,27,67
4059,4059,,14,0,14,67
4060,4060,,0,41,41,67
4061,4061,,0,7,7,114
4062,4062,,7,178,185,114
4063,4063,,31,0,31,124
4064,4064,,30,0,30,90
4065,4065,,0,6,6,30
4066,4066,,27,0,27,30
4067,4067,,0,30,30,115
4068,4068,,30,0,30,115
4069,4069,,0,88,88,18
4070,4070,,39,0,39,18
4071,4071,,5,0,5,67
4072,4072,,6,0,6,260
4073,4073,,104,0,104,112
4074,4074,,0,14,14,46
4075,4075,,5,0,5,46
4076,4076,,0,5,5,67
4077,4077,,0,14,14,90
4078,4078,,20,0,20,90
4079,4079,,2,0,2,67
4080,4080,,0,37,37,67
4081,4081,,13,0,13,77
4082,4082,,0,20,20,67
4083,4083,,13,0,13,67
4084,4084,,4,0,4,46
4085,4085,,52,0,52,141
4086,4086,,0,8,8,152
4087,4087,,13,0,13,90
4088,4088,,0,124,124,116
4089,4089,,124,0,124,116
4090,4090,,57,5,62,67
4091,4091,,0,8,8,67
4092,4092,,0,0,0,117
4093,4093,,0,1,1,118
4094,4094,,0,0,0,119
4095,4095,,0,6,6,120
4096,4096,,6,0,6,120
4097,4097,,60,0,60,152
4098,4098,,6,0,6,90
4099,4099,,36,0,36,124
4100,4100,,0,25,25,77
4101,4101,,0,71,71,152
4102,4102,,52,0,52,152
4103,4103,,0,8,8,67
4104,4104,,0,52,52,121
4105,4105,,62,0,62,121
4106,4106,,0,3,3,77
4107,4107,,1,0,1,77
4108,4108,,0,20,20,122
4109,4109,,20,0,20,122
4110,4110,,0,0,0,123
4111,4111,,49,0,49,124
4112,4112,,0,3,3,125
4113,4113,,3,0,3,112
4114,4114,,0,21,21,77
4115,4115,,23,0,23,77
4116,4116,,0,15,15,77
4117,4117,,0,20,20,30
4118,4118,,0,25,25,126
4119,4119,,25,0,25,126
4120,4120,,40,0,40,14
4121,4121,,8,0,8,46
4122,4122,,0,12,12,127
4123,4123,,12,0,12,127
4124,4124,,78,0,78,67
4125,4125,,0,0,0,128
4126,4126,,0,37,37,90
4127,4127,,0,1,1,46
4128,4128,,0,0,0,129
4129,4129,,0,0,0,130
4130,4130,,43,0,43,140
4131,4131,,0,40,40,67
4132,4132,,0,5,5,131
4133,4133,,5,0,5,131
4134,4134,,0,86,86,132
4135,4135,,44,0,44,132
4136,4136,,4,178,182,152
4137,4137,,22,0,22,133
4138,4138,,0,24,24,67
4139,4139,,0,112,112,67
4140,4140,,10,0,10,67
4141,4141,,0,39,39,134
4142,4142,,39,0,39,134
4143,4143,,3,0,3,94
4144,4144,,0,56,56,152
4145,4145,,14,0,14,152
4146,4146,,5,0,5,260
4147,4147,,23,0,23,152
4148,4148,,0,12,12,74
4149,4149,,15,0,15,74
4150,4150,,11,0,11,30
4151,4151,,0,0,0,135
4152,4152,,14,0,14,67
4153,4153,,2,0,2,136
4154,4154,,0,18,18,77
4155,4155,,0,15,15,29
4156,4156,,3,0,3,29
4157,4157,,0,0,0,137
4158,4158,,22,0,22,79
4159,4159,,0,3,3,67
4160,4160,,6,0,6,67
4161,4161,,28,0,28,44
4162,4162,,0,16,16,90
4163,4163,,0,0,0,138
4164,4164,,0,28,28,139
4165,4165,,28,0,28,139
4166,4166,,0,39,39,77
4167,4167,,55,0,55,77
4168,4168,,0,43,43,140
4169,4169,,47,0,47,18
4170,4170,,2,0,2,260
4171,4171,,46,0,46,18
4172,4172,,6,0,6,77
4173,4173,,47,0,47,90
4174,4174,,62,0,62,141
4175,4175,,42,0,42,132
4176,4176,,0,1,1,142
4177,4177,,1,0,1,142
4178,4178,,0,16,16,143
4179,4179,,16,0,16,143
4180,4180,,77,0,77,67
4181,4181,,0,3,3,145
4182,4182,,3,0,3,145
4183,4183,,2,0,2,112
4184,4184,,0,19,19,77
4185,4185,,0,19,19,152
4186,4186,,4,0,4,152
4187,4187,,0,19,19,67
4188,4188,,25,0,25,67
4189,4189,,59,0,59,152
4190,4190,,0,0,0,146
4191,4191,,0,0,0,147
4192,4192,,1,0,1,77
4193,4193,,0,18,18,148
4194,4194,,18,0,18,148
4195,4195,,0,7,7,149
4196,4196,,25,0,25,77
4197,4197,,0,0,0,150
4198,4198,,32,0,32,152
4199,4199,,0,27,27,151
4200,4200,,27,0,27,151
4201,4201,,4,0,4,44
4202,4202,,178,0,178,66
4203,4203,,7,0,7,94
4204,4204,,56,0,56,152
4205,4205,,0,63,63,121
4206,4206,,5,0,5,112
4207,4207,,31,0,31,90
4208,4208,,0,21,21,71
4209,4209,,0,0,0,153
4210,4210,,43,0,43,154
4211,4211,,74,0,74,81
4212,4212,,0,45,45,133
4213,4213,,43,0,43,133
4214,4214,,8,0,8,60
4215,4215,,0,0,0,155
4216,4216,,0,0,0,156
4217,4217,,0,7,7,77
4218,4218,,0,31,31,90
4219,4219,,8,0,8,90
4220,4220,,0,3,3,112
4221,4221,,0,0,0,157
4222,4222,,0,0,0,158
4223,4223,,0,4,4,67
4224,4224,,0,74,74,159
4225,4225,,74,0,74,159
4226,4226,,2,0,2,67
4227,4227,,59,0,59,152
4228,4228,,0,0,0,160
4229,4229,,0,132,132,316
4230,4230,,134,0,134,316
4231,4231,,5,0,5,124
4232,4232,,13,0,13,29
4233,4233,,0,2,2,216
4234,4234,,2,0,2,183
4235,4235,,0,18,18,204
4236,4236,,338,0,338,204
4237,4237,,0,16,16,204
4238,4238,,348,0,348,204
4239,4239,,0,19,19,204
4240,4240,,152,0,152,204
4241,4241,,0,1,1,216
4242,4242,,2,0,2,216
4243,4243,,0,18,18,204
4244,4244,,6,0,6,204
4245,4245,,0,10,10,204
4246,4246,,25,0,25,204
4247,4247,,0,31,31,204
4248,4248,,0,9,9,187
4249,4249,,18,0,18,216
4250,4250,,25,0,25,216
4251,4251,,0,9,9,216
4252,4252,,0,0,0,161
4253,4253,,48,0,48,204
4254,4254,,22,0,22,216
4255,4255,,0,4,4,204
4256,4256,,1,0,1,204
4257,4257,,16,0,16,204
4258,4258,,0,23,23,204
4259,4259,,36,0,36,204
4260,4260,,0,42,42,216
4261,4261,,16,0,16,216
4262,4262,,48,0,48,216
4263,4263,,0,25,25,216
4264,4264,,7,0,7,216
4265,4265,,1,0,1,216
4266,4266,,0,18,18,204
4267,4267,,106,0,106,204
4268,4268,,1,0,1,204
4269,4269,,0,368,368,216
4270,4270,,26,0,26,216
4271,4271,,0,19,19,204
4272,4272,,21,0,21,204
4273,4273,,32,0,32,216
4274,4274,,0,40,40,204
4275,4275,,16,0,16,204
4276,4276,,0,7,7,216
4277,4277,,44,0,44,216
4278,4278,,0,4,4,216
4279,4279,,32,0,32,216
4280,4280,,0,40,40,204
4281,4281,,25,0,25,204
4282,4282,,0,34,34,204
4283,4283,,114,0,114,204
4284,4284,,115,0,115,216
4285,4285,,12,0,12,204
4286,4286,,0,7,7,204
4287,4287,,0,0,0,162
4288,4288,,0,18,18,243
4289,4289,,5,0,5,243
4290,4290,,18,0,18,204
4291,4291,,173,0,173,204
4292,4292,,0,40,40,216
4293,4293,,37,0,37,216
4294,4294,,14,0,14,204
4295,4295,,0,14,14,204
4296,4296,,15,0,15,216
4297,4297,,0,41,41,204
4298,4298,,0,43,43,204
4299,4299,,25,0,25,204
4300,4300,,0,31,31,204
4301,4301,,10,0,10,204
4302,4302,,0,10,10,216
4303,4303,,5,0,5,216
4304,4304,,2,0,2,204
4305,4305,,0,16,16,204
4306,4306,,0,0,0,163
4307,4307,,0,8,8,187
4308,4308,,0,1,1,216
4309,4309,,15,0,15,216
4310,4310,,118,0,118,216
4311,4311,,0,44,44,204
4312,4312,,0,3,3,216
4313,4313,,18,0,18,216
4314,4314,,29,0,29,204
4315,4315,,0,0,0,164
4316,4316,,0,16,16,204
4317,4317,,83,0,83,204
4318,4318,,0,8,8,187
4319,4319,,3,0,3,204
4320,4320,,0,50,50,204
4321,4321,,26,0,26,204
4322,4322,,0,31,31,204
4323,4323,,157,0,157,204
4324,4324,,44,0,44,204
4325,4325,,4,0,4,243
4326,4326,,0,19,19,216
4327,4327,,22,0,22,216
4328,4328,,0,40,40,204
4329,4329,,38,0,38,204
4330,4330,,10,0,10,216
4331,4331,,34,0,34,216
4332,4332,,0,0,0,165
4333,4333,,27,0,27,216
4334,4334,,0,10,10,216
4335,4335,,27,0,27,216
4336,4336,,0,0,0,166
4337,4337,,30,0,30,216
4338,4338,,7,0,7,243
4339,4339,,32,0,32,216
4340,4340,,0,44,44,204
4341,4341,,9,0,9,204
4342,4342,,64,0,64,216
4343,4343,,0,6,6,204
4344,4344,,7,4,11,215
4345,4345,,1,0,1,204
4346,4346,,4,22,26,204
4347,4347,,14,0,14,243
4348,4348,,240,0,240,204
4349,4349,,0,5,5,204
4350,4350,,5,0,5,204
4351,4351,,0,46,46,204
4352,4352,,22,0,22,204
4353,4353,,2,0,2,33
4354,4354,,35,0,35,216
4355,4355,,0,33,33,204
4356,4356,,6,0,6,204
4357,4357,,4,0,4,243
4358,4358,,20,0,20,204
4359,4359,,0,46,46,216
4360,4360,,9,0,9,216
4361,4361,,0,16,16,204
4362,4362,,8,0,8,204
4363,4363,,4,0,4,216
4364,4364,,7,0,7,74
4365,4365,,0,32,32,204
4366,4366,,28,0,28,204
4367,4367,,0,70,70,204
4368,4368,,2,0,2,216
4369,4369,,0,40,40,204
4370,4370,,108,0,108,204
4371,4371,,9,0,9,204
4372,4372,,11,0,11,216
4373,4373,,0,20,20,204
4374,4374,,9,0,9,239
4375,4375,,0,44,44,216
4376,4376,,12,0,12,216
4377,4377,,6,0,6,216
4378,4378,,39,0,39,216
4379,4379,,0,11,11,204
4380,4380,,4,0,4,216
4381,4381,,0,8,8,216
4382,4382,,10,0,10,216
4383,4383,,0,62,62,204
4384,4384,,27,0,27,204
4385,4385,,0,20,20,204
4386,4386,,21,0,21,204
4387,4387,,12,0,12,216
4388,4388,,18,0,18,204
4389,4389,,9,0,9,248
4390,4390,,10,0,10,216
4391,4391,,0,5,5,243
4392,4392,,0,0,0,167
4393,4393,,0,39,39,204
4394,4394,,10,0,10,204
4395,4395,,0,5,5,216
4396,4396,,0,62,62,204
4397,4397,,6,0,6,204
4398,4398,,0,90,90,204
4399,4399,,0,22,22,239
4400,4400,,12,0,12,204
4401,4401,,0,12,12,204
4402,4402,,0,49,49,216
4403,4403,,24,0,24,74
4404,4404,,0,10,10,216
4405,4405,,9,0,9,216
4406,4406,,0,28,28,204
4407,4407,,35,0,35,216
4408,4408,,9,0,9,216
4409,4409,,0,10,10,204
4410,4410,,13,0,13,204
4411,4411,,4,0,4,216
4412,4412,,10,0,10,204
4413,4413,,0,35,35,204
4414,4414,,8,0,8,204
4415,4415,,0,30,30,243
4416,4416,,35,0,35,243
4417,4417,,0,23,23,216
4418,4418,,2,0,2,216
4419,4419,,0,22,22,204
4420,4420,,23,0,23,204
4421,4421,,0,52,52,204
4422,4422,,42,0,42,204
4423,4423,,0,18,18,216
4424,4424,,16,0,16,216
4425,4425,,20,0,20,204
4426,4426,,2,0,2,239
4427,4427,,0,41,41,204
4428,4428,,6,0,6,204
4429,4429,,8,0,8,204
4430,4430,,33,0,33,204
4431,4431,,1,0,1,216
4432,4432,,0,17,17,204
4433,4433,,0,10,10,204
4434,4434,,24,0,24,204
4435,4435,,3,0,3,239
4436,4436,,24,0,24,216
4437,4437,,12,0,12,204
4438,4438,,0,62,62,204
4439,4439,,32,0,32,204
4440,4440,,0,63,63,204
4441,4441,,9,0,9,204
4442,4442,,0,1,1,216
4443,4443,,17,0,17,204
4444,4444,,0,20,20,204
4445,4445,,35,0,35,204
4446,4446,,0,4,4,204
4447,4447,,3,0,3,204
4448,4448,,12,0,12,74
4449,4449,,0,2,2,204
4450,4450,,8,0,8,216
4451,4451,,0,4,4,216
4452,4452,,23,0,23,216
4453,4453,,0,8,8,204
4454,4454,,14,0,14,204
4455,4455,,0,14,14,74
4456,4456,,96,0,96,204
4457,4457,,0,11,11,243
4458,4458,,15,0,15,243
4459,4459,,0,18,18,204
4460,4460,,0,0,0,168
4461,4461,,0,10,10,204
4462,4462,,0,9,9,216
4463,4463,,8,0,8,204
4464,4464,,0,10,10,204
4465,4465,,5,0,5,204
4466,4466,,2,0,2,216
4467,4467,,0,21,21,204
4468,4468,,0,19,19,216
4469,4469,,21,0,21,216
4470,4470,,0,0,0,169
4471,4471,,3,0,3,216
4472,4472,,114,0,114,216
4473,4473,,0,36,36,204
4474,4474,,0,15,15,216
4475,4475,,9,0,9,216
4476,4476,,140,0,140,216
4477,4477,,44,0,44,204
4478,4478,,23,0,23,216
4479,4479,,10,0,10,216
4480,4480,,0,15,15,216
4481,4481,,41,0,41,216
4482,4482,,0,3,3,171
4483,4483,,2,0,2,243
4484,4484,,0,0,0,170
4485,4485,,36,0,36,204
4486,4486,,11,0,11,216
4487,4487,,109,0,109,216
4488,4488,,0,16,16,204
4489,4489,,146,0,146,204
4490,4490,,0,14,14,204
4491,4491,,76,0,76,204
4492,4492,,63,0,63,216
4493,4493,,0,27,27,204
4494,4494,,45,0,45,216
4495,4495,,0,43,43,204
4496,4496,,24,0,24,204
4497,4497,,0,9,9,216
4498,4498,,3,0,3,216
4499,4499,,0,21,21,216
4500,4500,,0,15,15,216
4501,4501,,61,0,61,216
4502,4502,,0,25,25,204
4503,4503,,3,0,3,204
4504,4504,,15,0,15,216
4505,4505,,0,6,6,216
4506,4506,,18,0,18,204
4507,4507,,0,22,22,243
4508,4508,,23,0,23,243
4509,4509,,48,0,48,204
4510,4510,,0,27,27,216
4511,4511,,5,0,5,216
4512,4512,,22,0,22,204
4513,4513,,11,0,11,216
4514,4514,,0,22,22,204
4515,4515,,19,0,19,204
4516,4516,,0,48,48,204
4517,4517,,0,0,0,172
4518,4518,,7,0,7,74
4519,4519,,11,0,11,216
4520,4520,,53,0,53,204
4521,4521,,6,0,6,204
4522,4522,,2,0,2,204
4523,4523,,0,22,22,204
4524,4524,,34,0,34,216
4525,4525,,0,25,25,204
4526,4526,,9,0,9,204
4527,4527,,0,0,0,173
4528,4528,,0,0,0,174
4529,4529,,0,12,12,216
4530,4530,,25,0,25,204
4531,4531,,0,40,40,204
4532,4532,,13,0,13,204
4533,4533,,0,12,12,216
4534,4534,,0,24,24,204
4535,4535,,23,0,23,204
4536,4536,,0,14,14,204
4537,4537,,20,0,20,204
4538,4538,,30,0,30,216
4539,4539,,14,0,14,204
4540,4540,,0,44,44,216
4541,4541,,16,0,16,204
4542,4542,,40,0,40,216
4543,4543,,0,0,0,175
4544,4544,,2,0,2,204
4545,4545,,0,0,0,176
4546,4546,,0,3,3,204
4547,4547,,5,0,5,204
4548,4548,,0,37,37,215
4549,4549,,41,0,41,215
4550,4550,,0,33,33,216
4551,4551,,0,18,18,204
4552,4552,,6,0,6,204
4553,4553,,3,0,3,204
4554,4554,,0,19,19,216
4555,4555,,5,0,5,216
4556,4556,,4,0,4,216
4557,4557,,0,0,0,177
4558,4558,,10,0,10,216
4559,4559,,27,0,27,216
4560,4560,,2,0,2,204
4561,4561,,6,0,6,171
4562,4562,,0,2,2,216
4563,4563,,0,20,20,216
4564,4564,,0,0,0,178
4565,4565,,2,0,2,813
4566,4566,,0,44,44,204
4567,4567,,35,0,35,204
4568,4568,,0,8,8,204
4569,4569,,0,22,22,216
4570,4570,,8,0,8,204
4571,4571,,0,30,30,204
4572,4572,,16,0,16,204
4573,4573,,5,0,5,216
4574,4574,,15,0,15,243
4575,4575,,3,0,3,239
4576,4576,,0,22,22,204
4577,4577,,43,0,43,216
4578,4578,,0,14,14,243
4579,4579,,0,0,0,179
4580,4580,,0,26,26,204
4581,4581,,0,61,61,204
4582,4582,,14,0,14,204
4583,4583,,0,52,52,216
4584,4584,,21,0,21,204
4585,4585,,0,1,1,204
4586,4586,,55,0,55,216
4587,4587,,0,77,77,204
4588,4588,,0,38,38,204
4589,4589,,124,0,124,204
4590,4590,,20,84,104,216
4591,4591,,27,0,27,204
4592,4592,,2,0,2,74
4593,4593,,141,0,141,216
4594,4594,,0,73,73,204
4595,4595,,0,61,61,216
4596,4596,,116,0,116,204
4597,4597,,0,16,16,204
4598,4598,,3,0,3,204
4599,4599,,0,16,16,204
4600,4600,,0,24,24,216
4601,4601,,21,0,21,216
4602,4602,,0,7,7,204
4603,4603,,0,0,0,180
4604,4604,,4,0,4,204
4605,4605,,0,22,22,204
4606,4606,,0,32,32,204
4607,4607,,15,0,15,216
4608,4608,,0,31,31,216
4609,4609,,23,0,23,216
4610,4610,,15,0,15,243
4611,4611,,0,48,48,204
4612,4612,,28,0,28,204
4613,4613,,31,0,31,216
4614,4614,,3,0,3,243
4615,4615,,19,0,19,204
4616,4616,,3,0,3,239
4617,4617,,0,77,77,216
4618,4618,,19,0,19,216
4619,4619,,0,9,9,216
4620,4620,,0,12,12,216
4621,4621,,30,0,30,216
4622,4622,,0,12,12,204
4623,4623,,0,24,24,216
4624,4624,,49,0,49,216
4625,4625,,0,18,18,215
4626,4626,,32,0,32,215
4627,4627,,15,0,15,215
4628,4628,,0,12,12,204
4629,4629,,11,0,11,204
4630,4630,,0,15,15,216
4631,4631,,7,0,7,204
4632,4632,,40,0,40,204
4633,4633,,182,0,182,216
4634,4634,,4,0,4,216
4635,4635,,25,0,25,216
4636,4636,,0,15,15,216
4637,4637,,93,0,93,216
4638,4638,,0,2,2,216
4639,4639,,99,0,99,216
4640,4640,,10,0,10,204
4641,4641,,2,0,2,216
4642,4642,,19,0,19,204
4643,4643,,0,14,14,204
4644,4644,,0,10,10,204
4645,4645,,2,0,2,216
4646,4646,,0,46,46,216
4647,4647,,0,8,8,216
4648,4648,,3,0,3,216
4649,4649,,0,0,0,181
4650,4650,,13,0,13,204
4651,4651,,30,0,30,204
4652,4652,,5,26,31,216
4653,4653,,6,0,6,204
4654,4654,,0,9,9,243
4655,4655,,6,0,6,243
4656,4656,,0,8,8,216
4657,4657,,3,0,3,216
4658,4658,,0,2,2,204
4659,4659,,0,9,9,216
4660,4660,,0,0,0,182
4661,4661,,58,0,58,216
4662,4662,,0,10,10,216
4663,4663,,31,0,31,204
4664,4664,,0,28,28,216
4665,4665,,0,35,35,216
4666,4666,,0,51,51,204
4667,4667,,14,0,14,243
4668,4668,,0,1,1,204
4669,4669,,16,0,16,204
4670,4670,,10,0,10,216
4671,4671,,0,4,4,215
4672,4672,,7,0,7,204
4673,4673,,0,12,12,243
4674,4674,,7,0,7,216
4675,4675,,0,29,29,216
4676,4676,,2,0,2,204
4677,4677,,0,8,8,204
4678,4678,,0,4,4,183
4679,4679,,0,1,1,216
4680,4680,,1,0,1,216
4681,4681,,0,8,8,243
4682,4682,,15,0,15,243
4683,4683,,19,0,19,216
4684,4684,,0,0,0,184
4685,4685,,35,0,35,204
4686,4686,,6,0,6,216
4687,4687,,14,0,14,204
4688,4688,,4,0,4,204
4689,4689,,0,3,3,204
4690,4690,,52,0,52,204
4691,4691,,12,0,12,216
4692,4692,,0,11,11,216
4693,4693,,0,0,0,185
4694,4694,,0,20,20,216
4695,4695,,0,22,22,216
4696,4696,,51,0,51,216
4697,4697,,0,14,14,204
4698,4698,,51,0,51,216
4699,4699,,4,0,4,216
4700,4700,,29,0,29,204
4701,4701,,10,0,10,74
4702,4702,,29,0,29,204
4703,4703,,30,0,30,204
4704,4704,,0,30,30,204
4705,4705,,34,0,34,187
4706,4706,,0,27,27,204
4707,4707,,0,48,48,204
4708,4708,,15,0,15,204
4709,4709,,29,0,29,216
4710,4710,,24,0,24,204
4711,4711,,0,24,24,204
4712,4712,,6,0,6,204
4713,4713,,0,20,20,215
4714,4714,,24,0,24,204
4715,4715,,30,0,30,204
4716,4716,,0,16,16,216
4717,4717,,21,0,21,204
4718,4718,,0,14,14,204
4719,4719,,40,0,40,204
4720,4720,,19,0,19,216
4721,4721,,11,0,11,216
4722,4722,,18,0,18,204
4723,4723,,0,70,70,204
4724,4724,,0,16,16,216
4725,4725,,5,0,5,216
4726,4726,,18,0,18,216
4727,4727,,9,0,9,204
4728,4728,,20,0,20,216
4729,4729,,0,0,0,186
4730,4730,,0,103,103,216
4731,4731,,38,0,38,216
4732,4732,,0,9,9,74
4733,4733,,25,0,25,204
4734,4734,,109,0,109,216
4735,4735,,86,0,86,204
4736,4736,,4,0,4,216
4737,4737,,28,0,28,187
4738,4738,,0,15,15,204
4739,4739,,8,0,8,204
4740,4740,,2,0,2,204
4741,4741,,0,0,0,188
4742,4742,,3,0,3,216
4743,4743,,0,0,0,189
4744,4744,,0,10,10,204
4745,4745,,0,17,17,204
4746,4746,,0,0,0,190
4747,4747,,0,0,0,191
4748,4748,,11,0,11,204
4749,4749,,0,4,4,204
4750,4750,,0,19,19,204
4751,4751,,15,0,15,204
4752,4752,,0,15,15,204
4753,4753,,0,0,0,192
4754,4754,,0,0,0,193
4755,4755,,21,0,21,216
4756,4756,,25,0,25,204
4757,4757,,120,0,120,204
4758,4758,,4,0,4,216
4759,4759,,4,0,4,216
4760,4760,,0,3,3,248
4761,4761,,1,0,1,216
4762,4762,,34,0,34,216
4763,4763,,14,0,14,216
4764,4764,,12,0,12,204
4765,4765,,0,1,1,194
4766,4766,,2,0,2,204
4767,4767,,0,0,0,195
4768,4768,,24,0,24,216
4769,4769,,147,0,147,204
4770,4770,,0,0,0,196
4771,4771,,0,1,1,204
4772,4772,,0,29,29,216
4773,4773,,163,0,163,216
4774,4774,,5,0,5,74
4775,4775,,0,22,22,204
4776,4776,,5,0,5,204
4777,4777,,0,0,0,197
4778,4778,,9,0,9,204
4779,4779,,0,0,0,198
4780,4780,,0,0,0,199
4781,4781,,12,0,12,204
4782,4782,,0,19,19,204
4783,4783,,0,1,1,216
4784,4784,,0,0,0,200
4785,4785,,0,0,0,201
4786,4786,,3,0,3,215
4787,4787,,23,0,23,216
4788,4788,,0,50,50,204
4789,4789,,12,0,12,216
4790,4790,,0,8,8,204
4791,4791,,0,26,26,204
4792,4792,,7,0,7,216
4793,4793,,2,0,2,216
4794,4794,,0,16,16,204
4795,4795,,0,22,22,216
4796,4796,,9,0,9,216
4797,4797,,2,0,2,216
4798,4798,,1,0,1,187
4799,4799,,0,0,0,202
4800,4800,,28,0,28,204
4801,4801,,20,0,20,204
4802,4802,,5,0,5,239
4803,4803,,10,0,10,204
4804,4804,,0,42,42,204
4805,4805,,0,3,3,216
4806,4806,,33,0,33,204
4807,4807,,12,0,12,204
4808,4808,,6,0,6,204
4809,4809,,0,18,18,204
4810,4810,,6,0,6,204
4811,4811,,40,0,40,204
4812,4812,,0,28,28,204
4813,4813,,0,0,0,203
4814,4814,,16,0,16,74
4815,4815,,4,0,4,216
4816,4816,,0,13,13,216
4817,4817,,4,0,4,216
4818,4818,,7,0,7,216
4819,4819,,16,0,16,204
4820,4820,,0,11,11,204
4821,4821,,17,0,17,216
4822,4822,,0,30,30,204
4823,4823,,51,0,51,204
4824,4824,,16,0,16,204
4825,4825,,7,0,7,204
4826,4826,,0,20,20,204
4827,4827,,0,26,26,216
4828,4828,,0,8,8,204
4829,4829,,0,22,22,216
4830,4830,,3,0,3,204
4831,4831,,2,0,2,216
4832,4832,,11,0,11,204
4833,4833,,5,0,5,215
4834,4834,,0,8,8,204
4835,4835,,7,0,7,204
4836,4836,,0,14,14,216
4837,4837,,0,0,0,205
4838,4838,,0,27,27,243
4839,4839,,0,54,54,216
4840,4840,,0,15,15,243
4841,4841,,4,0,4,243
4842,4842,,23,0,23,204
4843,4843,,3,0,3,216
4844,4844,,0,48,48,216
4845,4845,,0,0,0,206
4846,4846,,27,0,27,216
4847,4847,,0,0,0,207
4848,4848,,6,0,6,187
4849,4849,,134,0,134,216
4850,4850,,0,27,27,204
4851,4851,,0,20,20,204
4852,4852,,0,237,237,216
4853,4853,,90,0,90,204
4854,4854,,19,0,19,216
4855,4855,,8,0,8,204
4856,4856,,0,0,0,208
4857,4857,,0,43,43,204
4858,4858,,0,41,41,216
4859,4859,,4,0,4,216
4860,4860,,8,0,8,243
4861,4861,,0,28,28,216
4862,4862,,0,40,40,204
4863,4863,,15,0,15,216
4864,4864,,0,8,8,204
4865,4865,,0,0,0,209
4866,4866,,0,96,96,204
4867,4867,,0,1,1,204
4868,4868,,0,0,0,210
4869,4869,,21,0,21,216
4870,4870,,14,0,14,204
4871,4871,,28,0,28,216
4872,4872,,0,1,1,216
4873,4873,,3,0,3,216
4874,4874,,0,35,35,204
4875,4875,,13,0,13,204
4876,4876,,15,0,15,204
4877,4877,,2,0,2,216
4878,4878,,20,0,20,243
4879,4879,,0,11,11,74
4880,4880,,22,0,22,216
4881,4881,,0,8,8,216
4882,4882,,17,0,17,204
4883,4883,,0,18,18,216
4884,4884,,0,26,26,204
4885,4885,,11,0,11,204
4886,4886,,0,31,31,204
4887,4887,,0,13,13,204
4888,4888,,0,0,0,211
4889,4889,,4,0,4,187
4890,4890,,0,0,0,212
4891,4891,,13,0,13,216
4892,4892,,0,4,4,204
4893,4893,,18,0,18,204
4894,4894,,22,0,22,216
4895,4895,,5,0,5,216
4896,4896,,3,0,3,204
4897,4897,,8,0,8,216
4898,4898,,0,13,13,204
4899,4899,,2,0,2,204
4900,4900,,13,0,13,216
4901,4901,,0,15,15,243
4902,4902,,3,0,3,204
4903,4903,,0,0,0,213
4904,4904,,15,0,15,216
4905,4905,,0,58,58,216
4906,4906,,3,0,3,33
4907,4907,,0,12,12,204
4908,4908,,0,0,0,214
4909,4909,,2,0,2,187
4910,4910,,8,0,8,216
4911,4911,,0,8,8,216
4912,4912,,0,45,45,215
4913,4913,,5,0,5,215
4914,4914,,19,0,19,216
4915,4915,,55,0,55,215
4916,4916,,0,12,12,204
4917,4917,,0,7,7,204
4918,4918,,20,0,20,216
4919,4919,,2,0,2,204
4920,4920,,34,0,34,204
4921,4921,,11,0,11,204
4922,4922,,10,0,10,239
4923,4923,,0,24,24,216
4924,4924,,9,0,9,216
4925,4925,,5,0,5,230
4926,4926,,4,0,4,204
4927,4927,,0,14,14,204
4928,4928,,11,0,11,204
4929,4929,,3,0,3,216
4930,4930,,3,0,3,230
4931,4931,,3,0,3,251
4932,4932,,4,0,4,216
4933,4933,,16,0,16,216
4934,4934,,0,34,34,204
4935,4935,,0,50,50,216
4936,4936,,36,0,36,216
4937,4937,,9,0,9,204
4938,4938,,0,16,16,230
4939,4939,,4,0,4,230
4940,4940,,0,13,13,204
4941,4941,,25,0,25,204
4942,4942,,0,3,3,187
4943,4943,,0,23,23,216
4944,4944,,28,0,28,216
4945,4945,,14,0,14,204
4946,4946,,15,0,15,204
4947,4947,,15,0,15,204
4948,4948,,0,18,18,243
4949,4949,,0,12,12,204
4950,4950,,0,0,0,217
4951,4951,,0,0,0,218
4952,4952,,12,0,12,216
4953,4953,,0,2,2,187
4954,4954,,3,0,3,248
4955,4955,,16,0,16,216
4956,4956,,9,0,9,204
4957,4957,,0,28,28,216
4958,4958,,0,7,7,187
4959,4959,,13,0,13,187
4960,4960,,0,36,36,204
4961,4961,,0,27,27,216
4962,4962,,4,0,4,216
4963,4963,,8,0,8,239
4964,4964,,0,3,3,215
4965,4965,,0,1,1,204
4966,4966,,2,0,2,204
4967,4967,,5,0,5,216
4968,4968,,3,0,3,204
4969,4969,,9,0,9,204
4970,4970,,0,10,10,204
4971,4971,,5,0,5,215
4972,4972,,0,0,0,219
4973,4973,,11,0,11,204
4974,4974,,13,0,13,204
4975,4975,,0,7,7,216
4976,4976,,15,0,15,239
4977,4977,,72,0,72,216
4978,4978,,6,0,6,204
4979,4979,,8,0,8,243
4980,4980,,0,33,33,204
4981,4981,,15,0,15,216
4982,4982,,0,9,9,243
4983,4983,,13,0,13,216
4984,4984,,30,0,30,216
4985,4985,,5,0,5,204
4986,4986,,22,0,22,204
4987,4987,,2,0,2,215
4988,4988,,0,0,0,220
4989,4989,,180,0,180,216
4990,4990,,0,28,28,204
4991,4991,,2,0,2,216
4992,4992,,7,0,7,216
4993,4993,,7,0,7,204
4994,4994,,40,0,40,216
4995,4995,,0,0,0,221
4996,4996,,0,12,12,243
4997,4997,,18,0,18,248
4998,4998,,0,4,4,216
4999,4999,,7,0,7,216
5000,5000,,10,0,10,216
5001,5001,,30,0,30,215
5002,5002,,0,0,0,222
5003,5003,,0,0,0,223
5004,5004,,29,0,29,204
5005,5005,,0,0,0,224
5006,5006,,1,0,1,225
5007,5007,,6,0,6,204
5008,5008,,0,20,20,216
5009,5009,,6,0,6,239
5010,5010,,2,0,2,204
5011,5011,,3,0,3,204
5012,5012,,31,0,31,216
5013,5013,,13,0,13,204
5014,5014,,0,27,27,204
5015,5015,,40,0,40,204
5016,5016,,0,0,0,226
5017,5017,,8,0,8,216
5018,5018,,9,0,9,204
5019,5019,,4,0,4,216
5020,5020,,12,0,12,216
5021,5021,,5,0,5,204
5022,5022,,8,0,8,204
5023,5023,,0,5,5,204
5024,5024,,10,0,10,204
5025,5025,,2,0,2,216
5026,5026,,0,0,0,227
5027,5027,,14,0,14,216
5028,5028,,15,0,15,204
5029,5029,,5,0,5,216
5030,5030,,12,0,12,204
5031,5031,,0,0,0,228
5032,5032,,2,0,2,204
5033,5033,,3,0,3,187
5034,5034,,12,0,12,216
5035,5035,,0,0,0,229
5036,5036,,0,5,5,204
5037,5037,,8,0,8,204
5038,5038,,20,0,20,204
5039,5039,,0,38,38,204
5040,5040,,13,0,13,216
5041,5041,,0,9,9,204
5042,5042,,0,2,2,230
5043,5043,,16,0,16,230
5044,5044,,0,0,0,231
5045,5045,,0,0,0,232
5046,5046,,7,0,7,204
5047,5047,,0,26,26,204
5048,5048,,8,0,8,216
5049,5049,,0,20,20,204
5050,5050,,3,0,3,216
5051,5051,,5,0,5,33
5052,5052,,8,0,8,204
5053,5053,,15,0,15,216
5054,5054,,24,0,24,187
5055,5055,,0,0,0,233
5056,5056,,11,0,11,216
5057,5057,,12,0,12,74
5058,5058,,23,0,23,204
5059,5059,,8,0,8,204
5060,5060,,18,0,18,74
5061,5061,,0,0,0,234
5062,5062,,0,0,0,235
5063,5063,,40,0,40,239
5064,5064,,3,0,3,216
5065,5065,,10,0,10,243
5066,5066,,5,0,5,230
5067,5067,,4,0,4,204
5068,5068,,3,0,3,243
5069,5069,,0,0,0,236
5070,5070,,12,0,12,243
5071,5071,,4,0,4,204
5072,5072,,36,0,36,204
5073,5073,,0,33,33,187
5074,5074,,0,16,16,216
5075,5075,,2,0,2,183
5076,5076,,15,0,15,204
5077,5077,,5,0,5,216
5078,5078,,1,0,1,216
5079,5079,,8,0,8,243
5080,5080,,0,12,12,216
5081,5081,,10,0,10,204
5082,5082,,4,0,4,204
5083,5083,,0,0,0,237
5084,5084,,17,0,17,216
5085,5085,,0,0,0,238
5086,5086,,0,17,17,215
5087,5087,,9,0,9,239
5088,5088,,2,0,2,216
5089,5089,,2,0,2,216
5090,5090,,11,0,11,204
5091,5091,,3,0,3,243
5092,5092,,0,4,4,243
5093,5093,,3,0,3,243
5094,5094,,4,0,4,204
5095,5095,,2,0,2,215
5096,5096,,2,0,2,187
5097,5097,,4,0,4,204
5098,5098,,2,0,2,216
5099,5099,,6,0,6,204
5100,5100,,0,0,0,240
5101,5101,,2,0,2,216
5102,5102,,0,0,0,241
5103,5103,,3,0,3,204
5104,5104,,2,0,2,204
5105,5105,,13,0,13,216
5106,5106,,13,0,13,204
5107,5107,,2,0,2,204
5108,5108,,0,0,0,242
5109,5109,,8,0,8,243
5110,5110,,0,6,6,243
5111,5111,,10,0,10,187
5112,5112,,0,0,0,244
5113,5113,,10,0,10,216
5114,5114,,15,0,15,74
5115,5115,,2,0,2,204
5116,5116,,19,0,19,204
5117,5117,,10,0,10,204
5118,5118,,0,0,0,245
5119,5119,,0,0,0,246
5120,5120,,63,0,63,243
5121,5121,,5,0,5,216
5122,5122,,4,0,4,216
5123,5123,,13,0,13,204
5124,5124,,6,0,6,187
5125,5125,,0,0,0,247
5126,5126,,6,0,6,204
5127,5127,,0,6,6,248
5128,5128,,0,0,0,249
5129,5129,,2,0,2,216
5130,5130,,4,0,4,216
5131,5131,,3,0,3,216
5132,5132,,25,0,25,215
5133,5133,,11,0,11,204
5134,5134,,5,0,5,204
5135,5135,,0,28,28,216
5136,5136,,1,0,1,204
5137,5137,,8,0,8,204
5138,5138,,9,0,9,187
5139,5139,,8,0,8,215
5140,5140,,14,0,14,204
5141,5141,,5,0,5,204
5142,5142,,4,0,4,74
5143,5143,,10,0,10,216
5144,5144,,3,0,3,243
5145,5145,,0,0,0,250
5146,5146,,9,0,9,216
5147,5147,,0,18,18,204
5148,5148,,0,1,1,194
5149,5149,,4,0,4,251
5150,5150,,3,0,3,243
5151,5151,,4,0,4,187
5152,5152,,0,0,0,252
5153,5153,,0,0,0,253
5154,5154,,10,0,10,204
5155,5155,,2,0,2,204
5156,5156,,7,0,7,46
5157,5157,,0,9,9,46
5158,5158,,2,0,2,171
5159,5159,,0,4,4,46
5160,5160,,18,0,18,280
5161,5161,,0,1,1,46
5162,5162,,3,0,3,46
5163,5163,,13,0,13,301
5164,5164,,0,6,6,46
5165,5165,,14,0,14,46
5166,5166,,7,0,7,301
5167,5167,,0,1,1,254
5168,5168,,1,0,1,254
5169,5169,,15,0,15,46
5170,5170,,2,0,2,46
5171,5171,,0,4,4,46
5172,5172,,133,0,133,46
5173,5173,,11,0,11,46
5174,5174,,1,0,1,46
5175,5175,,0,3,3,46
5176,5176,,7,0,7,46
5177,5177,,69,0,69,46
5178,5178,,3,0,3,46
5179,5179,,181,0,181,46
5180,5180,,0,7,7,46
5181,5181,,17,0,17,46
5182,5182,,3,0,3,74
5183,5183,,0,4,4,46
5184,5184,,26,0,26,46
5185,5185,,2,0,2,124
5186,5186,,6,0,6,46
5187,5187,,8,0,8,46
5188,5188,,8,0,8,171
5189,5189,,0,8,8,46
5190,5190,,5,0,5,46
5191,5191,,8,0,8,46
5192,5192,,0,5,5,46
5193,5193,,15,0,15,46
5194,5194,,7,0,7,46
5195,5195,,28,0,28,46
5196,5196,,13,0,13,46
5197,5197,,0,3,3,46
5198,5198,,87,0,87,46
5199,5199,,11,0,11,256
5200,5200,,0,9,9,46
5201,5201,,0,1,1,46
5202,5202,,2,0,2,259
5203,5203,,0,5,5,46
5204,5204,,17,0,17,46
5205,5205,,0,5,5,46
5206,5206,,13,0,13,46
5207,5207,,0,4,4,301
5208,5208,,14,0,14,301
5209,5209,,9,0,9,46
5210,5210,,0,3,3,46
5211,5211,,4,0,4,46
5212,5212,,2,0,2,46
5213,5213,,0,2,2,46
5214,5214,,5,0,5,46
5215,5215,,5,0,5,280
5216,5216,,49,51,100,257
5217,5217,,2,0,2,257
5218,5218,,0,6,6,46
5219,5219,,3,0,3,46
5220,5220,,20,0,20,46
5221,5221,,20,0,20,46
5222,5222,,0,4,4,46
5223,5223,,0,3,3,46
5224,5224,,22,0,22,46
5225,5225,,6,0,6,46
5226,5226,,0,8,8,46
5227,5227,,19,0,19,46
5228,5228,,14,0,14,46
5229,5229,,1,0,1,46
5230,5230,,0,2,2,46
5231,5231,,54,55,109,280
5232,5232,,11,0,11,46
5233,5233,,0,3,3,301
5234,5234,,0,1,1,46
5235,5235,,4,0,4,46
5236,5236,,0,2,2,46
5237,5237,,9,0,9,46
5238,5238,,4,0,4,316
5239,5239,,6,0,6,46
5240,5240,,0,2,2,133
5241,5241,,6,0,6,46
5242,5242,,0,3,3,46
5243,5243,,17,0,17,46
5244,5244,,4,0,4,152
5245,5245,,0,2,2,46
5246,5246,,13,0,13,46
5247,5247,,9,0,9,262
5248,5248,,26,0,26,46
5249,5249,,16,0,16,46
5250,5250,,7,0,7,46
5251,5251,,0,5,5,280
5252,5252,,13,0,13,280
5253,5253,,0,8,8,46
5254,5254,,5,0,5,46
5255,5255,,0,8,8,46
5256,5256,,24,0,24,46
5257,5257,,0,0,0,258
5258,5258,,0,3,3,259
5259,5259,,6,0,6,259
5260,5260,,0,4,4,46
5261,5261,,22,0,22,46
5262,5262,,0,5,5,46
5263,5263,,13,0,13,46
5264,5264,,3,0,3,29
5265,5265,,0,5,5,46
5266,5266,,0,2,2,46
5267,5267,,0,4,4,255
5268,5268,,20,0,20,46
5269,5269,,14,0,14,260
5270,5270,,0,0,0,261
5271,5271,,9,0,9,262
5272,5272,,0,3,3,46
5273,5273,,5,0,5,46
5274,5274,,9,0,9,46
5275,5275,,3,0,3,46
5276,5276,,0,3,3,301
5277,5277,,0,3,3,46
5278,5278,,7,0,7,46
5279,5279,,0,3,3,46
5280,5280,,0,8,8,46
5281,5281,,9,0,9,46
5282,5282,,0,4,4,46
5283,5283,,0,5,5,113
5284,5284,,3,0,3,113
5285,5285,,0,6,6,46
5286,5286,,7,0,7,46
5287,5287,,0,3,3,19
5288,5288,,6,0,6,19
5289,5289,,2,0,2,46
5290,5290,,2,0,2,133
5291,5291,,0,6,6,46
5292,5292,,54,55,109,263
5293,5293,,8,0,8,272
5294,5294,,0,1,1,46
5295,5295,,0,3,3,272
5296,5296,,0,0,0,264
5297,5297,,3,0,3,46
5298,5298,,0,3,3,46
5299,5299,,0,1,1,46
5300,5300,,4,0,4,46
5301,5301,,0,6,6,46
5302,5302,,0,2,2,46
5303,5303,,4,0,4,46
5304,5304,,0,4,4,46
5305,5305,,15,0,15,46
5306,5306,,0,3,3,46
5307,5307,,48,0,48,46
5308,5308,,0,6,6,262
5309,5309,,9,0,9,262
5310,5310,,6,0,6,133
5311,5311,,0,6,6,46
5312,5312,,0,0,0,265
5313,5313,,0,0,0,266
5314,5314,,0,2,2,133
5315,5315,,8,0,8,46
5316,5316,,0,5,5,46
5317,5317,,3,0,3,46
5318,5318,,0,1,1,46
5319,5319,,5,0,5,46
5320,5320,,0,1,1,46
5321,5321,,16,0,16,46
5322,5322,,6,0,6,46
5323,5323,,0,2,2,272
5324,5324,,0,5,5,46
5325,5325,,6,0,6,46
5326,5326,,4,0,4,46
5327,5327,,0,3,3,272
5328,5328,,8,0,8,272
5329,5329,,0,0,0,267
5330,5330,,8,0,8,301
5331,5331,,0,3,3,259
5332,5332,,5,0,5,259
5333,5333,,0,5,5,46
5334,5334,,0,0,0,268
5335,5335,,13,0,13,46
5336,5336,,12,0,12,46
5337,5337,,0,0,0,269
5338,5338,,0,0,0,270
5339,5339,,32,0,32,46
5340,5340,,17,0,17,46
5341,5341,,8,0,8,46
5342,5342,,3,0,3,46
5343,5343,,3,0,3,46
5344,5344,,0,1,1,259
5345,5345,,0,5,5,46
5346,5346,,0,3,3,46
5347,5347,,0,3,3,46
5348,5348,,6,0,6,46
5349,5349,,3,0,3,262
5350,5350,,0,0,0,271
5351,5351,,1,0,1,280
5352,5352,,0,6,6,46
5353,5353,,17,0,17,46
5354,5354,,0,5,5,262
5355,5355,,3,0,3,262
5356,5356,,7,0,7,46
5357,5357,,0,3,3,46
5358,5358,,3,0,3,46
5359,5359,,0,2,2,46
5360,5360,,12,0,12,46
5361,5361,,0,2,2,46
5362,5362,,4,0,4,46
5363,5363,,3,0,3,46
5364,5364,,11,0,11,46
5365,5365,,24,0,24,46
5366,5366,,0,3,3,46
5367,5367,,32,0,32,46
5368,5368,,0,2,2,46
5369,5369,,3,0,3,46
5370,5370,,7,0,7,46
5371,5371,,2,0,2,77
5372,5372,,0,1,1,46
5373,5373,,0,3,3,272
5374,5374,,0,4,4,46
5375,5375,,4,0,4,19
5376,5376,,0,4,4,46
5377,5377,,59,0,59,46
5378,5378,,15,0,15,46
5379,5379,,8,0,8,46
5380,5380,,7,0,7,46
5381,5381,,0,4,4,46
5382,5382,,16,0,16,46
5383,5383,,0,4,4,46
5384,5384,,9,0,9,46
5385,5385,,0,5,5,46
5386,5386,,8,0,8,46
5387,5387,,14,0,14,46
5388,5388,,0,4,4,46
5389,5389,,29,0,29,46
5390,5390,,9,0,9,272
5391,5391,,9,0,9,46
5392,5392,,0,4,4,301
5393,5393,,0,10,10,46
5394,5394,,0,5,5,46
5395,5395,,11,0,11,46
5396,5396,,1,0,1,55
5397,5397,,3,0,3,113
5398,5398,,0,2,2,46
5399,5399,,0,2,2,46
5400,5400,,2,0,2,46
5401,5401,,0,4,4,46
5402,5402,,4,0,4,46
5403,5403,,0,5,5,46
5404,5404,,4,0,4,46
5405,5405,,9,0,9,46
5406,5406,,15,0,15,46
5407,5407,,0,3,3,46
5408,5408,,0,4,4,46
5409,5409,,0,4,4,46
5410,5410,,9,0,9,46
5411,5411,,0,2,2,46
5412,5412,,0,1,1,46
5413,5413,,0,4,4,46
5414,5414,,6,0,6,46
5415,5415,,7,0,7,46
5416,5416,,0,3,3,46
5417,5417,,10,0,10,46
5418,5418,,0,4,4,262
5419,5419,,0,2,2,262
5420,5420,,0,2,2,46
5421,5421,,0,0,0,273
5422,5422,,0,5,5,46
5423,5423,,10,0,10,46
5424,5424,,0,2,2,46
5425,5425,,7,0,7,46
5426,5426,,6,0,6,46
5427,5427,,0,5,5,280
5428,5428,,5,0,5,280
5429,5429,,0,2,2,46
5430,5430,,0,4,4,46
5431,5431,,45,47,92,144
5432,5432,,3,0,3,144
5433,5433,,0,5,5,46
5434,5434,,4,0,4,133
5435,5435,,0,1,1,262
5436,5436,,0,3,3,46
5437,5437,,6,0,6,46
5438,5438,,0,4,4,46
5439,5439,,0,3,3,259
5440,5440,,0,0,0,274
5441,5441,,2,0,2,81
5442,5442,,0,0,0,275
5443,5443,,3,0,3,46
5444,5444,,5,0,5,46
5445,5445,,2,0,2,46
5446,5446,,0,5,5,46
5447,5447,,0,4,4,46
5448,5448,,6,0,6,46
5449,5449,,0,2,2,46
5450,5450,,1,0,1,46
5451,5451,,0,5,5,46
5452,5452,,0,2,2,280
5453,5453,,2,0,2,280
5454,5454,,0,0,0,276
5455,5455,,2,0,2,46
5456,5456,,0,1,1,301
5457,5457,,4,0,4,301
5458,5458,,0,0,0,277
5459,5459,,5,0,5,46
5460,5460,,4,0,4,46
5461,5461,,0,4,4,46
5462,5462,,0,3,3,46
5463,5463,,0,5,5,46
5464,5464,,10,0,10,46
5465,5465,,4,0,4,46
5466,5466,,0,4,4,46
5467,5467,,21,0,21,46
5468,5468,,4,0,4,46
5469,5469,,4,0,4,46
5470,5470,,0,3,3,46
5471,5471,,0,4,4,46
5472,5472,,0,3,3,301
5473,5473,,0,3,3,46
5474,5474,,6,0,6,46
5475,5475,,8,0,8,46
5476,5476,,0,5,5,46
5477,5477,,12,0,12,46
5478,5478,,0,5,5,46
5479,5479,,16,0,16,46
5480,5480,,0,5,5,46
5481,5481,,0,4,4,113
5482,5482,,0,3,3,46
5483,5483,,3,0,3,46
5484,5484,,0,4,4,46
5485,5485,,16,0,16,46
5486,5486,,2,0,2,46
5487,5487,,0,5,5,46
5488,5488,,0,4,4,46
5489,5489,,3,0,3,46
5490,5490,,3,0,3,46
5491,5491,,0,3,3,46
5492,5492,,0,1,1,77
5493,5493,,2,0,2,46
5494,5494,,3,0,3,19
5495,5495,,0,3,3,46
5496,5496,,0,4,4,262
5497,5497,,0,0,0,278
5498,5498,,0,4,4,46
5499,5499,,0,0,0,279
5500,5500,,0,5,5,280
5501,5501,,8,0,8,255
5502,5502,,3,0,3,46
5503,5503,,13,0,13,280
5504,5504,,5,0,5,316
5505,5505,,4,0,4,46
5506,5506,,0,7,7,46
5507,5507,,0,4,4,46
5508,5508,,7,0,7,259
5509,5509,,3,0,3,46
5510,5510,,0,3,3,46
5511,5511,,0,6,6,46
5512,5512,,0,4,4,280
5513,5513,,13,0,13,280
5514,5514,,17,19,36,280
5515,5515,,49,50,99,257
5516,5516,,7,0,7,46
5517,5517,,0,2,2,280
5518,5518,,0,4,4,46
5519,5519,,0,3,3,46
5520,5520,,16,0,16,46
5521,5521,,6,0,6,46
5522,5522,,0,8,8,280
5523,5523,,17,0,17,46
5524,5524,,0,4,4,46
5525,5525,,4,0,4,46
5526,5526,,0,3,3,19
5527,5527,,6,0,6,46
5528,5528,,0,1,1,77
5529,5529,,3,0,3,77
5530,5530,,0,5,5,255
5531,5531,,4,0,4,255
5532,5532,,2,0,2,19
5533,5533,,0,5,5,46
5534,5534,,0,0,0,281
5535,5535,,10,0,10,46
5536,5536,,0,5,5,46
5537,5537,,0,3,3,29
5538,5538,,5,0,5,46
5539,5539,,0,3,3,46
5540,5540,,3,0,3,46
5541,5541,,0,2,2,259
5542,5542,,5,0,5,280
5543,5543,,11,0,11,262
5544,5544,,0,7,7,46
5545,5545,,0,3,3,262
5546,5546,,5,0,5,46
5547,5547,,0,4,4,46
5548,5548,,0,0,0,282
5549,5549,,0,1,1,262
5550,5550,,3,0,3,262
5551,5551,,0,2,2,81
5552,5552,,4,0,4,46
5553,5553,,0,4,4,280
5554,5554,,3,0,3,280
5555,5555,,0,5,5,46
5556,5556,,0,5,5,46
5557,5557,,0,3,3,46
5558,5558,,0,3,3,46
5559,5559,,0,0,0,283
5560,5560,,0,0,0,284
5561,5561,,0,2,2,67
5562,5562,,1,0,1,46
5563,5563,,3,0,3,113
5564,5564,,0,2,2,46
5565,5565,,0,3,3,46
5566,5566,,0,3,3,280
5567,5567,,3,0,3,280
5568,5568,,0,5,5,46
5569,5569,,5,0,5,46
5570,5570,,0,6,6,46
5571,5571,,4,0,4,46
5572,5572,,0,6,6,259
5573,5573,,0,4,4,46
5574,5574,,0,4,4,46
5575,5575,,0,4,4,46
5576,5576,,0,3,3,259
5577,5577,,4,0,4,259
5578,5578,,0,4,4,46
5579,5579,,0,2,2,46
5580,5580,,7,0,7,46
5581,5581,,0,3,3,46
5582,5582,,0,10,10,46
5583,5583,,11,0,11,46
5584,5584,,0,7,7,46
5585,5585,,0,8,8,46
5586,5586,,0,3,3,46
5587,5587,,0,2,2,46
5588,5588,,0,8,8,46
5589,5589,,6,0,6,46
5590,5590,,0,4,4,46
5591,5591,,0,5,5,46
5592,5592,,28,29,57,46
5593,5593,,0,5,5,46
5594,5594,,4,0,4,77
5595,5595,,7,0,7,46
5596,5596,,10,0,10,46
5597,5597,,0,3,3,280
5598,5598,,0,5,5,46
5599,5599,,3,0,3,46
5600,5600,,0,0,0,285
5601,5601,,0,3,3,280
5602,5602,,10,0,10,280
5603,5603,,0,4,4,19
5604,5604,,3,0,3,19
5605,5605,,0,3,3,144
5606,5606,,0,6,6,46
5607,5607,,6,0,6,255
5608,5608,,0,3,3,46
5609,5609,,0,3,3,46
5610,5610,,6,0,6,46
5611,5611,,0,3,3,46
5612,5612,,0,3,3,316
5613,5613,,0,4,4,46
5614,5614,,0,4,4,46
5615,5615,,0,6,6,46
5616,5616,,0,2,2,46
5617,5617,,0,8,8,46
5618,5618,,0,6,6,46
5619,5619,,3,0,3,262
5620,5620,,0,3,3,46
5621,5621,,0,0,0,286
5622,5622,,3,0,3,46
5623,5623,,0,3,3,46
5624,5624,,0,4,4,46
5625,5625,,0,0,0,287
5626,5626,,0,3,3,46
5627,5627,,0,3,3,46
5628,5628,,0,2,2,46
5629,5629,,0,4,4,46
5630,5630,,0,6,6,46
5631,5631,,0,6,6,46
5632,5632,,3,0,3,46
5633,5633,,0,0,0,288
5634,5634,,5,0,5,46
5635,5635,,7,0,7,46
5636,5636,,0,5,5,46
5637,5637,,0,4,4,46
5638,5638,,0,3,3,46
5639,5639,,0,3,3,301
5640,5640,,3,0,3,301
5641,5641,,9,0,9,46
5642,5642,,0,3,3,46
5643,5643,,0,0,0,289
5644,5644,,0,3,3,46
5645,5645,,0,2,2,280
5646,5646,,5,0,5,46
5647,5647,,0,4,4,46
5648,5648,,2,0,2,46
5649,5649,,0,4,4,46
5650,5650,,0,4,4,46
5651,5651,,5,0,5,46
5652,5652,,4,0,4,46
5653,5653,,0,8,8,46
5654,5654,,0,5,5,46
5655,5655,,0,5,5,46
5656,5656,,3,0,3,259
5657,5657,,0,2,2,46
5658,5658,,3,0,3,46
5659,5659,,0,0,0,290
5660,5660,,0,5,5,46
5661,5661,,0,0,0,291
5662,5662,,5,0,5,46
5663,5663,,0,2,2,272
5664,5664,,0,1,1,46
5665,5665,,5,0,5,46
5666,5666,,1,0,1,46
5667,5667,,4,0,4,46
5668,5668,,0,3,3,46
5669,5669,,2,0,2,46
5670,5670,,14,0,14,46
5671,5671,,0,4,4,280
5672,5672,,0,4,4,46
5673,5673,,9,0,9,46
5674,5674,,0,3,3,46
5675,5675,,4,0,4,46
5676,5676,,5,0,5,46
5677,5677,,2,0,2,259
5678,5678,,0,3,3,19
5679,5679,,1,0,1,296
5680,5680,,0,4,4,46
5681,5681,,5,0,5,46
5682,5682,,15,0,15,46
5683,5683,,0,5,5,46
5684,5684,,0,3,3,46
5685,5685,,0,5,5,46
5686,5686,,6,0,6,46
5687,5687,,0,3,3,301
5688,5688,,0,0,0,292
5689,5689,,7,0,7,46
5690,5690,,0,3,3,46
5691,5691,,0,3,3,46
5692,5692,,4,0,4,46
5693,5693,,0,3,3,46
5694,5694,,7,0,7,46
5695,5695,,0,0,0,293
5696,5696,,0,5,5,46
5697,5697,,0,2,2,46
5698,5698,,0,3,3,280
5699,5699,,0,3,3,259
5700,5700,,0,0,0,294
5701,5701,,0,8,8,46
5702,5702,,3,0,3,46
5703,5703,,0,4,4,46
5704,5704,,0,2,2,46
5705,5705,,0,6,6,46
5706,5706,,0,3,3,46
5707,5707,,0,0,0,295
5708,5708,,0,4,4,280
5709,5709,,5,0,5,280
5710,5710,,0,2,2,46
5711,5711,,0,3,3,280
5712,5712,,0,1,1,296
5713,5713,,0,2,2,280
5714,5714,,0,3,3,301
5715,5715,,0,3,3,46
5716,5716,,3,0,3,46
5717,5717,,0,0,0,297
5718,5718,,0,4,4,46
5719,5719,,25,26,51,46
5720,5720,,0,3,3,255
5721,5721,,8,0,8,255
5722,5722,,0,4,4,46
5723,5723,,0,1,1,280
5724,5724,,2,0,2,46
5725,5725,,6,0,6,46
5726,5726,,0,6,6,46
5727,5727,,3,0,3,46
5728,5728,,0,3,3,259
5729,5729,,3,0,3,46
5730,5730,,0,1,1,46
5731,5731,,3,0,3,46
5732,5732,,5,0,5,46
5733,5733,,0,0,0,298
5734,5734,,0,3,3,262
5735,5735,,0,2,2,46
5736,5736,,2,0,2,55
5737,5737,,3,0,3,46
5738,5738,,0,4,4,46
5739,5739,,0,3,3,46
5740,5740,,0,3,3,262
5741,5741,,0,3,3,46
5742,5742,,0,6,6,46
5743,5743,,0,2,2,46
5744,5744,,4,0,4,74
5745,5745,,2,0,2,259
5746,5746,,7,0,7,46
5747,5747,,1,0,1,77
5748,5748,,0,1,1,46
5749,5749,,0,4,4,46
5750,5750,,17,17,34,280
5751,5751,,2,0,2,280
5752,5752,,0,0,0,299
5753,5753,,5,0,5,46
5754,5754,,2,0,2,46
5755,5755,,5,0,5,46
5756,5756,,0,5,5,46
5757,5757,,0,4,4,46
5758,5758,,1,0,1,14
5759,5759,,0,3,3,46
5760,5760,,2,0,2,46
5761,5761,,0,3,3,46
5762,5762,,0,0,0,300
5763,5763,,0,4,4,46
5764,5764,,7,0,7,46
5765,5765,,0,3,3,46
5766,5766,,0,4,4,280
5767,5767,,5,0,5,280
5768,5768,,4,0,4,46
5769,5769,,0,4,4,46
5770,5770,,0,3,3,280
5771,5771,,5,0,5,272
5772,5772,,0,6,6,255
5773,5773,,0,4,4,46
5774,5774,,3,0,3,262
5775,5775,,6,0,6,46
5776,5776,,0,4,4,46
5777,5777,,0,4,4,46
5778,5778,,0,4,4,46
5779,5779,,3,0,3,259
5780,5780,,0,3,3,272
5781,5781,,2,0,2,46
5782,5782,,6,0,6,46
5783,5783,,0,4,4,46
5784,5784,,0,6,6,46
5785,5785,,0,2,2,124
5786,5786,,0,4,4,46
5787,5787,,0,1,1,90
5788,5788,,3,0,3,90
5789,5789,,0,3,3,259
5790,5790,,0,3,3,46
5791,5791,,0,3,3,46
5792,5792,,3,0,3,46
5793,5793,,0,3,3,255
5794,5794,,0,2,2,46
5795,5795,,0,4,4,46
5796,5796,,5,0,5,46
5797,5797,,0,4,4,46
5798,5798,,0,3,3,46
5799,5799,,0,3,3,280
5800,5800,,8,0,8,46
5801,5801,,0,3,3,46
5802,5802,,10,0,10,301
5803,5803,,5,0,5,46
5804,5804,,0,3,3,46
5805,5805,,0,7,7,46
5806,5806,,0,4,4,46
5807,5807,,0,3,3,46
5808,5808,,4,0,4,46
5809,5809,,3,0,3,46
5810,5810,,0,3,3,46
5811,5811,,0,3,3,46
5812,5812,,2,0,2,46
5813,5813,,3,0,3,67
5814,5814,,0,2,2,280
5815,5815,,3,0,3,280
5816,5816,,0,1,1,46
5817,5817,,3,0,3,262
5818,5818,,0,2,2,74
5819,5819,,0,5,5,46
5820,5820,,2,0,2,280
5821,5821,,0,3,3,46
5822,5822,,0,2,2,46
5823,5823,,0,4,4,46
5824,5824,,4,0,4,301
5825,5825,,4,0,4,46
5826,5826,,0,0,0,302
5827,5827,,0,0,0,303
5828,5828,,0,3,3,301
5829,5829,,0,3,3,152
5830,5830,,0,6,6,46
5831,5831,,0,4,4,255
5832,5832,,0,2,2,46
5833,5833,,0,3,3,46
5834,5834,,0,4,4,46
5835,5835,,0,39,39,804
5836,5836,,0,2,2,272
5837,5837,,0,3,3,46
5838,5838,,0,0,0,304
5839,5839,,0,3,3,124
5840,5840,,2,0,2,46
5841,5841,,0,5,5,46
5842,5842,,3,0,3,46
5843,5843,,0,6,6,46
5844,5844,,0,1,1,46
5845,5845,,0,1,1,46
5846,5846,,0,1,1,1169
5847,5847,,2,0,2,316
5848,5848,,0,2,2,46
5849,5849,,0,4,4,46
5850,5850,,0,4,4,46
5851,5851,,0,2,2,1516
5852,5852,,1,0,1,280
5853,5853,,0,2,2,46
5854,5854,,0,2,2,46
5855,5855,,2,0,2,46
5856,5856,,0,4,4,46
5857,5857,,0,3,3,46
5858,5858,,5,0,5,46
5859,5859,,2,0,2,280
5860,5860,,0,4,4,46
5861,5861,,0,1,1,46
5862,5862,,0,5,5,280
5863,5863,,0,2,2,280
5864,5864,,3,0,3,280
5865,5865,,0,4,4,46
5866,5866,,0,5,5,46
5867,5867,,3,0,3,46
5868,5868,,3,0,3,46
5869,5869,,3,0,3,46
5870,5870,,0,4,4,301
5871,5871,,2,0,2,67
5872,5872,,0,8,8,46
5873,5873,,0,2,2,46
5874,5874,,5,0,5,46
5875,5875,,0,3,3,46
5876,5876,,0,1,1,280
5877,5877,,0,6,6,46
5878,5878,,0,2,2,272
5879,5879,,17,17,34,280
5880,5880,,0,2,2,46
5881,5881,,3,0,3,46
5882,5882,,0,3,3,46
5883,5883,,0,6,6,262
5884,5884,,0,6,6,46
5885,5885,,0,3,3,46
5886,5886,,0,0,0,305
5887,5887,,3,0,3,272
5888,5888,,0,1,1,259
5889,5889,,0,2,2,46
5890,5890,,2,0,2,46
5891,5891,,0,1,1,96
5892,5892,,0,0,0,306
5893,5893,,0,3,3,46
5894,5894,,6,0,6,46
5895,5895,,0,11,11,42
5896,5896,,47,48,95,46
5897,5897,,0,3,3,113
5898,5898,,0,4,4,46
5899,5899,,3,0,3,46
5900,5900,,0,5,5,46
5901,5901,,3,0,3,46
5902,5902,,0,3,3,29
5903,5903,,0,0,0,307
5904,5904,,0,3,3,46
5905,5905,,0,1,1,46
5906,5906,,0,6,6,46
5907,5907,,0,3,3,272
5908,5908,,0,3,3,46
5909,5909,,0,3,3,46
5910,5910,,0,1,1,259
5911,5911,,0,0,0,308
5912,5912,,0,2,2,46
5913,5913,,0,3,3,46
5914,5914,,46,5,51,3
5915,5915,,7,9,16,74
5916,5916,,0,2,2,1554
5917,5917,,0,3,3,46
5918,5918,,0,3,3,46
5919,5919,,50,51,101,280
5920,5920,,3,0,3,46
5921,5921,,2,0,2,259
5922,5922,,0,2,2,280
5923,5923,,0,0,0,309
5924,5924,,0,2,2,280
5925,5925,,0,3,3,301
5926,5926,,0,3,3,280
5927,5927,,0,1,1,46
5928,5928,,0,4,4,260
5929,5929,,0,5,5,67
5930,5930,,0,3,3,46
5931,5931,,0,26,26,280
5932,5932,,0,4,4,46
5933,5933,,0,3,3,46
5934,5934,,5,0,5,46
5935,5935,,0,2,2,46
5936,5936,,0,3,3,46
5937,5937,,0,2,2,46
5938,5938,,0,2,2,280
5939,5939,,0,3,3,46
5940,5940,,0,5,5,46
5941,5941,,0,2,2,124
5942,5942,,0,3,3,152
5943,5943,,2,0,2,280
5944,5944,,46,53,99,152
5945,5945,,0,2,2,280
5946,5946,,0,4,4,46
5947,5947,,0,4,4,46
5948,5948,,0,5,5,46
5949,5949,,3,0,3,46
5950,5950,,0,6,6,255
5951,5951,,0,3,3,46
5952,5952,,0,3,3,272
5953,5953,,3,0,3,272
5954,5954,,0,3,3,255
5955,5955,,0,3,3,280
5956,5956,,0,3,3,46
5957,5957,,0,3,3,46
5958,5958,,0,3,3,67
5959,5959,,0,4,4,255
5960,5960,,2,0,2,255
5961,5961,,0,4,4,46
5962,5962,,0,2,2,133
5963,5963,,0,2,2,96
5964,5964,,0,3,3,46
5965,5965,,0,4,4,280
5966,5966,,0,10,10,260
5967,5967,,30,30,60,320
5968,5968,,0,2,2,46
5969,5969,,0,3,3,124
5970,5970,,0,2,2,152
5971,5971,,54,56,110,46
5972,5972,,0,3,3,29
5973,5973,,51,52,103,215
5974,5974,,10,11,21,43
5975,5975,,18,31,49,41
5976,5976,,33,34,67,96
5977,5977,,61,66,127,310
5978,5978,,66,61,127,310
5979,5979,,4,4,8,49
5980,5980,,17,18,35,44
5981,5981,,23,24,47,46
5982,5982,,20,21,41,41
5983,5983,,20,21,41,41
5984,5984,,178,178,356,7
5985,5985,,26,27,53,152
5986,5986,,13,24,37,58
5987,5987,,16,16,32,30
5988,5988,,4,5,9,39
5989,5989,,138,132,270,815
5990,5990,,49,54,103,280
5991,5991,,54,111,165,804
5992,5992,,0,0,0,311
5993,5993,,14,2,16,27
5994,5994,,57,58,115,56
5995,5995,,9,26,35,58
5996,5996,,38,6,44,27
5997,5997,,47,69,116,280
5998,5998,,69,48,117,280
5999,5999,,19,20,39,41
6000,6000,,178,356,534,7
6001,6001,,43,2,45,44
6002,6002,,14,20,34,44
6003,6003,,31,32,63,30
6004,6004,,25,85,110,15
6005,6005,,69,69,138,42
6006,6006,,7,8,15,26
6007,6007,,7,7,14,51
6008,6008,,8,9,17,19
6009,6009,,8,9,17,19
6010,6010,,30,31,61,57
6011,6011,,10,11,21,73
6012,6012,,7,8,15,74
6013,6013,,86,68,154,27
6014,6014,,67,87,154,27
6015,6015,,8,9,17,27
6016,6016,,8,9,17,27
6017,6017,,18,18,36,216
6018,6018,,13,13,26,36
6019,6019,,52,53,105,27
6020,6020,,54,90,144,37
6021,6021,,45,45,90,25
6022,6022,,54,54,108,263
6023,6023,,5,17,22,804
6024,6024,,105,106,211,812
6025,6025,,105,128,233,812
6026,6026,,60,61,121,27
6027,6027,,60,61,121,27
6028,6028,,6,8,14,57
6029,6029,,0,0,0,312
6030,6030,,0,0,0,313
6031,6031,,17,21,38,27
6032,6032,,17,18,35,112
6033,6033,,2,3,5,46
6034,6034,,8,9,17,77
6035,6035,,7,61,68,47
6036,6036,,0,15,15,58
6037,6037,,52,0,52,58
6038,6038,,10,31,41,804
6039,6039,,30,11,41,804
6040,6040,,21,21,42,55
6041,6041,,43,43,86,216
6042,6042,,4,5,9,46
6043,6043,,11,12,23,215
6044,6044,,26,26,52,38
6045,6045,,8,8,16,41
6046,6046,,22,23,45,113
6047,6047,,17,12,29,49
6048,6048,,44,45,89,46
6049,6049,,18,19,37,46
6050,6050,,15,16,31,49
6051,6051,,22,23,45,30
6052,6052,,54,55,109,26
6053,6053,,54,60,114,26
6054,6054,,12,13,25,67
6055,6055,,57,58,115,41
6056,6056,,34,35,69,260
6057,6057,,29,30,59,44
6058,6058,,7,8,15,46
6059,6059,,4,4,8,804
6060,6060,,6,7,13,30
6061,6061,,21,22,43,58
6062,6062,,21,22,43,58
6063,6063,,3,4,7,27
6064,6064,,136,45,181,29
6065,6065,,6,7,13,260
6066,6066,,32,33,65,45
6067,6067,,6,8,14,113
6068,6068,,38,39,77,260
6069,6069,,49,49,98,74
6070,6070,,49,50,99,74
6071,6071,,10,11,21,33
6072,6072,,19,20,39,27
6073,6073,,61,113,174,815
6074,6074,,24,24,48,49
6075,6075,,16,26,42,25
6076,6076,,50,50,100,77
6077,6077,,41,41,82,272
6078,6078,,22,22,44,29
6079,6079,,0,0,0,314
6080,6080,,21,46,67,27
6081,6081,,59,60,119,316
6082,6082,,59,59,118,316
6083,6083,,22,23,45,46
6084,6084,,9,10,19,216
6085,6085,,4,31,35,19
6086,6086,,52,53,105,260
6087,6087,,29,30,59,14
6088,6088,,21,48,69,59
6089,6089,,58,8,66,27
6090,6090,,2,3,5,44
6091,6091,,63,64,127,280
6092,6092,,57,58,115,46
6093,6093,,14,14,28,25
6094,6094,,20,21,41,280
6095,6095,,7,6,13,49
6096,6096,,53,65,118,42
6097,6097,,64,53,117,42
6098,6098,,33,33,66,81
6099,6099,,33,34,67,81
6100,6100,,17,17,34,37
6101,6101,,6,7,13,46
6102,6102,,42,43,85,316
6103,6103,,4,4,8,316
6104,6104,,81,87,168,6
6105,6105,,48,49,97,316
6106,6106,,4,4,8,29
6107,6107,,23,44,67,73
6108,6108,,12,19,31,67
6109,6109,,25,0,25,58
6110,6110,,85,86,171,44
6111,6111,,88,89,177,259
6112,6112,,26,40,66,49
6113,6113,,20,21,41,40
6114,6114,,44,98,142,813
6115,6115,,97,45,142,813
6116,6116,,20,20,40,152
6117,6117,,20,21,41,152
6118,6118,,50,51,101,204
6119,6119,,56,64,120,804
6120,6120,,13,14,27,44
6121,6121,,30,31,61,73
6122,6122,,4,5,9,50
6123,6123,,26,27,53,59
6124,6124,,52,9,61,67
6125,6125,,29,29,58,804
6126,6126,,20,21,41,57
6127,6127,,20,21,41,57
6128,6128,,14,89,103,216
6129,6129,,22,22,44,77
6130,6130,,27,28,55,259
6131,6131,,46,47,93,43
6132,6132,,39,40,79,43
6133,6133,,25,25,50,58
6134,6134,,58,59,117,67
6135,6135,,8,9,17,26
6136,6136,,8,9,17,26
6137,6137,,1,1,2,73
6138,6138,,61,62,123,96
6139,6139,,17,18,35,26
6140,6140,,17,18,35,26
6141,6141,,27,28,55,53
6142,6142,,98,99,197,59
6143,6143,,0,0,0,315
6144,6144,,4,4,8,216
6145,6145,,40,112,152,316
6146,6146,,47,59,106,67
6147,6147,,7,112,119,815
6148,6148,,98,99,197,13
6149,6149,,60,61,121,41
6150,6150,,19,20,39,256
6151,6151,,34,35,69,27
6152,6152,,34,35,69,27
6153,6153,,71,72,143,42
6154,6154,,32,33,65,41
6155,6155,,32,33,65,41
6156,6156,,3,4,7,260
6157,6157,,6,7,13,21
6158,6158,,34,143,177,113
6159,6159,,142,35,177,113
6160,6160,,69,35,104,280
6161,6161,,3,4,7,46
6162,6162,,26,26,52,1
6163,6163,,13,14,27,47
6164,6164,,33,34,67,216
6165,6165,,58,59,117,42
6166,6166,,12,13,25,259
6167,6167,,18,43,61,272
6168,6168,,54,93,147,317
6169,6169,,92,55,147,317
6170,6170,,40,40,80,27
6171,6171,,40,41,81,27
6172,6172,,13,14,27,260
6173,6173,,13,14,27,260
6174,6174,,79,80,159,260
6175,6175,,72,3,75,316
6176,6176,,2,3,5,41
6177,6177,,9,10,19,46
6178,6178,,12,13,25,27
6179,6179,,4,9,13,152
6180,6180,,30,15,45,804
6181,6181,,23,20,43,38
6182,6182,,5,6,11,14
6183,6183,,3,5,8,57
6184,6184,,178,8,186,805
6185,6185,,7,356,363,805
6186,6186,,70,71,141,260
6187,6187,,40,7,47,804
6188,6188,,6,87,93,804
6189,6189,,19,19,38,77
6190,6190,,0,0,0,318
6191,6191,,47,47,94,260
6192,6192,,28,29,57,46
6193,6193,,8,8,16,42
6194,6194,,70,71,141,27
6195,6195,,94,62,156,41
6196,6196,,61,95,156,41
6197,6197,,52,53,105,44
6198,6198,,41,88,129,262
6199,6199,,17,15,32,260
6200,6200,,10,22,32,44
6201,6201,,3,64,67,26
6202,6202,,54,39,93,256
6203,6203,,38,55,93,256
6204,6204,,178,179,357,24
6205,6205,,178,179,357,24
6206,6206,,50,51,101,27
6207,6207,,50,51,101,27
6208,6208,,26,7,33,27
6209,6209,,3,4,7,27
6210,6210,,115,121,236,215
6211,6211,,22,23,45,259
6212,6212,,0,1,1,1300
6213,6213,,3,4,7,34
6214,6214,,19,20,39,46
6215,6215,,2,3,5,44
6216,6216,,31,6,37,96
6217,6217,,131,132,263,37
6218,6218,,10,67,77,67
6219,6219,,17,100,117,96
6220,6220,,45,10,55,260
6221,6221,,58,59,117,19
6222,6222,,4,47,51,77
6223,6223,,23,24,47,216
6224,6224,,90,149,239,815
6225,6225,,54,54,108,17
6226,6226,,37,38,75,44
6227,6227,,10,11,21,280
6228,6228,,48,49,97,144
6229,6229,,3,4,7,133
6230,6230,,14,14,28,152
6231,6231,,58,58,116,10
6232,6232,,52,53,105,59
6233,6233,,8,9,17,49
6234,6234,,7,8,15,43
6235,6235,,32,66,98,812
6236,6236,,65,33,98,812
6237,6237,,13,14,27,41
6238,6238,,7,8,15,35
6239,6239,,50,4,54,42
6240,6240,,8,9,17,73
6241,6241,,72,5,77,42
6242,6242,,4,5,9,44
6243,6243,,6,12,18,36
6244,6244,,8,9,17,124
6245,6245,,8,9,17,124
6246,6246,,49,50,99,67
6247,6247,,6,80,86,58
6248,6248,,4,4,8,35
6249,6249,,61,61,122,215
6250,6250,,61,62,123,215
6251,6251,,19,20,39,42
6252,6252,,13,20,33,804
6253,6253,,19,27,46,804
6254,6254,,53,53,106,27
6255,6255,,6,6,12,256
6256,6256,,6,8,14,113
6257,6257,,49,50,99,262
6258,6258,,10,11,21,260
6259,6259,,17,18,35,124
6260,6260,,31,32,63,44
6261,6261,,2,3,5,56
6262,6262,,23,24,47,79
6263,6263,,23,24,47,79
6264,6264,,21,4,25,152
6265,6265,,3,21,24,152
6266,6266,,35,36,71,81
6267,6267,,37,38,75,152
6268,6268,,34,65,99,27
6269,6269,,9,9,18,319
6270,6270,,9,9,18,319
6271,6271,,36,55,91,25
6272,6272,,54,50,104,25
6273,6273,,14,15,29,77
6274,6274,,57,58,115,4
6275,6275,,30,31,61,260
6276,6276,,18,18,36,255
6277,6277,,39,46,85,41
6278,6278,,8,9,17,144
6279,6279,,50,50,100,280
6280,6280,,17,30,47,804
6281,6281,,13,14,27,46
6282,6282,,2,2,4,11
6283,6283,,38,43,81,804
6284,6284,,9,10,19,74
6285,6285,,51,46,97,152
6286,6286,,18,18,36,19
6287,6287,,16,17,33,96
6288,6288,,16,17,33,96
6289,6289,,88,88,176,43
6290,6290,,8,8,16,34
6291,6291,,15,78,93,8
6292,6292,,4,5,9,79
6293,6293,,14,70,84,43
6294,6294,,69,15,84,43
6295,6295,,55,56,111,44
6296,6296,,0,3,3,815
6297,6297,,30,30,60,320
6298,6298,,79,1,80,260
6299,6299,,8,9,17,260
6300,6300,,13,13,26,27
6301,6301,,38,39,77,46
6302,6302,,6,7,13,46
6303,6303,,46,47,93,77
6304,6304,,27,28,55,215
6305,6305,,16,17,33,46
6306,6306,,16,17,33,46
6307,6307,,9,10,19,59
6308,6308,,21,21,42,301
6309,6309,,6,7,13,144
6310,6310,,6,7,13,144
6311,6311,,24,24,48,42
6312,6312,,24,25,49,42
6313,6313,,11,12,23,42
6314,6314,,52,52,104,20
6315,6315,,70,7,77,67
6316,6316,,6,71,77,67
6317,6317,,26,26,52,9
6318,6318,,61,61,122,316
6319,6319,,8,10,18,46
6320,6320,,49,3,52,124
6321,6321,,0,178,178,321
6322,6322,,178,0,178,321
6323,6323,,0,52,52,688
6324,6324,,15,0,15,688
6325,6325,,0,1,1,322
6326,6326,,1,0,1,322
6327,6327,,0,54,54,323
6328,6328,,55,0,55,323
6329,6329,,0,88,88,573
6330,6330,,105,0,105,573
6331,6331,,0,25,25,496
6332,6332,,15,0,15,496
6333,6333,,0,62,62,324
6334,6334,,62,0,62,324
6335,6335,,0,9,9,325
6336,6336,,9,0,9,325
6337,6337,,0,92,92,326
6338,6338,,95,0,95,326
6339,6339,,0,21,21,327
6340,6340,,21,0,21,327
6341,6341,,0,45,45,487
6342,6342,,14,0,14,487
6343,6343,,0,178,178,328
6344,6344,,178,0,178,328
6345,6345,,0,6,6,329
6346,6346,,6,0,6,329
6347,6347,,0,0,0,330
6348,6348,,0,4,4,782
6349,6349,,0,4,4,460
6350,6350,,14,0,14,460
6351,6351,,0,85,85,57
6352,6352,,49,0,49,57
6353,6353,,0,20,20,1412
6354,6354,,4,0,4,1412
6355,6355,,0,168,168,729
6356,6356,,295,0,295,729
6357,6357,,0,5,5,777
6358,6358,,21,0,21,777
6359,6359,,0,7,7,331
6360,6360,,7,0,7,331
6361,6361,,0,0,0,332
6362,6362,,0,0,0,333
6363,6363,,0,11,11,334
6364,6364,,11,0,11,334
6365,6365,,0,178,178,335
6366,6366,,178,0,178,335
6367,6367,,0,37,37,336
6368,6368,,44,0,44,336
6369,6369,,0,104,104,337
6370,6370,,104,0,104,337
6371,6371,,0,3,3,338
6372,6372,,3,0,3,338
6373,6373,,0,103,103,759
6374,6374,,168,0,168,759
6375,6375,,0,0,0,339
6376,6376,,0,0,0,340
6377,6377,,0,8,8,627
6378,6378,,125,0,125,627
6379,6379,,0,9,9,341
6380,6380,,10,0,10,341
6381,6381,,0,6,6,342
6382,6382,,6,0,6,342
6383,6383,,0,891,891,440
6384,6384,,178,0,178,440
6385,6385,,0,34,34,496
6386,6386,,13,0,13,496
6387,6387,,0,37,37,343
6388,6388,,37,0,37,343
6389,6389,,0,0,0,344
6390,6390,,0,0,0,345
6391,6391,,0,0,0,346
6392,6392,,0,0,0,347
6393,6393,,0,178,178,348
6394,6394,,178,0,178,348
6395,6395,,0,18,18,625
6396,6396,,155,0,155,625
6397,6397,,0,6,6,788
6398,6398,,30,0,30,788
6399,6399,,0,15,15,688
6400,6400,,2,0,2,688
6401,6401,,0,85,85,578
6402,6402,,173,0,173,578
6403,6403,,0,5,5,349
6404,6404,,5,0,5,349
6405,6405,,0,88,88,350
6406,6406,,88,0,88,350
6407,6407,,0,3,3,592
6408,6408,,10,0,10,592
6409,6409,,0,0,0,351
6410,6410,,0,0,0,352
6411,6411,,0,178,178,353
6412,6412,,178,0,178,353
6413,6413,,0,196,196,354
6414,6414,,178,0,178,354
6415,6415,,0,0,0,355
6416,6416,,1,0,1,453
6417,6417,,178,0,178,440
6418,6418,,0,293,293,648
6419,6419,,12,0,12,648
6420,6420,,0,7,7,356
6421,6421,,16,0,16,356
6422,6422,,0,0,0,357
6423,6423,,23,0,23,33
6424,6424,,0,79,79,358
6425,6425,,79,0,79,358
6426,6426,,0,37,37,359
6427,6427,,37,0,37,359
6428,6428,,0,90,90,688
6429,6429,,49,0,49,688
6430,6430,,0,46,46,360
6431,6431,,46,0,46,360
6432,6432,,0,3,3,416
6433,6433,,42,0,42,416
6434,6434,,0,211,211,729
6435,6435,,0,0,0,361
6436,6436,,0,0,0,362
6437,6437,,0,11,11,547
6438,6438,,28,0,28,547
6439,6439,,0,26,26,363
6440,6440,,26,0,26,363
6441,6441,,0,60,60,364
6442,6442,,71,0,71,364
6443,6443,,0,178,178,365
6444,6444,,178,0,178,365
6445,6445,,0,178,178,366
6446,6446,,178,0,178,366
6447,6447,,0,72,72,367
6448,6448,,72,0,72,367
6449,6449,,178,0,178,110
6450,6450,,138,0,138,152
6451,6451,,0,4,4,754
6452,6452,,11,0,11,754
6453,6453,,0,0,0,368
6454,6454,,0,0,0,369
6455,6455,,0,6,6,370
6456,6456,,6,0,6,370
6457,6457,,12,12,24,688
6458,6458,,0,0,0,371
6459,6459,,1,0,1,379
6460,6460,,0,9,9,372
6461,6461,,9,1,10,372
6462,6462,,0,0,0,373
6463,6463,,0,0,0,374
6464,6464,,0,13,13,570
6465,6465,,57,0,57,570
6466,6466,,94,0,94,216
6467,6467,,12,0,12,648
6468,6468,,0,178,178,375
6469,6469,,178,0,178,375
6470,6470,,0,14,14,686
6471,6471,,7,0,7,686
6472,6472,,0,56,56,460
6473,6473,,0,11,11,407
6474,6474,,13,0,13,407
6475,6475,,0,23,23,376
6476,6476,,26,0,26,376
6477,6477,,0,0,0,377
6478,6478,,0,0,0,378
6479,6479,,14,0,14,688
6480,6480,,0,1,1,379
6481,6481,,0,72,72,380
6482,6482,,72,0,72,380
6483,6483,,0,10,10,381
6484,6484,,10,0,10,381
6485,6485,,0,712,712,499
6486,6486,,178,0,178,499
6487,6487,,0,178,178,382
6488,6488,,178,0,178,382
6489,6489,,0,9,9,547
6490,6490,,0,185,185,383
6491,6491,,178,0,178,383
6492,6492,,12,0,12,648
6493,6493,,0,144,144,573
6494,6494,,17,0,17,573
6495,6495,,0,4,4,694
6496,6496,,21,0,21,694
6497,6497,,26,0,26,124
6498,6498,,0,5,5,535
6499,6499,,0,534,534,569
6500,6500,,178,0,178,569
6501,6501,,0,890,890,746
6502,6502,,178,0,178,746
6503,6503,,1,10,11,384
6504,6504,,7,0,7,384
6505,6505,,44,0,44,67
6506,6506,,0,42,42,688
6507,6507,,10,0,10,688
6508,6508,,0,3,3,777
6509,6509,,0,16,16,385
6510,6510,,20,0,20,385
6511,6511,,0,0,0,386
6512,6512,,0,0,0,387
6513,6513,,0,0,0,388
6514,6514,,0,0,0,389
6515,6515,,0,9,9,390
6516,6516,,9,0,9,390
6517,6517,,0,89,89,391
6518,6518,,89,0,89,391
6519,6519,,0,57,57,625
6520,6520,,49,0,49,625
6521,6521,,0,84,84,478
6522,6522,,172,0,172,478
6523,6523,,0,178,178,392
6524,6524,,178,0,178,392
6525,6525,,0,534,534,756
6526,6526,,178,0,178,756
6527,6527,,0,46,46,393
6528,6528,,46,0,46,393
6529,6529,,0,23,23,634
6530,6530,,75,0,75,634
6531,6531,,0,13,13,394
6532,6532,,14,0,14,394
6533,6533,,0,0,0,395
6534,6534,,0,0,0,396
6535,6535,,1,0,1,802
6536,6536,,0,4,4,385
6537,6537,,16,0,16,33
6538,6538,,0,0,0,397
6539,6539,,12,0,12,519
6540,6540,,0,2,2,398
6541,6541,,2,0,2,398
6542,6542,,0,77,77,399
6543,6543,,77,0,77,399
6544,6544,,0,0,0,400
6545,6545,,0,0,0,401
6546,6546,,0,508,508,709
6547,6547,,18,0,18,709
6548,6548,,0,3,3,402
6549,6549,,3,0,3,402
6550,6550,,0,178,178,403
6551,6551,,178,0,178,403
6552,6552,,0,0,0,404
6553,6553,,0,0,0,405
6554,6554,,0,2,2,722
6555,6555,,0,0,0,406
6556,6556,,0,5,5,407
6557,6557,,3,0,3,407
6558,6558,,0,6,6,708
6559,6559,,10,0,10,708
6560,6560,,0,8,8,726
6561,6561,,4,0,4,726
6562,6562,,0,0,0,408
6563,6563,,0,0,0,409
6564,6564,,0,178,178,410
6565,6565,,178,0,178,410
6566,6566,,0,35,35,411
6567,6567,,27,0,27,411
6568,6568,,0,178,178,412
6569,6569,,178,0,178,412
6570,6570,,0,0,0,413
6571,6571,,0,178,178,414
6572,6572,,178,0,178,414
6573,6573,,0,178,178,415
6574,6574,,178,0,178,415
6575,6575,,0,39,39,416
6576,6576,,0,18,18,417
6577,6577,,18,0,18,417
6578,6578,,12,0,12,648
6579,6579,,0,0,0,418
6580,6580,,0,0,0,419
6581,6581,,0,13,13,420
6582,6582,,13,0,13,420
6583,6583,,0,37,37,627
6584,6584,,2,3,5,1412
6585,6585,,0,8,8,421
6586,6586,,8,0,8,421
6587,6587,,0,39,39,422
6588,6588,,39,0,39,422
6589,6589,,0,12,12,423
6590,6590,,12,0,12,423
6591,6591,,0,3,3,326
6592,6592,,0,0,0,424
6593,6593,,0,0,0,425
6594,6594,,18,0,18,590
6595,6595,,37,0,37,259
6596,6596,,0,178,178,426
6597,6597,,178,0,178,426
6598,6598,,0,0,0,427
6599,6599,,0,0,0,428
6600,6600,,1,15,16,627
6601,6601,,40,0,40,627
6602,6602,,0,356,356,684
6603,6603,,178,0,178,684
6604,6604,,0,1,1,495
6605,6605,,10,0,10,495
6606,6606,,0,1,1,429
6607,6607,,1,0,1,429
6608,6608,,0,14,14,430
6609,6609,,21,0,21,430
6610,6610,,0,130,130,431
6611,6611,,70,0,70,431
6612,6612,,0,178,178,432
6613,6613,,178,0,178,432
6614,6614,,19,0,19,709
6615,6615,,0,9,9,688
6616,6616,,22,0,22,688
6617,6617,,0,8,8,627
6618,6618,,3,0,3,688
6619,6619,,0,178,178,433
6620,6620,,178,0,178,433
6621,6621,,0,6,6,434
6622,6622,,8,0,8,434
6623,6623,,0,3,3,758
6624,6624,,12,0,12,77
6625,6625,,0,3,3,435
6626,6626,,3,0,3,435
6627,6627,,12,0,12,648
6628,6628,,0,12,12,436
6629,6629,,24,0,24,436
6630,6630,,0,5,5,437
6631,6631,,5,0,5,437
6632,6632,,0,0,0,438
6633,6633,,0,0,0,439
6634,6634,,178,0,178,440
6635,6635,,8,0,8,688
6636,6636,,0,63,63,768
6637,6637,,218,0,218,768
6638,6638,,0,48,48,441
6639,6639,,25,0,25,441
6640,6640,,0,178,178,442
6641,6641,,178,0,178,442
6642,6642,,0,3,3,376
6643,6643,,0,16,16,627
6644,6644,,178,0,178,499
6645,6645,,0,7,7,443
6646,6646,,7,0,7,443
6647,6647,,0,0,0,444
6648,6648,,0,4,4,445
6649,6649,,11,0,11,445
6650,6650,,0,3,3,446
6651,6651,,3,0,3,446
6652,6652,,0,0,0,447
6653,6653,,0,0,0,448
6654,6654,,0,11,11,449
6655,6655,,11,0,11,449
6656,6656,,0,1,1,341
6657,6657,,0,13,13,450
6658,6658,,15,0,15,450
6659,6659,,19,0,19,709
6660,6660,,0,0,0,451
6661,6661,,0,0,0,452
6662,6662,,239,0,239,272
6663,6663,,12,0,12,758
6664,6664,,0,1,1,453
6665,6665,,0,0,0,454
6666,6666,,0,0,0,455
6667,6667,,0,0,0,456
6668,6668,,178,0,178,746
6669,6669,,0,29,29,699
6670,6670,,11,0,11,699
6671,6671,,0,0,0,457
6672,6672,,3,1,4,384
6673,6673,,0,10,10,688
6674,6674,,0,150,150,625
6675,6675,,183,0,183,625
6676,6676,,0,890,890,798
6677,6677,,178,0,178,798
6678,6678,,0,7,7,458
6679,6679,,14,0,14,458
6680,6680,,0,0,0,459
6681,6681,,2,0,2,542
6682,6682,,0,16,16,33
6683,6683,,0,6,6,486
6684,6684,,10,0,10,486
6685,6685,,51,0,51,460
6686,6686,,0,10,10,461
6687,6687,,10,0,10,461
6688,6688,,0,59,59,243
6689,6689,,0,178,178,462
6690,6690,,178,0,178,462
6691,6691,,46,0,46,113
6692,6692,,0,45,45,759
6693,6693,,0,28,28,463
6694,6694,,28,0,28,463
6695,6695,,0,0,0,464
6696,6696,,0,0,0,465
6697,6697,,10,0,10,688
6698,6698,,0,8,8,466
6699,6699,,8,0,8,466
6700,6700,,0,93,93,467
6701,6701,,93,0,93,467
6702,6702,,0,5,5,468
6703,6703,,7,0,7,468
6704,6704,,0,19,19,688
6705,6705,,0,15,15,216
6706,6706,,0,62,62,469
6707,6707,,62,0,62,469
6708,6708,,0,18,18,272
6709,6709,,80,0,80,272
6710,6710,,0,178,178,470
6711,6711,,178,0,178,470
6712,6712,,22,0,22,56
6713,6713,,0,40,40,471
6714,6714,,40,0,40,471
6715,6715,,2,0,2,535
6716,6716,,20,0,20,67
6717,6717,,0,79,79,581
6718,6718,,1,0,1,581
6719,6719,,5,0,5,709
6720,6720,,0,29,29,472
6721,6721,,29,0,29,472
6722,6722,,47,0,47,57
6723,6723,,0,356,356,493
6724,6724,,178,0,178,493
6725,6725,,0,178,178,473
6726,6726,,178,0,178,473
6727,6727,,0,0,0,474
6728,6728,,0,0,0,475
6729,6729,,178,0,178,746
6730,6730,,178,0,178,569
6731,6731,,0,5,5,476
6732,6732,,5,0,5,476
6733,6733,,0,178,178,477
6734,6734,,178,0,178,477
6735,6735,,0,88,88,478
6736,6736,,0,10,10,479
6737,6737,,10,0,10,479
6738,6738,,0,0,0,480
6739,6739,,0,0,0,481
6740,6740,,0,89,89,482
6741,6741,,94,0,94,482
6742,6742,,0,4,4,483
6743,6743,,8,0,8,483
6744,6744,,0,0,0,484
6745,6745,,0,178,178,485
6746,6746,,178,0,178,485
6747,6747,,12,0,12,648
6748,6748,,0,4,4,486
6749,6749,,2,0,2,486
6750,6750,,37,0,37,487
6751,6751,,0,30,30,755
6752,6752,,11,0,11,755
6753,6753,,0,0,0,488
6754,6754,,0,0,0,489
6755,6755,,0,0,0,490
6756,6756,,0,0,0,491
6757,6757,,0,60,60,492
6758,6758,,60,0,60,492
6759,6759,,178,0,178,493
6760,6760,,0,178,178,494
6761,6761,,178,0,178,494
6762,6762,,0,187,187,495
6763,6763,,178,0,178,495
6764,6764,,20,0,20,496
6765,6765,,12,0,12,648
6766,6766,,0,0,0,497
6767,6767,,0,0,0,498
6768,6768,,178,0,178,499
6769,6769,,12,0,12,648
6770,6770,,0,6,6,688
6771,6771,,0,178,178,500
6772,6772,,178,0,178,500
6773,6773,,168,0,168,216
6774,6774,,0,20,20,501
6775,6775,,20,0,20,501
6776,6776,,0,49,49,728
6777,6777,,222,0,222,728
6778,6778,,0,0,0,502
6779,6779,,0,0,0,503
6780,6780,,0,8,8,688
6781,6781,,0,178,178,504
6782,6782,,178,0,178,504
6783,6783,,0,5,5,505
6784,6784,,5,0,5,505
6785,6785,,0,178,178,506
6786,6786,,178,0,178,506
6787,6787,,0,6,6,67
6788,6788,,0,7,7,507
6789,6789,,7,0,7,507
6790,6790,,0,0,0,508
6791,6791,,0,0,0,509
6792,6792,,6,0,6,708
6793,6793,,0,65,65,510
6794,6794,,65,0,65,510
6795,6795,,0,8,8,511
6796,6796,,8,0,8,511
6797,6797,,0,178,178,512
6798,6798,,178,0,178,512
6799,6799,,0,24,24,113
6800,6800,,0,178,178,513
6801,6801,,178,0,178,513
6802,6802,,0,3,3,445
6803,6803,,0,0,0,514
6804,6804,,0,0,0,515
6805,6805,,0,7,7,458
6806,6806,,8,0,8,579
6807,6807,,0,712,712,567
6808,6808,,178,0,178,567
6809,6809,,0,2,2,516
6810,6810,,2,0,2,516
6811,6811,,0,7,7,356
6812,6812,,26,0,26,581
6813,6813,,0,4,4,696
6814,6814,,31,0,31,696
6815,6815,,0,0,0,517
6816,6816,,178,178,356,684
6817,6817,,0,17,17,518
6818,6818,,24,0,24,518
6819,6819,,0,12,12,519
6820,6820,,0,5,5,520
6821,6821,,5,0,5,520
6822,6822,,9,0,9,709
6823,6823,,0,11,11,364
6824,6824,,0,21,21,521
6825,6825,,15,0,15,521
6826,6826,,0,178,178,522
6827,6827,,178,0,178,522
6828,6828,,0,0,0,523
6829,6829,,0,178,178,524
6830,6830,,178,0,178,524
6831,6831,,0,85,85,525
6832,6832,,85,0,85,525
6833,6833,,0,3,3,526
6834,6834,,3,0,3,526
6835,6835,,18,0,18,709
6836,6836,,0,49,49,527
6837,6837,,49,0,49,527
6838,6838,,0,6,6,528
6839,6839,,6,0,6,528
6840,6840,,0,2,2,680
6841,6841,,14,0,14,680
6842,6842,,0,17,17,529
6843,6843,,17,0,17,529
6844,6844,,178,1,179,547
6845,6845,,0,0,0,530
6846,6846,,0,0,0,531
6847,6847,,0,0,0,532
6848,6848,,0,0,0,533
6849,6849,,5,0,5,688
6850,6850,,0,84,84,216
6851,6851,,0,16,16,534
6852,6852,,16,0,16,534
6853,6853,,3,0,3,535
6854,6854,,106,0,106,73
6855,6855,,0,356,356,536
6856,6856,,178,0,178,536
6857,6857,,0,4,4,537
6858,6858,,4,0,4,537
6859,6859,,0,40,40,728
6860,6860,,12,0,12,648
6861,6861,,0,0,0,538
6862,6862,,0,0,0,539
6863,6863,,0,56,56,540
6864,6864,,56,0,56,540
6865,6865,,0,9,9,541
6866,6866,,15,0,15,541
6867,6867,,0,1,1,542
6868,6868,,9,0,9,572
6869,6869,,178,0,178,756
6870,6870,,0,0,0,543
6871,6871,,0,0,0,544
6872,6872,,0,10,10,44
6873,6873,,13,0,13,44
6874,6874,,0,0,0,545
6875,6875,,0,0,0,546
6876,6876,,21,0,21,675
6877,6877,,0,356,356,547
6878,6878,,0,0,0,548
6879,6879,,0,0,0,549
6880,6880,,0,0,0,550
6881,6881,,0,39,39,551
6882,6882,,39,0,39,551
6883,6883,,0,0,0,552
6884,6884,,0,0,0,553
6885,6885,,0,178,178,554
6886,6886,,178,0,178,554
6887,6887,,0,16,16,555
6888,6888,,16,0,16,555
6889,6889,,0,178,178,556
6890,6890,,178,0,178,556
6891,6891,,0,0,0,557
6892,6892,,0,8,8,547
6893,6893,,0,1,1,542
6894,6894,,0,2,2,336
6895,6895,,0,0,0,558
6896,6896,,0,0,0,559
6897,6897,,0,178,178,560
6898,6898,,178,0,178,560
6899,6899,,0,0,0,561
6900,6900,,0,0,0,562
6901,6901,,0,2,2,450
6902,6902,,0,0,0,563
6903,6903,,0,0,0,564
6904,6904,,0,0,0,565
6905,6905,,0,0,0,566
6906,6906,,12,0,12,648
6907,6907,,178,0,178,567
6908,6908,,13,0,13,1412
6909,6909,,34,0,34,688
6910,6910,,0,0,0,568
6911,6911,,5,0,5,124
6912,6912,,9,0,9,709
6913,6913,,178,0,178,569
6914,6914,,0,3,3,487
6915,6915,,0,19,19,67
6916,6916,,0,44,44,570
6917,6917,,0,82,82,571
6918,6918,,86,0,86,571
6919,6919,,0,9,9,572
6920,6920,,47,0,47,573
6921,6921,,0,82,82,574
6922,6922,,82,0,82,574
6923,6923,,0,45,45,575
6924,6924,,45,0,45,575
6925,6925,,18,0,18,215
6926,6926,,0,48,48,216
6927,6927,,0,0,0,576
6928,6928,,0,178,178,776
6929,6929,,14,0,14,688
6930,6930,,0,178,178,577
6931,6931,,178,0,178,577
6932,6932,,0,88,88,578
6933,6933,,16,0,16,688
6934,6934,,0,338,338,663
6935,6935,,93,0,93,663
6936,6936,,0,5,5,336
6937,6937,,0,3,3,627
6938,6938,,0,8,8,579
6939,6939,,178,0,178,547
6940,6940,,0,66,66,580
6941,6941,,66,0,66,580
6942,6942,,26,0,26,581
6943,6943,,0,2,2,596
6944,6944,,7,0,7,596
6945,6945,,0,8,8,301
6946,6946,,14,0,14,301
6947,6947,,0,75,75,582
6948,6948,,75,0,75,582
6949,6949,,0,0,0,583
6950,6950,,0,0,0,584
6951,6951,,0,356,356,687
6952,6952,,178,0,178,687
6953,6953,,5,0,5,709
6954,6954,,0,4,4,113
6955,6955,,0,87,87,585
6956,6956,,87,0,87,585
6957,6957,,0,8,8,586
6958,6958,,8,0,8,586
6959,6959,,0,5,5,460
6960,6960,,0,2,2,468
6961,6961,,0,0,0,587
6962,6962,,0,0,0,588
6963,6963,,0,4,4,710
6964,6964,,2,0,2,710
6965,6965,,0,77,77,589
6966,6966,,77,0,77,589
6967,6967,,0,34,34,590
6968,6968,,17,0,17,590
6969,6969,,12,0,12,648
6970,6970,,0,3,3,591
6971,6971,,3,0,3,591
6972,6972,,0,7,7,592
6973,6973,,0,8,8,593
6974,6974,,8,0,8,593
6975,6975,,0,0,0,594
6976,6976,,0,21,21,629
6977,6977,,10,0,10,629
6978,6978,,0,3,3,595
6979,6979,,5,0,5,595
6980,6980,,0,5,5,596
6981,6981,,115,0,115,573
6982,6982,,42,0,42,30
6983,6983,,0,0,0,597
6984,6984,,0,2,2,708
6985,6985,,12,0,12,648
6986,6986,,0,34,34,598
6987,6987,,34,0,34,598
6988,6988,,0,0,0,599
6989,6989,,0,0,0,600
6990,6990,,0,24,24,601
6991,6991,,24,0,24,601
6992,6992,,18,0,18,354
6993,6993,,2,0,2,804
6994,6994,,0,5,5,602
6995,6995,,5,0,5,602
6996,6996,,18,0,18,709
6997,6997,,0,3,3,603
6998,6998,,3,0,3,603
6999,6999,,33,0,33,73
7000,7000,,0,356,356,604
7001,7001,,178,0,178,604
7002,7002,,0,0,0,605
7003,7003,,0,0,0,606
7004,7004,,0,18,18,607
7005,7005,,18,0,18,607
7006,7006,,0,3,3,487
7007,7007,,0,5,5,216
7008,7008,,0,178,178,608
7009,7009,,178,0,178,608
7010,7010,,12,0,12,648
7011,7011,,12,0,12,648
7012,7012,,0,0,0,609
7013,7013,,0,0,0,610
7014,7014,,0,0,0,611
7015,7015,,0,0,0,612
7016,7016,,0,23,23,613
7017,7017,,23,0,23,613
7018,7018,,11,0,11,688
7019,7019,,0,178,178,614
7020,7020,,178,0,178,614
7021,7021,,12,0,12,648
7022,7022,,178,0,178,567
7023,7023,,0,2,2,615
7024,7024,,2,0,2,615
7025,7025,,23,0,23,441
7026,7026,,0,0,0,616
7027,7027,,3,0,3,171
7028,7028,,22,0,22,688
7029,7029,,0,0,0,617
7030,7030,,0,0,0,618
7031,7031,,19,0,19,709
7032,7032,,0,178,178,619
7033,7033,,178,0,178,619
7034,7034,,18,0,18,709
7035,7035,,0,0,0,620
7036,7036,,8,0,8,672
7037,7037,,7,0,7,688
7038,7038,,12,0,12,648
7039,7039,,6,0,6,709
7040,7040,,0,356,356,621
7041,7041,,178,0,178,621
7042,7042,,0,0,0,622
7043,7043,,0,178,178,623
7044,7044,,178,0,178,623
7045,7045,,0,178,178,624
7046,7046,,178,0,178,624
7047,7047,,0,122,122,625
7048,7048,,0,2,2,434
7049,7049,,58,0,58,42
7050,7050,,12,0,12,648
7051,7051,,0,2,2,759
7052,7052,,21,0,21,759
7053,7053,,19,0,19,709
7054,7054,,0,178,178,626
7055,7055,,178,0,178,626
7056,7056,,0,45,45,627
7057,7057,,0,178,178,628
7058,7058,,178,0,178,628
7059,7059,,0,4,4,33
7060,7060,,11,0,11,629
7061,7061,,0,356,356,630
7062,7062,,178,0,178,630
7063,7063,,12,0,12,648
7064,7064,,178,0,178,630
7065,7065,,0,1,1,590
7066,7066,,0,0,0,631
7067,7067,,0,11,11,431
7068,7068,,71,0,71,431
7069,7069,,0,178,178,632
7070,7070,,178,0,178,632
7071,7071,,0,178,178,633
7072,7072,,178,0,178,633
7073,7073,,0,26,26,634
7074,7074,,0,178,178,635
7075,7075,,178,0,178,635
7076,7076,,0,0,0,636
7077,7077,,0,0,0,637
7078,7078,,0,12,12,638
7079,7079,,12,0,12,638
7080,7080,,0,19,19,639
7081,7081,,34,0,34,639
7082,7082,,0,94,94,640
7083,7083,,94,0,94,640
7084,7084,,0,60,60,641
7085,7085,,60,0,60,641
7086,7086,,0,34,34,642
7087,7087,,34,0,34,642
7088,7088,,0,0,0,643
7089,7089,,0,0,0,644
7090,7090,,0,22,22,645
7091,7091,,22,0,22,645
7092,7092,,0,41,41,646
7093,7093,,41,0,41,646
7094,7094,,0,7,7,647
7095,7095,,14,0,14,647
7096,7096,,15,0,15,648
7097,7097,,0,178,178,649
7098,7098,,178,0,178,649
7099,7099,,0,5,5,777
7100,7100,,0,0,0,650
7101,7101,,0,0,0,651
7102,7102,,0,4,4,652
7103,7103,,4,0,4,652
7104,7104,,60,0,60,709
7105,7105,,0,178,178,653
7106,7106,,178,0,178,653
7107,7107,,19,0,19,38
7108,7108,,0,0,0,654
7109,7109,,0,0,0,655
7110,7110,,0,0,0,656
7111,7111,,0,0,0,657
7112,7112,,3,0,3,688
7113,7113,,0,101,101,658
7114,7114,,101,0,101,658
7115,7115,,0,0,0,659
7116,7116,,178,0,178,798
7117,7117,,178,0,178,604
7118,7118,,0,178,178,660
7119,7119,,178,0,178,660
7120,7120,,0,32,32,661
7121,7121,,32,0,32,661
7122,7122,,0,0,0,662
7123,7123,,178,0,178,663
7124,7124,,0,53,53,664
7125,7125,,59,0,59,664
7126,7126,,0,2,2,356
7127,7127,,0,356,356,665
7128,7128,,178,0,178,665
7129,7129,,0,0,0,666
7130,7130,,0,0,0,667
7131,7131,,0,32,32,668
7132,7132,,32,0,32,668
7133,7133,,0,0,0,669
7134,7134,,93,0,93,301
7135,7135,,0,13,13,670
7136,7136,,13,0,13,670
7137,7137,,0,178,178,671
7138,7138,,178,0,178,671
7139,7139,,178,0,178,440
7140,7140,,178,0,178,746
7141,7141,,0,8,8,672
7142,7142,,0,0,0,673
7143,7143,,0,0,0,674
7144,7144,,0,18,18,573
7145,7145,,8,0,8,411
7146,7146,,178,0,178,114
7147,7147,,15,0,15,204
7148,7148,,0,21,21,675
7149,7149,,0,8,8,113
7150,7150,,2,0,2,688
7151,7151,,0,0,0,676
7152,7152,,0,0,0,677
7153,7153,,0,0,0,678
7154,7154,,0,8,8,679
7155,7155,,8,0,8,679
7156,7156,,0,37,37,680
7157,7157,,0,69,69,681
7158,7158,,69,0,69,681
7159,7159,,178,0,178,53
7160,7160,,0,56,56,682
7161,7161,,56,0,56,682
7162,7162,,0,5,5,759
7163,7163,,0,2,2,67
7164,7164,,178,0,178,152
7165,7165,,108,0,108,11
7166,7166,,0,94,94,301
7167,7167,,0,21,21,73
7168,7168,,178,0,178,621
7169,7169,,0,5,5,683
7170,7170,,5,0,5,683
7171,7171,,26,0,26,581
7172,7172,,0,5,5,482
7173,7173,,21,0,21,496
7174,7174,,178,0,178,684
7175,7175,,18,0,18,709
7176,7176,,0,2,2,713
7177,7177,,5,0,5,713
7178,7178,,0,7,7,685
7179,7179,,7,0,7,685
7180,7180,,0,58,58,686
7181,7181,,72,0,72,686
7182,7182,,178,0,178,687
7183,7183,,4,0,4,688
7184,7184,,0,178,178,689
7185,7185,,178,0,178,689
7186,7186,,178,0,178,567
7187,7187,,0,178,178,690
7188,7188,,178,0,178,690
7189,7189,,0,0,0,691
7190,7190,,0,0,0,692
7191,7191,,178,0,178,499
7192,7192,,0,0,0,693
7193,7193,,0,24,24,759
7194,7194,,0,17,17,694
7195,7195,,4,0,4,680
7196,7196,,0,14,14,695
7197,7197,,14,0,14,695
7198,7198,,0,27,27,696
7199,7199,,0,27,27,697
7200,7200,,27,0,27,697
7201,7201,,0,178,178,698
7202,7202,,178,0,178,698
7203,7203,,0,31,31,699
7204,7204,,49,0,49,699
7205,7205,,0,100,100,700
7206,7206,,100,0,100,700
7207,7207,,178,0,178,798
7208,7208,,178,31,209,707
7209,7209,,31,0,31,707
7210,7210,,0,30,30,701
7211,7211,,30,0,30,701
7212,7212,,0,3,3,702
7213,7213,,3,0,3,702
7214,7214,,19,0,19,709
7215,7215,,0,14,14,703
7216,7216,,14,0,14,703
7217,7217,,0,52,52,728
7218,7218,,67,0,67,663
7219,7219,,0,178,178,704
7220,7220,,178,0,178,704
7221,7221,,0,12,12,705
7222,7222,,12,0,12,705
7223,7223,,0,7,7,706
7224,7224,,7,0,7,706
7225,7225,,178,0,178,133
7226,7226,,0,178,178,707
7227,7227,,0,3,3,758
7228,7228,,0,6,6,541
7229,7229,,0,8,8,708
7230,7230,,14,0,14,648
7231,7231,,60,0,60,709
7232,7232,,0,6,6,113
7233,7233,,0,14,14,710
7234,7234,,16,0,16,710
7235,7235,,0,4,4,711
7236,7236,,8,0,8,711
7237,7237,,0,121,121,272
7238,7238,,0,178,178,712
7239,7239,,178,0,178,712
7240,7240,,0,3,3,713
7241,7241,,0,21,21,714
7242,7242,,21,0,21,714
7243,7243,,0,0,0,715
7244,7244,,0,0,0,716
7245,7245,,0,9,9,204
7246,7246,,2,0,2,680
7247,7247,,0,12,12,717
7248,7248,,12,0,12,717
7249,7249,,0,5,5,718
7250,7250,,5,0,5,718
7251,7251,,5,0,5,680
7252,7252,,0,34,34,573
7253,7253,,0,178,178,719
7254,7254,,178,0,178,719
7255,7255,,0,6,6,664
7256,7256,,5,0,5,521
7257,7257,,0,0,0,720
7258,7258,,0,107,107,721
7259,7259,,107,0,107,721
7260,7260,,0,7,7,430
7261,7261,,178,0,178,536
7262,7262,,1,0,1,722
7263,7263,,0,10,10,496
7264,7264,,0,26,26,634
7265,7265,,4,0,4,680
7266,7266,,0,0,0,723
7267,7267,,0,0,0,724
7268,7268,,0,32,32,725
7269,7269,,32,0,32,725
7270,7270,,4,0,4,726
7271,7271,,0,178,178,727
7272,7272,,178,0,178,727
7273,7273,,0,82,82,728
7274,7274,,192,0,192,729
7275,7275,,19,0,19,709
7276,7276,,19,0,19,709
7277,7277,,0,4,4,445
7278,7278,,0,11,11,730
7279,7279,,11,0,11,730
7280,7280,,59,0,59,74
7281,7281,,0,4,4,731
7282,7282,,4,0,4,731
7283,7283,,0,0,0,732
7284,7284,,0,0,0,733
7285,7285,,0,2,2,734
7286,7286,,2,0,2,734
7287,7287,,87,0,87,90
7288,7288,,0,0,0,735
7289,7289,,0,0,0,736
7290,7290,,0,10,10,737
7291,7291,,10,0,10,737
7292,7292,,9,0,9,709
7293,7293,,0,0,0,738
7294,7294,,0,88,88,739
7295,7295,,88,0,88,739
7296,7296,,0,178,178,740
7297,7297,,178,0,178,740
7298,7298,,0,15,15,639
7299,7299,,19,0,19,709
7300,7300,,0,12,12,436
7301,7301,,0,52,52,741
7302,7302,,52,0,52,741
7303,7303,,0,2,2,486
7304,7304,,0,76,76,742
7305,7305,,76,0,76,742
7306,7306,,0,0,0,743
7307,7307,,0,2,2,749
7308,7308,,5,0,5,749
7309,7309,,0,7,7,686
7310,7310,,12,0,12,648
7311,7311,,178,0,178,53
7312,7312,,0,0,0,744
7313,7313,,0,0,0,745
7314,7314,,178,0,178,746
7315,7315,,0,178,178,747
7316,7316,,178,0,178,747
7317,7317,,0,178,178,748
7318,7318,,178,0,178,748
7319,7319,,0,3,3,749
7320,7320,,0,77,77,768
7321,7321,,0,0,0,750
7322,7322,,0,0,0,751
7323,7323,,0,36,36,752
7324,7324,,36,0,36,752
7325,7325,,178,0,178,665
7326,7326,,0,2,2,595
7327,7327,,178,0,178,440
7328,7328,,0,4,4,711
7329,7329,,9,0,9,709
7330,7330,,0,2,2,753
7331,7331,,2,0,2,753
7332,7332,,0,9,9,754
7333,7333,,0,7,7,518
7334,7334,,19,0,19,755
7335,7335,,178,0,178,756
7336,7336,,0,0,0,757
7337,7337,,0,6,6,758
7338,7338,,0,10,10,759
7339,7339,,0,64,64,760
7340,7340,,64,0,64,760
7341,7341,,0,85,85,761
7342,7342,,85,0,85,761
7343,7343,,3,0,3,125
7344,7344,,0,0,0,762
7345,7345,,0,0,0,763
7346,7346,,0,108,108,729
7347,7347,,0,2,2,764
7348,7348,,2,0,2,764
7349,7349,,0,2,2,765
7350,7350,,2,0,2,765
7351,7351,,0,5,5,766
7352,7352,,5,0,5,766
7353,7353,,12,0,12,648
7354,7354,,0,178,178,767
7355,7355,,178,0,178,767
7356,7356,,0,78,78,768
7357,7357,,178,0,178,798
7358,7358,,0,178,178,769
7359,7359,,178,0,178,769
7360,7360,,0,13,13,770
7361,7361,,13,0,13,770
7362,7362,,0,178,178,771
7363,7363,,178,0,178,771
7364,7364,,0,12,12,772
7365,7365,,12,0,12,772
7366,7366,,19,0,19,709
7367,7367,,9,0,9,709
7368,7368,,6,0,6,709
7369,7369,,0,178,178,773
7370,7370,,178,0,178,773
7371,7371,,0,17,17,627
7372,7372,,0,4,4,774
7373,7373,,4,0,4,774
7374,7374,,7,0,7,383
7375,7375,,0,71,71,775
7376,7376,,71,0,71,775
7377,7377,,178,0,178,776
7378,7378,,0,8,8,777
7379,7379,,10,0,10,680
7380,7380,,0,14,14,778
7381,7381,,14,0,14,778
7382,7382,,0,0,0,779
7383,7383,,0,0,0,780
7384,7384,,0,1,1,828
7385,7385,,0,178,178,781
7386,7386,,178,0,178,781
7387,7387,,4,0,4,782
7388,7388,,0,0,0,783
7389,7389,,0,178,178,784
7390,7390,,178,0,178,784
7391,7391,,0,16,16,627
7392,7392,,0,4,4,571
7393,7393,,0,8,8,785
7394,7394,,8,0,8,785
7395,7395,,12,0,12,648
7396,7396,,0,81,81,786
7397,7397,,81,0,81,786
7398,7398,,1,48,49,1454
7399,7399,,48,0,48,1454
7400,7400,,0,0,0,787
7401,7401,,0,24,24,788
7402,7402,,60,0,60,709
7403,7403,,0,83,83,789
7404,7404,,83,0,83,789
7405,7405,,1,0,1,521
7406,7406,,0,0,0,790
7407,7407,,0,0,0,791
7408,7408,,0,0,0,792
7409,7409,,0,0,0,793
7410,7410,,0,0,0,794
7411,7411,,0,0,0,795
7412,7412,,0,4,4,483
7413,7413,,0,0,0,796
7414,7414,,0,0,0,797
7415,7415,,178,0,178,798
7416,7416,,12,0,12,648
7417,7417,,0,0,0,799
7418,7418,,0,0,0,800
7419,7419,,0,7,7,647
7420,7420,,0,40,40,625
7421,7421,,0,178,178,801
7422,7422,,178,0,178,801
7423,7423,,2,0,2,110
7424,7424,,0,2,2,802
7425,7425,,3,0,3,46
7426,7426,,0,3,3,46
7427,7427,,6,0,6,46
7428,7428,,4,0,4,73
7429,7429,,0,3,3,133
7430,7430,,4,0,4,113
7431,7431,,3,0,3,255
7432,7432,,4,0,4,46
7433,7433,,0,4,4,316
7434,7434,,0,3,3,113
7435,7435,,4,0,4,67
7436,7436,,17,0,17,113
7437,7437,,0,3,3,67
7438,7438,,4,0,4,67
7439,7439,,3,0,3,124
7440,7440,,0,3,3,77
7441,7441,,6,0,6,77
7442,7442,,5,0,5,77
7443,7443,,0,3,3,113
7444,7444,,4,0,4,96
7445,7445,,12,0,12,113
7446,7446,,15,0,15,67
7447,7447,,0,3,3,144
7448,7448,,5,0,5,74
7449,7449,,0,3,3,152
7450,7450,,0,3,3,67
7451,7451,,0,3,3,77
7452,7452,,6,0,6,73
7453,7453,,4,0,4,113
7454,7454,,6,0,6,77
7455,7455,,9,0,9,113
7456,7456,,10,0,10,260
7457,7457,,0,3,3,67
7458,7458,,0,3,3,67
7459,7459,,14,0,14,67
7460,7460,,4,0,4,67
7461,7461,,2,0,2,73
7462,7462,,0,3,3,67
7463,7463,,3,0,3,67
7464,7464,,0,3,3,113
7465,7465,,3,0,3,74
7466,7466,,0,2,2,67
7467,7467,,0,3,3,74
7468,7468,,0,3,3,74
7469,7469,,3,0,3,73
7470,7470,,0,3,3,77
7471,7471,,0,3,3,77
7472,7472,,0,3,3,67
7473,7473,,0,4,4,67
7474,7474,,3,0,3,113
7475,7475,,0,3,3,113
7476,7476,,0,3,3,260
7477,7477,,0,3,3,112
7478,7478,,0,3,3,74
7479,7479,,4,0,4,42
7480,7480,,0,3,3,113
7481,7481,,3,0,3,112
7482,7482,,4,0,4,29
7483,7483,,0,2,2,113
7484,7484,,0,3,3,42
7485,7485,,0,3,3,44
7486,7486,,0,3,3,113
7487,7487,,0,55,55,804
7488,7488,,0,40,40,804
7489,7489,,3,0,3,45
7490,7490,,4,0,4,46
7491,7491,,0,30,30,804
7492,7492,,0,55,55,22
7493,7493,,4,0,4,67
7494,7494,,0,32,32,818
7495,7495,,0,56,56,21
7496,7496,,2,0,2,90
7497,7497,,0,99,99,804
7498,7498,,0,3,3,260
7499,7499,,0,2,2,1494
7500,7500,,0,42,42,804
7501,7501,,4,0,4,46
7502,7502,,4,0,4,57
7503,7503,,12,0,12,259
7504,7504,,0,94,94,806
7505,7505,,0,3,3,171
7506,7506,,0,5,5,815
7507,7507,,0,214,214,804
7508,7508,,0,194,194,806
7509,7509,,3,0,3,301
7510,7510,,2,0,2,256
7511,7511,,0,3,3,804
7512,7512,,0,14,14,804
7513,7513,,8,0,8,47
7514,7514,,0,202,202,805
7515,7515,,0,7,7,34
7516,7516,,0,48,48,815
7517,7517,,5,0,5,815
7518,7518,,0,9,9,804
7519,7519,,4,0,4,59
7520,7520,,4,0,4,47
7521,7521,,0,4,4,260
7522,7522,,0,298,298,806
7523,7523,,0,23,23,812
7524,7524,,2,0,2,67
7525,7525,,3,0,3,67
7526,7526,,0,357,357,805
7527,7527,,0,192,192,804
7528,7528,,0,67,67,804
7529,7529,,0,3,3,19
7530,7530,,0,105,105,806
7531,7531,,0,183,183,806
7532,7532,,0,53,53,804
7533,7533,,0,173,173,804
7534,7534,,1,0,1,260
7535,7535,,0,167,167,806
7536,7536,,0,40,40,22
7537,7537,,0,206,206,805
7538,7538,,0,5,5,73
7539,7539,,0,25,25,812
7540,7540,,0,37,37,815
7541,7541,,3,0,3,46
7542,7542,,4,0,4,46
7543,7543,,0,31,31,804
7544,7544,,0,144,144,804
7545,7545,,0,24,24,804
7546,7546,,0,184,184,806
7547,7547,,0,23,23,804
7548,7548,,4,0,4,46
7549,7549,,0,129,129,815
7550,7550,,0,91,91,806
7551,7551,,3,0,3,806
7552,7552,,0,4,4,815
7553,7553,,0,251,251,806
7554,7554,,0,22,22,22
7555,7555,,0,38,38,804
7556,7556,,0,7,7,804
7557,7557,,0,141,141,815
7558,7558,,0,6,6,215
7559,7559,,0,112,112,815
7560,7560,,0,21,21,806
7561,7561,,3,0,3,806
7562,7562,,0,139,139,804
7563,7563,,0,3,3,301
7564,7564,,0,1,1,1185
7565,7565,,0,294,294,812
7566,7566,,0,3,3,1876
7567,7567,,0,357,357,805
7568,7568,,0,171,171,804
7569,7569,,0,155,155,804
7570,7570,,0,13,13,815
7571,7571,,0,196,196,804
7572,7572,,0,191,191,805
7573,7573,,6,0,6,806
7574,7574,,0,15,15,804
7575,7575,,0,55,55,40
7576,7576,,0,64,64,804
7577,7577,,0,242,242,812
7578,7578,,0,91,91,806
7579,7579,,0,220,220,804
7580,7580,,0,209,209,804
7581,7581,,0,207,207,806
7582,7582,,0,4,4,41
7583,7583,,0,25,25,804
7584,7584,,0,188,188,812
7585,7585,,0,188,188,804
7586,7586,,0,202,202,805
7587,7587,,0,169,169,806
7588,7588,,3,0,3,144
7589,7589,,0,33,33,25
7590,7590,,0,2,2,27
7591,7591,,0,162,162,804
7592,7592,,0,63,63,804
7593,7593,,0,191,191,806
7594,7594,,0,156,156,806
7595,7595,,0,183,183,805
7596,7596,,0,50,50,25
7597,7597,,0,348,348,806
7598,7598,,0,34,34,804
7599,7599,,0,182,182,804
7600,7600,,0,205,205,806
7601,7601,,0,226,226,806
7602,7602,,0,55,55,804
7603,7603,,0,127,127,806
7604,7604,,0,24,24,815
7605,7605,,0,3,3,1274
7606,7606,,0,1,1,216
7607,7607,,0,127,127,806
7608,7608,,0,625,625,804
7609,7609,,0,43,43,804
7610,7610,,0,138,138,806
7611,7611,,0,14,14,813
7612,7612,,0,118,118,804
7613,7613,,0,70,70,22
7614,7614,,0,190,190,806
7615,7615,,0,4,4,280
7616,7616,,0,187,187,804
7617,7617,,0,12,12,42
7618,7618,,0,127,127,806
7619,7619,,0,199,199,806
7620,7620,,0,3,3,16
7621,7621,,0,3,3,255
7622,7622,,0,142,142,804
7623,7623,,0,356,356,806
7624,7624,,0,1,1,216
7625,7625,,0,23,23,804
7626,7626,,0,147,147,815
7627,7627,,0,7,7,19
7628,7628,,0,15,15,804
7629,7629,,0,389,389,804
7630,7630,,0,207,207,806
7631,7631,,0,121,121,815
7632,7632,,0,4,4,1781
7633,7633,,0,20,20,815
7634,7634,,0,165,165,804
7635,7635,,0,2,2,926
7636,7636,,0,357,357,805
7637,7637,,0,7,7,30
7638,7638,,0,57,57,804
7639,7639,,0,0,0,803
7640,7640,,0,191,191,805
7641,7641,,0,7,7,804
7642,7642,,0,127,127,815
7643,7643,,0,3,3,46
7644,7644,,0,3,3,30
7645,7645,,0,111,111,806
7646,7646,,0,47,47,815
7647,7647,,0,127,127,806
7648,7648,,0,5,5,40
7649,7649,,0,183,183,806
7650,7650,,0,127,127,806
7651,7651,,0,86,86,806
7652,7652,,2593,0,2593,806
7653,7653,,4888,0,4888,804
7654,7654,,675,0,675,804
7655,7655,,187,0,187,40
7656,7656,,218,0,218,813
7657,7657,,100,0,100,804
7658,7658,,10,0,10,255
7659,7659,,3631,0,3631,804
7660,7660,,293,0,293,812
7661,7661,,54,0,54,21
7662,7662,,0,212,212,805
7663,7663,,3027,0,3027,805
7664,7664,,1459,0,1459,806
7665,7665,,3085,0,3085,806
7666,7666,,0,42,42,812
7667,7667,,260,0,260,812
7668,7668,,452,0,452,40
7669,7669,,61,0,61,813
7670,7670,,52,0,52,815
7671,7671,,0,251,251,815
7672,7672,,887,0,887,815
7673,7673,,0,189,189,804
7674,7674,,1777,0,1777,804
7675,7675,,30,0,30,804
7676,7676,,0,184,184,806
7677,7677,,6478,0,6478,806
7678,7678,,0,46,46,813
7679,7679,,18,0,18,813
7680,7680,,378,0,378,804
7681,7681,,1173,0,1173,806
7682,7682,,0,0,0,807
7683,7683,,11,0,11,239
7684,7684,,3553,0,3553,806
7685,7685,,99,0,99,813
7686,7686,,3,0,3,815
7687,7687,,0,269,269,806
7688,7688,,11,0,11,22
7689,7689,,0,67,67,22
7690,7690,,88,0,88,22
7691,7691,,1298,0,1298,806
7692,7692,,39,0,39,42
7693,7693,,0,16,16,14
7694,7694,,41,0,41,14
7695,7695,,0,14,14,812
7696,7696,,174,0,174,812
7697,7697,,504,0,504,812
7698,7698,,34,0,34,25
7699,7699,,35,0,35,818
7700,7700,,0,55,55,40
7701,7701,,172,0,172,40
7702,7702,,0,21,21,239
7703,7703,,19,0,19,239
7704,7704,,0,225,225,806
7705,7705,,0,297,297,806
7706,7706,,115,0,115,21
7707,7707,,0,13,13,14
7708,7708,,27,0,27,14
7709,7709,,0,20,20,813
7710,7710,,24,0,24,813
7711,7711,,39,0,39,813
7712,7712,,59,0,59,804
7713,7713,,0,0,0,808
7714,7714,,0,89,89,40
7715,7715,,12,0,12,40
7716,7716,,0,42,42,40
7717,7717,,31,0,31,813
7718,7718,,0,246,246,806
7719,7719,,548,0,548,805
7720,7720,,313,0,313,22
7721,7721,,57,0,57,25
7722,7722,,286,0,286,804
7723,7723,,92,0,92,815
7724,7724,,538,0,538,815
7725,7725,,15,0,15,804
7726,7726,,0,0,0,809
7727,7727,,0,26,26,813
7728,7728,,32,0,32,804
7729,7729,,0,0,0,810
7730,7730,,50,0,50,14
7731,7731,,44,0,44,25
7732,7732,,0,30,30,813
7733,7733,,0,0,0,811
7734,7734,,289,0,289,812
7735,7735,,91,0,91,813
7736,7736,,866,0,866,806
7737,7737,,22,0,22,804
7738,7738,,0,21,21,804
7739,7739,,65,0,65,813
7740,7740,,24,0,24,21
7741,7741,,0,25,25,25
7742,7742,,103,0,103,812
7743,7743,,161,0,161,21
7744,7744,,0,220,220,805
7745,7745,,0,50,50,804
7746,7746,,32,0,32,804
7747,7747,,52,0,52,813
7748,7748,,0,24,24,813
7749,7749,,254,0,254,813
7750,7750,,226,0,226,40
7751,7751,,0,22,22,239
7752,7752,,42,0,42,239
7753,7753,,658,0,658,815
7754,7754,,0,51,51,40
7755,7755,,0,297,297,812
7756,7756,,0,29,29,804
7757,7757,,0,297,297,806
7758,7758,,0,159,159,804
7759,7759,,15,0,15,804
7760,7760,,0,31,31,239
7761,7761,,70,0,70,239
7762,7762,,46,0,46,813
7763,7763,,0,17,17,25
7764,7764,,41,0,41,77
7765,7765,,0,12,12,42
7766,7766,,0,29,29,806
7767,7767,,122,0,122,813
7768,7768,,106,0,106,14
7769,7769,,0,219,219,806
7770,7770,,0,192,192,804
7771,7771,,0,283,283,806
7772,7772,,0,230,230,805
7773,7773,,0,17,17,25
7774,7774,,159,0,159,806
7775,7775,,0,36,36,239
7776,7776,,18,0,18,230
7777,7777,,0,261,261,806
7778,7778,,80,0,80,14
7779,7779,,32,0,32,14
7780,7780,,0,0,0,814
7781,7781,,296,0,296,815
7782,7782,,0,12,12,42
7783,7783,,712,0,712,804
7784,7784,,0,276,276,806
7785,7785,,80,0,80,33
7786,7786,,0,16,16,813
7787,7787,,66,0,66,42
7788,7788,,46,0,46,21
7789,7789,,0,29,29,804
7790,7790,,602,0,602,806
7791,7791,,6,0,6,815
7792,7792,,214,0,214,812
7793,7793,,0,18,18,14
7794,7794,,39,0,39,33
7795,7795,,92,0,92,812
7796,7796,,174,0,174,804
7797,7797,,0,324,324,804
7798,7798,,0,183,183,806
7799,7799,,64,0,64,804
7800,7800,,30,0,30,31
7801,7801,,0,292,292,806
7802,7802,,0,196,196,805
7803,7803,,167,0,167,804
7804,7804,,0,45,45,813
7805,7805,,0,299,299,806
7806,7806,,5,0,5,813
7807,7807,,70,0,70,25
7808,7808,,0,275,275,806
7809,7809,,0,276,276,806
7810,7810,,0,61,61,813
7811,7811,,42,0,42,239
7812,7812,,57,0,57,22
7813,7813,,279,0,279,40
7814,7814,,0,380,380,804
7815,7815,,0,183,183,806
7816,7816,,0,50,50,239
7817,7817,,69,0,69,239
7818,7818,,0,16,16,40
7819,7819,,0,33,33,21
7820,7820,,60,0,60,804
7821,7821,,391,0,391,255
7822,7822,,0,232,232,806
7823,7823,,392,0,392,812
7824,7824,,22,0,22,25
7825,7825,,0,226,226,806
7826,7826,,0,272,272,806
7827,7827,,229,0,229,815
7828,7828,,0,11,11,22
7829,7829,,109,0,109,239
7830,7830,,435,0,435,806
7831,7831,,0,21,21,239
7832,7832,,16,0,16,31
7833,7833,,40,0,40,25
7834,7834,,0,0,0,816
7835,7835,,58,0,58,239
7836,7836,,0,286,286,806
7837,7837,,0,36,36,239
7838,7838,,0,36,36,239
7839,7839,,0,246,246,806
7840,7840,,0,21,21,25
7841,7841,,63,0,63,813
7842,7842,,0,0,0,817
7843,7843,,161,0,161,804
7844,7844,,0,294,294,806
7845,7845,,0,36,36,40
7846,7846,,29,0,29,21
7847,7847,,62,0,62,804
7848,7848,,25,0,25,804
7849,7849,,0,55,55,40
7850,7850,,0,55,55,40
7851,7851,,0,11,11,22
7852,7852,,48,0,48,21
7853,7853,,61,0,61,804
7854,7854,,0,297,297,806
7855,7855,,0,37,37,804
7856,7856,,26,0,26,77
7857,7857,,0,19,19,239
7858,7858,,0,183,183,804
7859,7859,,0,25,25,255
7860,7860,,73,0,73,818
7861,7861,,0,51,51,815
7862,7862,,16,0,16,813
7863,7863,,0,147,147,806
7864,7864,,0,285,285,806
7865,7865,,0,193,193,804
7866,7866,,12,0,12,804
7867,7867,,0,1,1,819
7868,7868,,1,0,1,819
7869,7869,,1,0,1,19
7870,7870,,0,1,1,820
7871,7871,,1,0,1,820
7872,7872,,0,1,1,19
7873,7873,,2,0,2,19
7874,7874,,0,1,1,821
7875,7875,,3,0,3,821
7876,7876,,1,0,1,42
7877,7877,,0,0,0,822
7878,7878,,0,0,0,823
7879,7879,,1,0,1,44
7880,7880,,0,1,1,824
7881,7881,,1,0,1,824
7882,7882,,0,4,4,1652
7883,7883,,1,0,1,1652
7884,7884,,0,1,1,825
7885,7885,,1,0,1,825
7886,7886,,0,1,1,826
7887,7887,,1,0,1,826
7888,7888,,0,0,0,827
7889,7889,,1,0,1,828
7890,7890,,3,0,3,194
7891,7891,,0,3,3,1112
7892,7892,,1,0,1,1112
7893,7893,,0,3,3,829
7894,7894,,1,0,1,829
7895,7895,,0,1,1,830
7896,7896,,1,0,1,830
7897,7897,,0,1,1,831
7898,7898,,1,0,1,831
7899,7899,,1,0,1,44
7900,7900,,1,0,1,67
7901,7901,,0,1,1,832
7902,7902,,1,0,1,832
7903,7903,,1,0,1,19
7904,7904,,0,1,1,43
7905,7905,,2,0,2,43
7906,7906,,0,1,1,833
7907,7907,,3,0,3,833
7908,7908,,0,0,0,834
7909,7909,,0,0,0,835
7910,7910,,0,1,1,836
7911,7911,,1,0,1,836
7912,7912,,0,0,0,837
7913,7913,,0,0,0,838
7914,7914,,1,0,1,1516
7915,7915,,0,6,6,839
7916,7916,,1,0,1,839
7917,7917,,0,0,0,840
7918,7918,,0,7,7,2010
7919,7919,,1,0,1,2010
7920,7920,,0,0,0,841
7921,7921,,2,0,2,1448
7922,7922,,0,4,4,43
7923,7923,,0,0,0,842
7924,7924,,1,0,1,44
7925,7925,,1,0,1,19
7926,7926,,1,0,1,46
7927,7927,,0,1,1,833
7928,7928,,0,3,3,984
7929,7929,,1,0,1,984
7930,7930,,0,0,0,843
7931,7931,,0,0,0,844
7932,7932,,0,0,0,845
7933,7933,,0,0,0,846
7934,7934,,0,0,0,847
7935,7935,,0,0,0,848
7936,7936,,0,4,4,971
7937,7937,,1,0,1,971
7938,7938,,0,1,1,849
7939,7939,,1,0,1,849
7940,7940,,0,0,0,850
7941,7941,,0,0,0,851
7942,7942,,3,0,3,81
7943,7943,,0,1,1,852
7944,7944,,1,0,1,852
7945,7945,,0,2,2,853
7946,7946,,1,0,1,853
7947,7947,,1,0,1,46
7948,7948,,0,0,0,854
7949,7949,,0,0,0,855
7950,7950,,1,0,1,73
7951,7951,,0,1,1,856
7952,7952,,1,0,1,856
7953,7953,,1,0,1,216
7954,7954,,0,1,1,857
7955,7955,,1,0,1,857
7956,7956,,0,0,0,858
7957,7957,,0,1,1,25
7958,7958,,4,0,4,25
7959,7959,,0,1,1,859
7960,7960,,1,0,1,859
7961,7961,,0,1,1,860
7962,7962,,1,0,1,860
7963,7963,,0,0,0,861
7964,7964,,0,0,0,862
7965,7965,,0,3,3,1128
7966,7966,,1,0,1,1128
7967,7967,,0,0,0,863
7968,7968,,0,1,1,864
7969,7969,,1,0,1,864
7970,7970,,0,1,1,865
7971,7971,,1,0,1,865
7972,7972,,1,0,1,280
7973,7973,,1,0,1,46
7974,7974,,1,0,1,280
7975,7975,,1,0,1,1781
7976,7976,,0,1,1,866
7977,7977,,1,0,1,866
7978,7978,,1,0,1,53
7979,7979,,0,2,2,867
7980,7980,,1,0,1,867
7981,7981,,0,1,1,868
7982,7982,,1,0,1,868
7983,7983,,1,0,1,259
7984,7984,,0,2,2,869
7985,7985,,1,0,1,869
7986,7986,,1,0,1,260
7987,7987,,0,1,1,27
7988,7988,,3,0,3,27
7989,7989,,1,0,1,19
7990,7990,,1,0,1,802
7991,7991,,1,0,1,152
7992,7992,,0,1,1,870
7993,7993,,5,0,5,870
7994,7994,,0,1,1,73
7995,7995,,2,0,2,73
7996,7996,,1,0,1,2010
7997,7997,,0,1,1,871
7998,7998,,1,0,1,871
7999,7999,,1,0,1,815
8000,8000,,0,0,0,872
8001,8001,,0,0,0,873
8002,8002,,0,0,0,874
8003,8003,,0,0,0,875
8004,8004,,0,0,0,876
8005,8005,,1,0,1,215
8006,8006,,0,1,1,877
8007,8007,,1,0,1,877
8008,8008,,0,1,1,878
8009,8009,,2,0,2,878
8010,8010,,0,1,1,879
8011,8011,,1,0,1,879
8012,8012,,0,1,1,880
8013,8013,,1,0,1,880
8014,8014,,0,1,1,881
8015,8015,,1,0,1,881
8016,8016,,0,1,1,882
8017,8017,,1,0,1,882
8018,8018,,0,0,0,883
8019,8019,,0,0,0,884
8020,8020,,1,0,1,804
8021,8021,,0,12,12,1975
8022,8022,,1,0,1,1975
8023,8023,,1,0,1,47
8024,8024,,1,0,1,35
8025,8025,,0,1,1,44
8026,8026,,2,0,2,44
8027,8027,,0,1,1,885
8028,8028,,1,0,1,885
8029,8029,,0,1,1,886
8030,8030,,1,0,1,886
8031,8031,,0,2,2,1180
8032,8032,,1,0,1,1180
8033,8033,,0,0,0,887
8034,8034,,2,0,2,1412
8035,8035,,0,1,1,888
8036,8036,,2,0,2,888
8037,8037,,1,0,1,33
8038,8038,,0,4,4,1882
8039,8039,,1,0,1,1882
8040,8040,,0,9,9,1975
8041,8041,,1,0,1,1975
8042,8042,,0,1,1,889
8043,8043,,1,0,1,889
8044,8044,,0,2,2,890
8045,8045,,1,0,1,890
8046,8046,,0,0,0,891
8047,8047,,0,0,0,892
8048,8048,,0,1,1,893
8049,8049,,1,0,1,893
8050,8050,,1,0,1,41
8051,8051,,0,1,1,894
8052,8052,,1,0,1,894
8053,8053,,0,1,1,895
8054,8054,,1,0,1,895
8055,8055,,1,0,1,372
8056,8056,,0,1,1,896
8057,8057,,1,0,1,896
8058,8058,,0,0,0,897
8059,8059,,0,0,0,898
8060,8060,,0,1,1,899
8061,8061,,1,0,1,899
8062,8062,,1,0,1,52
8063,8063,,0,1,1,900
8064,8064,,1,0,1,900
8065,8065,,1,0,1,259
8066,8066,,1,0,1,44
8067,8067,,0,0,0,901
8068,8068,,0,0,0,902
8069,8069,,0,0,0,903
8070,8070,,0,0,0,904
8071,8071,,0,1,1,905
8072,8072,,1,0,1,905
8073,8073,,1,0,1,43
8074,8074,,1,0,1,46
8075,8075,,0,1,1,906
8076,8076,,1,0,1,906
8077,8077,,1,0,1,255
8078,8078,,0,0,0,907
8079,8079,,0,0,0,908
8080,8080,,1,0,1,255
8081,8081,,0,1,1,74
8082,8082,,2,0,2,74
8083,8083,,0,0,0,909
8084,8084,,0,0,0,910
8085,8085,,0,0,0,911
8086,8086,,0,0,0,912
8087,8087,,0,1,1,913
8088,8088,,1,0,1,913
8089,8089,,0,0,0,914
8090,8090,,0,0,0,915
8091,8091,,1,0,1,42
8092,8092,,0,4,4,916
8093,8093,,1,0,1,916
8094,8094,,1,0,1,34
8095,8095,,1,0,1,44
8096,8096,,0,1,1,917
8097,8097,,1,0,1,917
8098,8098,,0,1,1,918
8099,8099,,1,0,1,918
8100,8100,,0,0,0,919
8101,8101,,0,0,0,920
8102,8102,,0,5,5,1630
8103,8103,,2,0,2,1630
8104,8104,,1,0,1,280
8105,8105,,0,0,0,921
8106,8106,,1,0,1,280
8107,8107,,0,1,1,922
8108,8108,,1,0,1,922
8109,8109,,0,1,1,923
8110,8110,,1,0,1,923
8111,8111,,1,0,1,41
8112,8112,,0,2,2,2010
8113,8113,,3,0,3,2010
8114,8114,,1,0,1,44
8115,8115,,1,0,1,301
8116,8116,,0,0,0,924
8117,8117,,1,0,1,1333
8118,8118,,2,0,2,67
8119,8119,,0,3,3,925
8120,8120,,1,0,1,925
8121,8121,,1,0,1,926
8122,8122,,0,1,1,927
8123,8123,,2,0,2,927
8124,8124,,1,0,1,113
8125,8125,,0,1,1,928
8126,8126,,1,0,1,928
8127,8127,,0,2,2,1636
8128,8128,,1,0,1,1636
8129,8129,,1,0,1,1882
8130,8130,,0,1,1,929
8131,8131,,1,0,1,929
8132,8132,,1,0,1,255
8133,8133,,1,0,1,67
8134,8134,,0,1,1,1412
8135,8135,,8,0,8,1412
8136,8136,,0,0,0,930
8137,8137,,2,0,2,1630
8138,8138,,1,0,1,19
8139,8139,,0,1,1,931
8140,8140,,2,0,2,931
8141,8141,,1,0,1,19
8142,8142,,0,1,1,932
8143,8143,,2,0,2,932
8144,8144,,1,0,1,41
8145,8145,,0,1,1,933
8146,8146,,1,0,1,933
8147,8147,,0,0,0,934
8148,8148,,0,0,0,935
8149,8149,,0,1,1,936
8150,8150,,1,0,1,936
8151,8151,,0,6,6,1896
8152,8152,,1,0,1,1896
8153,8153,,0,0,0,937
8154,8154,,0,4,4,1597
8155,8155,,1,0,1,1597
8156,8156,,0,1,1,938
8157,8157,,2,0,2,938
8158,8158,,0,1,1,1606
8159,8159,,0,0,0,939
8160,8160,,1,0,1,216
8161,8161,,1,0,1,27
8162,8162,,0,1,1,940
8163,8163,,1,0,1,940
8164,8164,,3,0,3,754
8165,8165,,0,1,1,941
8166,8166,,1,0,1,941
8167,8167,,1,0,1,215
8168,8168,,0,1,1,942
8169,8169,,1,0,1,942
8170,8170,,0,1,1,943
8171,8171,,1,0,1,943
8172,8172,,0,0,0,944
8173,8173,,0,0,0,945
8174,8174,,0,0,0,946
8175,8175,,1,0,1,43
8176,8176,,1,0,1,829
8177,8177,,1,0,1,260
8178,8178,,0,1,1,947
8179,8179,,2,0,2,947
8180,8180,,0,1,1,948
8181,8181,,1,0,1,948
8182,8182,,0,0,0,949
8183,8183,,0,0,0,950
8184,8184,,1,0,1,42
8185,8185,,0,0,0,951
8186,8186,,0,1,1,952
8187,8187,,1,0,1,952
8188,8188,,1,0,1,215
8189,8189,,1,0,1,1975
8190,8190,,1,0,1,41
8191,8191,,1,0,1,44
8192,8192,,1,0,1,55
8193,8193,,0,1,1,953
8194,8194,,1,0,1,953
8195,8195,,1,0,1,280
8196,8196,,1,0,1,171
8197,8197,,0,1,1,954
8198,8198,,2,0,2,954
8199,8199,,0,0,0,955
8200,8200,,0,0,0,956
8201,8201,,0,3,3,67
8202,8202,,0,0,0,957
8203,8203,,1,0,1,57
8204,8204,,0,1,1,958
8205,8205,,1,0,1,958
8206,8206,,0,2,2,959
8207,8207,,1,0,1,959
8208,8208,,0,0,0,960
8209,8209,,0,0,0,961
8210,8210,,0,1,1,962
8211,8211,,1,0,1,962
8212,8212,,1,0,1,187
8213,8213,,0,1,1,963
8214,8214,,1,0,1,963
8215,8215,,0,1,1,964
8216,8216,,1,0,1,964
8217,8217,,1,0,1,73
8218,8218,,0,1,1,965
8219,8219,,1,0,1,965
8220,8220,,0,0,0,966
8221,8221,,0,1,1,967
8222,8222,,1,0,1,967
8223,8223,,0,0,0,968
8224,8224,,0,1,1,969
8225,8225,,2,0,2,969
8226,8226,,0,1,1,970
8227,8227,,1,0,1,970
8228,8228,,1,0,1,971
8229,8229,,0,0,0,972
8230,8230,,0,0,0,973
8231,8231,,0,1,1,974
8232,8232,,1,0,1,974
8233,8233,,1,0,1,42
8234,8234,,1,0,1,46
8235,8235,,0,1,1,975
8236,8236,,1,0,1,975
8237,8237,,1,0,1,301
8238,8238,,0,0,0,976
8239,8239,,0,0,0,977
8240,8240,,0,1,1,978
8241,8241,,1,0,1,978
8242,8242,,0,1,1,979
8243,8243,,1,0,1,979
8244,8244,,1,0,1,43
8245,8245,,1,0,1,215
8246,8246,,0,1,1,980
8247,8247,,1,0,1,980
8248,8248,,0,1,1,981
8249,8249,,1,0,1,981
8250,8250,,0,1,1,870
8251,8251,,0,1,1,982
8252,8252,,1,0,1,982
8253,8253,,0,1,1,983
8254,8254,,1,0,1,983
8255,8255,,0,1,1,81
8256,8256,,5,0,5,81
8257,8257,,0,1,1,260
8258,8258,,2,0,2,260
8259,8259,,1,0,1,984
8260,8260,,0,0,0,985
8261,8261,,0,0,0,986
8262,8262,,0,0,0,987
8263,8263,,0,0,0,988
8264,8264,,0,1,1,989
8265,8265,,1,0,1,989
8266,8266,,0,0,0,990
8267,8267,,0,0,0,991
8268,8268,,0,1,1,992
8269,8269,,1,0,1,992
8270,8270,,0,0,0,993
8271,8271,,0,0,0,994
8272,8272,,1,0,1,260
8273,8273,,1,0,1,46
8274,8274,,0,1,1,995
8275,8275,,2,0,2,995
8276,8276,,0,6,6,1221
8277,8277,,1,0,1,1221
8278,8278,,1,0,1,42
8279,8279,,0,0,0,996
8280,8280,,0,0,0,997
8281,8281,,0,1,1,998
8282,8282,,1,0,1,998
8283,8283,,1,0,1,1781
8284,8284,,0,1,1,999
8285,8285,,1,0,1,999
8286,8286,,0,0,0,1000
8287,8287,,0,0,0,1001
8288,8288,,0,2,2,1002
8289,8289,,1,0,1,1002
8290,8290,,0,0,0,1003
8291,8291,,1,0,1,255
8292,8292,,0,0,0,1004
8293,8293,,0,0,0,1005
8294,8294,,1,0,1,1128
8295,8295,,1,0,1,829
8296,8296,,1,0,1,25
8297,8297,,0,0,0,1006
8298,8298,,0,0,0,1007
8299,8299,,1,0,1,255
8300,8300,,0,1,1,1008
8301,8301,,2,0,2,1008
8302,8302,,0,1,1,1009
8303,8303,,1,0,1,1009
8304,8304,,0,0,0,1010
8305,8305,,0,0,0,1011
8306,8306,,1,0,1,239
8307,8307,,1,0,1,144
8308,8308,,1,0,1,280
8309,8309,,0,0,0,1012
8310,8310,,0,0,0,1013
8311,8311,,0,1,1,1014
8312,8312,,1,0,1,1014
8313,8313,,0,1,1,1015
8314,8314,,1,0,1,1015
8315,8315,,0,1,1,1016
8316,8316,,1,0,1,1016
8317,8317,,1,0,1,42
8318,8318,,1,0,1,260
8319,8319,,1,0,1,255
8320,8320,,0,2,2,1412
8321,8321,,0,0,0,1017
8322,8322,,0,0,0,1018
8323,8323,,1,0,1,1975
8324,8324,,1,0,1,813
8325,8325,,1,0,1,96
8326,8326,,0,0,0,1019
8327,8327,,1,0,1,280
8328,8328,,0,1,1,1020
8329,8329,,1,0,1,1020
8330,8330,,0,0,0,1021
8331,8331,,0,0,0,1022
8332,8332,,0,1,1,888
8333,8333,,1,0,1,38
8334,8334,,0,1,1,1023
8335,8335,,1,0,1,1023
8336,8336,,1,0,1,46
8337,8337,,0,2,2,1903
8338,8338,,1,0,1,1903
8339,8339,,1,0,1,215
8340,8340,,1,0,1,260
8341,8341,,0,1,1,1024
8342,8342,,1,0,1,1024
8343,8343,,0,1,1,1025
8344,8344,,1,0,1,1025
8345,8345,,1,0,1,280
8346,8346,,3,0,3,27
8347,8347,,0,4,4,73
8348,8348,,4,0,4,73
8349,8349,,0,1,1,1026
8350,8350,,1,0,1,1026
8351,8351,,0,1,1,1027
8352,8352,,1,0,1,1027
8353,8353,,0,2,2,1638
8354,8354,,2,0,2,1638
8355,8355,,0,4,4,1520
8356,8356,,1,0,1,1520
8357,8357,,0,1,1,1028
8358,8358,,1,0,1,1028
8359,8359,,0,1,1,1029
8360,8360,,1,0,1,1029
8361,8361,,0,1,1,1030
8362,8362,,1,0,1,1030
8363,8363,,0,4,4,1714
8364,8364,,1,0,1,1714
8365,8365,,1,0,1,27
8366,8366,,0,1,1,1031
8367,8367,,1,0,1,1031
8368,8368,,0,1,1,1765
8369,8369,,0,0,0,1032
8370,8370,,0,0,0,1033
8371,8371,,0,0,0,1034
8372,8372,,0,1,1,1035
8373,8373,,1,0,1,1035
8374,8374,,0,4,4,1090
8375,8375,,0,0,0,1036
8376,8376,,0,0,0,1037
8377,8377,,0,0,0,1038
8378,8378,,0,0,0,1039
8379,8379,,0,0,0,1040
8380,8380,,1,0,1,260
8381,8381,,0,1,1,1041
8382,8382,,1,0,1,1041
8383,8383,,0,1,1,1042
8384,8384,,1,0,1,1042
8385,8385,,1,0,1,44
8386,8386,,0,2,2,1740
8387,8387,,1,0,1,1740
8388,8388,,0,0,0,1043
8389,8389,,0,0,0,1044
8390,8390,,0,0,0,1045
8391,8391,,0,1,1,1046
8392,8392,,1,0,1,1046
8393,8393,,0,1,1,1091
8394,8394,,2,0,2,1091
8395,8395,,1,0,1,280
8396,8396,,0,2,2,1047
8397,8397,,1,0,1,1047
8398,8398,,0,0,0,1048
8399,8399,,0,1,1,1049
8400,8400,,1,0,1,1049
8401,8401,,1,0,1,19
8402,8402,,0,0,0,1050
8403,8403,,0,0,0,1051
8404,8404,,0,0,0,1052
8405,8405,,1,0,1,1830
8406,8406,,0,1,1,1053
8407,8407,,1,0,1,1053
8408,8408,,0,1,1,1054
8409,8409,,1,0,1,1054
8410,8410,,0,0,0,1055
8411,8411,,1,0,1,1250
8412,8412,,0,0,0,1056
8413,8413,,0,0,0,1057
8414,8414,,0,1,1,1058
8415,8415,,1,0,1,1058
8416,8416,,0,1,1,1059
8417,8417,,2,0,2,1059
8418,8418,,1,0,1,440
8419,8419,,0,0,0,1060
8420,8420,,0,0,0,1061
8421,8421,,0,2,2,1062
8422,8422,,1,0,1,1062
8423,8423,,0,1,1,1748
8424,8424,,0,0,0,1063
8425,8425,,0,0,0,1064
8426,8426,,0,0,0,1065
8427,8427,,0,1,1,1066
8428,8428,,1,0,1,1066
8429,8429,,0,7,7,1067
8430,8430,,1,0,1,1067
8431,8431,,0,0,0,1068
8432,8432,,0,0,0,1069
8433,8433,,0,1,1,1070
8434,8434,,1,0,1,1070
8435,8435,,0,1,1,1071
8436,8436,,1,0,1,1071
8437,8437,,0,3,3,1072
8438,8438,,1,0,1,1072
8439,8439,,1,0,1,1630
8440,8440,,0,1,1,1073
8441,8441,,2,0,2,1073
8442,8442,,0,1,1,1074
8443,8443,,1,0,1,1074
8444,8444,,1,0,1,1090
8445,8445,,0,0,0,1075
8446,8446,,0,0,0,1076
8447,8447,,0,1,1,1077
8448,8448,,1,0,1,1077
8449,8449,,0,1,1,1078
8450,8450,,1,0,1,1078
8451,8451,,1,0,1,280
8452,8452,,1,0,1,216
8453,8453,,1,0,1,171
8454,8454,,0,1,1,1079
8455,8455,,1,0,1,1079
8456,8456,,0,0,0,1080
8457,8457,,0,0,0,1081
8458,8458,,0,0,0,1082
8459,8459,,0,3,3,1747
8460,8460,,0,0,0,1083
8461,8461,,1,0,1,18
8462,8462,,0,0,0,1084
8463,8463,,0,0,0,1085
8464,8464,,0,1,1,1086
8465,8465,,1,0,1,1086
8466,8466,,0,0,0,1087
8467,8467,,1,0,1,44
8468,8468,,1,0,1,1067
8469,8469,,0,1,1,1088
8470,8470,,1,0,1,1088
8471,8471,,0,1,1,1089
8472,8472,,3,0,3,1089
8473,8473,,0,5,5,1448
8474,8474,,3,0,3,1448
8475,8475,,0,1,1,1638
8476,8476,,1,0,1,1090
8477,8477,,0,2,2,1091
8478,8478,,1,0,1,1091
8479,8479,,0,1,1,1092
8480,8480,,1,0,1,1092
8481,8481,,1,0,1,260
8482,8482,,0,1,1,1093
8483,8483,,1,0,1,1093
8484,8484,,2,0,2,73
8485,8485,,1,0,1,216
8486,8486,,0,1,1,1094
8487,8487,,1,0,1,1094
8488,8488,,0,1,1,1095
8489,8489,,1,0,1,1095
8490,8490,,0,1,1,1096
8491,8491,,1,0,1,1096
8492,8492,,0,1,1,1097
8493,8493,,2,0,2,1097
8494,8494,,0,0,0,1098
8495,8495,,0,0,0,1099
8496,8496,,0,1,1,1100
8497,8497,,1,0,1,1100
8498,8498,,0,1,1,1412
8499,8499,,0,2,2,1101
8500,8500,,1,0,1,1101
8501,8501,,1,0,1,39
8502,8502,,0,0,0,1102
8503,8503,,1,0,1,73
8504,8504,,1,0,1,19
8505,8505,,0,1,1,1103
8506,8506,,1,0,1,1103
8507,8507,,0,1,1,1104
8508,8508,,1,0,1,1104
8509,8509,,0,0,0,1105
8510,8510,,0,1,1,1106
8511,8511,,2,0,2,1106
8512,8512,,0,0,0,1107
8513,8513,,0,0,0,1108
8514,8514,,1,0,1,55
8515,8515,,0,0,0,1109
8516,8516,,1,0,1,44
8517,8517,,0,1,1,1089
8518,8518,,0,0,0,1110
8519,8519,,0,0,0,1111
8520,8520,,1,0,1,1112
8521,8521,,0,1,1,1113
8522,8522,,1,0,1,1113
8523,8523,,0,1,1,44
8524,8524,,2,0,2,44
8525,8525,,0,2,2,1697
8526,8526,,1,0,1,1697
8527,8527,,0,1,1,1114
8528,8528,,1,0,1,1114
8529,8529,,0,1,1,1115
8530,8530,,1,0,1,1115
8531,8531,,0,1,1,1116
8532,8532,,1,0,1,1116
8533,8533,,0,1,1,260
8534,8534,,0,1,1,1117
8535,8535,,1,0,1,1117
8536,8536,,0,3,3,1143
8537,8537,,1,0,1,1143
8538,8538,,0,1,1,1118
8539,8539,,1,0,1,1118
8540,8540,,1,0,1,255
8541,8541,,1,0,1,67
8542,8542,,1,0,1,171
8543,8543,,1,0,1,260
8544,8544,,1,0,1,73
8545,8545,,0,1,1,1119
8546,8546,,1,0,1,1119
8547,8547,,1,0,1,260
8548,8548,,0,1,1,1120
8549,8549,,1,0,1,1120
8550,8550,,1,0,1,77
8551,8551,,4,0,4,25
8552,8552,,0,1,1,1121
8553,8553,,3,0,3,1121
8554,8554,,1,0,1,1412
8555,8555,,0,1,1,25
8556,8556,,0,1,1,1122
8557,8557,,1,0,1,1122
8558,8558,,1,0,1,19
8559,8559,,1,0,1,46
8560,8560,,0,1,1,73
8561,8561,,2,0,2,73
8562,8562,,1,0,1,1975
8563,8563,,0,1,1,1123
8564,8564,,1,0,1,1123
8565,8565,,1,0,1,272
8566,8566,,1,0,1,2010
8567,8567,,1,0,1,42
8568,8568,,0,1,1,1124
8569,8569,,1,0,1,1124
8570,8570,,0,0,0,1125
8571,8571,,0,0,0,1126
8572,8572,,0,0,0,1127
8573,8573,,1,0,1,1128
8574,8574,,1,0,1,1090
8575,8575,,0,1,1,1129
8576,8576,,1,0,1,1129
8577,8577,,1,0,1,27
8578,8578,,0,1,1,1130
8579,8579,,1,0,1,1130
8580,8580,,1,0,1,46
8581,8581,,0,1,1,1131
8582,8582,,1,0,1,1131
8583,8583,,0,1,1,1262
8584,8584,,2,0,2,1262
8585,8585,,0,0,0,1132
8586,8586,,0,1,1,1133
8587,8587,,1,0,1,1133
8588,8588,,1,0,1,272
8589,8589,,0,1,1,1173
8590,8590,,0,0,0,1134
8591,8591,,1,0,1,77
8592,8592,,2,0,2,26
8593,8593,,0,1,1,1135
8594,8594,,1,0,1,1135
8595,8595,,0,0,0,1136
8596,8596,,0,0,0,1137
8597,8597,,0,0,0,1138
8598,8598,,1,0,1,1448
8599,8599,,1,0,1,815
8600,8600,,0,0,0,1139
8601,8601,,0,1,1,1140
8602,8602,,1,0,1,1140
8603,8603,,0,1,1,1141
8604,8604,,2,0,2,1141
8605,8605,,0,1,1,1142
8606,8606,,1,0,1,1142
8607,8607,,1,0,1,925
8608,8608,,1,0,1,1143
8609,8609,,1,0,1,1072
8610,8610,,0,1,1,1144
8611,8611,,2,0,2,1144
8612,8612,,0,0,0,1145
8613,8613,,0,0,0,1146
8614,8614,,0,0,0,1147
8615,8615,,0,0,0,1148
8616,8616,,0,1,1,1448
8617,8617,,2,0,2,1448
8618,8618,,0,0,0,1149
8619,8619,,1,0,1,26
8620,8620,,1,0,1,56
8621,8621,,0,1,1,1150
8622,8622,,1,0,1,1150
8623,8623,,0,1,1,1151
8624,8624,,1,0,1,1151
8625,8625,,1,0,1,215
8626,8626,,1,0,1,41
8627,8627,,0,0,0,1152
8628,8628,,0,1,1,1153
8629,8629,,2,0,2,1153
8630,8630,,0,0,0,1154
8631,8631,,0,1,1,1155
8632,8632,,1,0,1,1155
8633,8633,,1,0,1,260
8634,8634,,0,2,2,1996
8635,8635,,1,0,1,1996
8636,8636,,2,0,2,73
8637,8637,,0,1,1,1156
8638,8638,,1,0,1,1156
8639,8639,,0,1,1,1157
8640,8640,,1,0,1,1157
8641,8641,,0,0,0,1158
8642,8642,,0,0,0,1159
8643,8643,,1,0,1,19
8644,8644,,0,1,1,1160
8645,8645,,1,0,1,1160
8646,8646,,0,0,0,1161
8647,8647,,0,1,1,1162
8648,8648,,1,0,1,1162
8649,8649,,1,0,1,46
8650,8650,,0,1,1,1163
8651,8651,,1,0,1,1163
8652,8652,,0,1,1,90
8653,8653,,2,0,2,90
8654,8654,,0,1,1,1164
8655,8655,,1,0,1,1164
8656,8656,,1,0,1,144
8657,8657,,1,0,1,41
8658,8658,,0,1,1,1165
8659,8659,,1,0,1,1165
8660,8660,,0,0,0,1166
8661,8661,,0,1,1,46
8662,8662,,1,0,1,67
8663,8663,,0,1,1,870
8664,8664,,0,0,0,1167
8665,8665,,0,1,1,1168
8666,8666,,1,0,1,1168
8667,8667,,1,0,1,260
8668,8668,,1,0,1,1169
8669,8669,,0,1,1,1170
8670,8670,,1,0,1,1170
8671,8671,,1,0,1,33
8672,8672,,0,1,1,1171
8673,8673,,1,0,1,1171
8674,8674,,1,0,1,46
8675,8675,,1,0,1,1112
8676,8676,,0,1,1,1172
8677,8677,,1,0,1,1172
8678,8678,,1,0,1,42
8679,8679,,1,0,1,43
8680,8680,,1,0,1,1173
8681,8681,,0,1,1,1174
8682,8682,,1,0,1,1174
8683,8683,,0,1,1,1106
8684,8684,,0,0,0,1175
8685,8685,,1,0,1,1975
8686,8686,,2,0,2,77
8687,8687,,0,1,1,1176
8688,8688,,1,0,1,1176
8689,8689,,1,0,1,46
8690,8690,,0,0,0,1177
8691,8691,,1,0,1,260
8692,8692,,0,1,1,1178
8693,8693,,1,0,1,1178
8694,8694,,0,1,1,1179
8695,8695,,1,0,1,1179
8696,8696,,1,0,1,1180
8697,8697,,1,0,1,46
8698,8698,,0,1,1,1181
8699,8699,,1,0,1,1181
8700,8700,,1,0,1,19
8701,8701,,1,0,1,55
8702,8702,,1,0,1,1896
8703,8703,,0,1,1,1182
8704,8704,,1,0,1,1182
8705,8705,,0,1,1,1141
8706,8706,,1,0,1,152
8707,8707,,0,2,2,1877
8708,8708,,1,0,1,1877
8709,8709,,1,0,1,49
8710,8710,,0,0,0,1183
8711,8711,,0,0,0,1184
8712,8712,,1,0,1,1185
8713,8713,,0,0,0,1186
8714,8714,,0,0,0,1187
8715,8715,,0,1,1,26
8716,8716,,3,0,3,26
8717,8717,,0,1,1,1188
8718,8718,,1,0,1,1188
8719,8719,,0,0,0,1189
8720,8720,,0,2,2,73
8721,8721,,0,4,4,1233
8722,8722,,1,0,1,1233
8723,8723,,0,1,1,1190
8724,8724,,1,0,1,1190
8725,8725,,0,2,2,1191
8726,8726,,1,0,1,1191
8727,8727,,1,0,1,916
8728,8728,,0,1,1,1192
8729,8729,,1,0,1,1192
8730,8730,,0,1,1,1193
8731,8731,,1,0,1,1193
8732,8732,,0,1,1,1194
8733,8733,,1,0,1,1194
8734,8734,,0,1,1,927
8735,8735,,0,1,1,1195
8736,8736,,2,0,2,1195
8737,8737,,0,0,0,1196
8738,8738,,0,1,1,1197
8739,8739,,1,0,1,1197
8740,8740,,0,3,3,1253
8741,8741,,0,0,0,1198
8742,8742,,0,1,1,1199
8743,8743,,1,0,1,1199
8744,8744,,0,1,1,1200
8745,8745,,1,0,1,1200
8746,8746,,0,1,1,260
8747,8747,,2,0,2,260
8748,8748,,0,1,1,931
8749,8749,,1,0,1,57
8750,8750,,1,0,1,42
8751,8751,,0,1,1,1201
8752,8752,,1,0,1,1201
8753,8753,,0,0,0,1202
8754,8754,,0,0,0,1203
8755,8755,,0,1,1,46
8756,8756,,2,0,2,46
8757,8757,,0,2,2,1662
8758,8758,,1,0,1,1662
8759,8759,,1,0,1,280
8760,8760,,1,0,1,19
8761,8761,,2,0,2,1975
8762,8762,,1,0,1,73
8763,8763,,0,1,1,1204
8764,8764,,1,0,1,1204
8765,8765,,0,1,1,1205
8766,8766,,1,0,1,1205
8767,8767,,1,0,1,272
8768,8768,,0,0,0,1206
8769,8769,,0,0,0,1207
8770,8770,,0,1,1,1208
8771,8771,,1,0,1,1208
8772,8772,,0,0,0,1209
8773,8773,,0,0,0,1210
8774,8774,,0,1,1,1211
8775,8775,,1,0,1,1211
8776,8776,,0,0,0,1212
8777,8777,,0,0,0,1213
8778,8778,,0,1,1,1218
8779,8779,,2,0,2,1218
8780,8780,,0,1,1,1214
8781,8781,,1,0,1,1214
8782,8782,,0,1,1,1215
8783,8783,,1,0,1,1215
8784,8784,,1,0,1,77
8785,8785,,0,0,0,1216
8786,8786,,0,0,0,1217
8787,8787,,1,0,1,1494
8788,8788,,1,0,1,19
8789,8789,,0,2,2,1218
8790,8790,,2,0,2,1218
8791,8791,,1,0,1,42
8792,8792,,0,1,1,1219
8793,8793,,1,0,1,1219
8794,8794,,0,1,1,1220
8795,8795,,1,0,1,1220
8796,8796,,1,0,1,27
8797,8797,,0,1,1,25
8798,8798,,0,1,1,1195
8799,8799,,1,0,1,46
8800,8800,,1,0,1,1221
8801,8801,,0,1,1,1222
8802,8802,,1,0,1,1222
8803,8803,,0,1,1,1223
8804,8804,,1,0,1,1223
8805,8805,,0,1,1,1224
8806,8806,,1,0,1,1224
8807,8807,,0,1,1,1225
8808,8808,,2,0,2,1225
8809,8809,,0,1,1,1218
8810,8810,,0,2,2,1226
8811,8811,,1,0,1,1226
8812,8812,,1,0,1,839
8813,8813,,0,0,0,1227
8814,8814,,1,0,1,259
8815,8815,,1,0,1,1520
8816,8816,,0,1,1,1228
8817,8817,,1,0,1,1228
8818,8818,,0,0,0,1229
8819,8819,,0,0,0,1230
8820,8820,,0,1,1,1231
8821,8821,,1,0,1,1231
8822,8822,,0,1,1,1232
8823,8823,,1,0,1,1232
8824,8824,,1,0,1,1233
8825,8825,,1,0,1,19
8826,8826,,0,1,1,1412
8827,8827,,0,1,1,1234
8828,8828,,1,0,1,1234
8829,8829,,1,0,1,46
8830,8830,,0,1,1,1235
8831,8831,,1,0,1,1235
8832,8832,,0,1,1,1236
8833,8833,,1,0,1,1236
8834,8834,,0,0,0,1237
8835,8835,,5,0,5,1830
8836,8836,,0,0,0,1238
8837,8837,,1,0,1,1444
8838,8838,,1,0,1,43
8839,8839,,0,0,0,1239
8840,8840,,0,1,1,1240
8841,8841,,1,0,1,1240
8842,8842,,0,0,0,1241
8843,8843,,0,0,0,1242
8844,8844,,0,1,1,1243
8845,8845,,1,0,1,1243
8846,8846,,0,0,0,1244
8847,8847,,0,0,0,1245
8848,8848,,0,1,1,1246
8849,8849,,1,0,1,1246
8850,8850,,0,0,0,1247
8851,8851,,1,0,1,42
8852,8852,,0,1,1,1248
8853,8853,,1,0,1,1248
8854,8854,,0,0,0,1249
8855,8855,,0,1,1,1250
8856,8856,,0,0,0,1251
8857,8857,,0,0,0,1252
8858,8858,,1,0,1,1253
8859,8859,,1,0,1,280
8860,8860,,1,0,1,14
8861,8861,,0,1,1,1254
8862,8862,,1,0,1,1254
8863,8863,,0,0,0,1255
8864,8864,,0,0,0,1256
8865,8865,,0,2,2,1956
8866,8866,,1,0,1,1956
8867,8867,,0,1,1,1257
8868,8868,,1,0,1,1257
8869,8869,,0,1,1,1121
8870,8870,,0,0,0,1258
8871,8871,,0,0,0,1259
8872,8872,,0,0,0,1260
8873,8873,,0,0,0,1261
8874,8874,,1,0,1,77
8875,8875,,0,2,2,1262
8876,8876,,1,0,1,1262
8877,8877,,0,0,0,1263
8878,8878,,0,0,0,1264
8879,8879,,0,3,3,1265
8880,8880,,1,0,1,1265
8881,8881,,4,0,4,35
8882,8882,,1,0,1,1191
8883,8883,,0,1,1,1266
8884,8884,,1,0,1,1266
8885,8885,,0,1,1,1267
8886,8886,,2,0,2,1267
8887,8887,,0,1,1,1268
8888,8888,,1,0,1,1268
8889,8889,,1,0,1,259
8890,8890,,0,0,0,1269
8891,8891,,1,0,1,1412
8892,8892,,0,0,0,1270
8893,8893,,1,0,1,215
8894,8894,,1,0,1,19
8895,8895,,1,0,1,38
8896,8896,,0,1,1,1271
8897,8897,,1,0,1,1271
8898,8898,,1,0,1,215
8899,8899,,1,0,1,1002
8900,8900,,0,1,1,1272
8901,8901,,1,0,1,1272
8902,8902,,0,1,1,1273
8903,8903,,1,0,1,1273
8904,8904,,1,0,1,1274
8905,8905,,0,0,0,1275
8906,8906,,2,0,2,1806
8907,8907,,0,0,0,1276
8908,8908,,0,1,1,1277
8909,8909,,1,0,1,1277
8910,8910,,0,3,3,1278
8911,8911,,1,0,1,1278
8912,8912,,1,0,1,1226
8913,8913,,1,0,1,215
8914,8914,,1,0,1,27
8915,8915,,0,1,1,1279
8916,8916,,1,0,1,1279
8917,8917,,1,0,1,41
8918,8918,,0,0,0,1280
8919,8919,,1,0,1,34
8920,8920,,2,0,2,1638
8921,8921,,1,0,1,804
8922,8922,,0,1,1,1281
8923,8923,,1,0,1,1281
8924,8924,,0,0,0,1282
8925,8925,,0,1,1,1283
8926,8926,,1,0,1,1283
8927,8927,,0,1,1,1284
8928,8928,,1,0,1,1284
8929,8929,,0,1,1,1285
8930,8930,,1,0,1,1285
8931,8931,,0,1,1,1286
8932,8932,,1,0,1,1286
8933,8933,,1,0,1,133
8934,8934,,2,0,2,43
8935,8935,,0,1,1,1287
8936,8936,,1,0,1,1287
8937,8937,,0,1,1,1288
8938,8938,,1,0,1,1288
8939,8939,,0,1,1,77
8940,8940,,0,0,0,1289
8941,8941,,0,1,1,1290
8942,8942,,1,0,1,1290
8943,8943,,1,0,1,216
8944,8944,,0,0,0,1291
8945,8945,,0,0,0,1292
8946,8946,,0,1,1,1293
8947,8947,,1,0,1,1293
8948,8948,,0,1,1,1294
8949,8949,,1,0,1,1294
8950,8950,,1,0,1,27
8951,8951,,0,3,3,15
8952,8952,,0,0,0,1295
8953,8953,,0,0,0,1296
8954,8954,,1,0,1,1067
8955,8955,,0,0,0,1297
8956,8956,,0,1,1,1298
8957,8957,,1,0,1,1298
8958,8958,,1,0,1,77
8959,8959,,0,0,0,1299
8960,8960,,1,0,1,1300
8961,8961,,0,1,1,1301
8962,8962,,1,0,1,1301
8963,8963,,0,1,1,1302
8964,8964,,1,0,1,1302
8965,8965,,2,0,2,19
8966,8966,,1,0,1,926
8967,8967,,0,1,1,1303
8968,8968,,1,0,1,1303
8969,8969,,0,0,0,1304
8970,8970,,0,0,0,1305
8971,8971,,0,0,0,1306
8972,8972,,0,0,0,1307
8973,8973,,0,1,1,1308
8974,8974,,1,0,1,1308
8975,8975,,0,1,1,1309
8976,8976,,1,0,1,1309
8977,8977,,0,0,0,1310
8978,8978,,0,1,1,1311
8979,8979,,1,0,1,1311
8980,8980,,1,0,1,171
8981,8981,,0,1,1,1312
8982,8982,,1,0,1,1312
8983,8983,,1,0,1,42
8984,8984,,0,0,0,1313
8985,8985,,0,0,0,1314
8986,8986,,0,1,1,394
8987,8987,,1,0,1,113
8988,8988,,0,0,0,1315
8989,8989,,0,0,0,1316
8990,8990,,0,1,1,1317
8991,8991,,1,0,1,1317
8992,8992,,0,1,1,1318
8993,8993,,1,0,1,1318
8994,8994,,0,3,3,1553
8995,8995,,1,0,1,1553
8996,8996,,0,1,1,1319
8997,8997,,1,0,1,1319
8998,8998,,0,1,1,1320
8999,8999,,1,0,1,1320
9000,9000,,0,0,0,1321
9001,9001,,1,0,1,1597
9002,9002,,0,1,1,1322
9003,9003,,1,0,1,1322
9004,9004,,2,0,2,67
9005,9005,,0,0,0,1323
9006,9006,,0,0,0,1324
9007,9007,,0,1,1,1325
9008,9008,,1,0,1,1325
9009,9009,,2,0,2,73
9010,9010,,1,0,1,67
9011,9011,,0,0,0,1326
9012,9012,,0,0,0,1327
9013,9013,,0,1,1,1328
9014,9014,,1,0,1,1328
9015,9015,,0,1,1,1329
9016,9016,,1,0,1,1329
9017,9017,,0,1,1,1330
9018,9018,,1,0,1,1330
9019,9019,,0,0,0,1331
9020,9020,,0,1,1,1332
9021,9021,,1,0,1,1332
9022,9022,,0,1,1,1333
9023,9023,,1,0,1,46
9024,9024,,0,0,0,1334
9025,9025,,1,0,1,46
9026,9026,,0,1,1,1335
9027,9027,,1,0,1,1335
9028,9028,,0,1,1,1336
9029,9029,,1,0,1,1336
9030,9030,,0,1,1,1337
9031,9031,,1,0,1,1337
9032,9032,,0,1,1,1338
9033,9033,,1,0,1,1338
9034,9034,,0,1,1,73
9035,9035,,2,0,2,73
9036,9036,,0,0,0,1339
9037,9037,,0,0,0,1340
9038,9038,,0,1,1,1341
9039,9039,,1,0,1,1341
9040,9040,,0,0,0,1342
9041,9041,,1,0,1,215
9042,9042,,0,4,4,1448
9043,9043,,0,1,1,1343
9044,9044,,1,0,1,1343
9045,9045,,1,0,1,46
9046,9046,,0,2,2,1344
9047,9047,,1,0,1,1344
9048,9048,,0,2,2,1501
9049,9049,,1,0,1,1501
9050,9050,,0,0,0,1345
9051,9051,,0,0,0,1346
9052,9052,,0,1,1,1347
9053,9053,,1,0,1,1347
9054,9054,,0,1,1,1348
9055,9055,,1,0,1,1348
9056,9056,,0,0,0,1349
9057,9057,,0,0,0,1350
9058,9058,,1,0,1,1448
9059,9059,,0,1,1,1351
9060,9060,,2,0,2,1351
9061,9061,,0,1,1,1352
9062,9062,,1,0,1,1352
9063,9063,,1,0,1,67
9064,9064,,0,1,1,1353
9065,9065,,1,0,1,1353
9066,9066,,0,1,1,1354
9067,9067,,1,0,1,1354
9068,9068,,1,0,1,43
9069,9069,,0,0,0,1355
9070,9070,,0,0,0,1356
9071,9071,,0,1,1,1357
9072,9072,,1,0,1,1357
9073,9073,,1,0,1,187
9074,9074,,1,0,1,1047
9075,9075,,1,0,1,46
9076,9076,,1,0,1,215
9077,9077,,1,0,1,19
9078,9078,,1,0,1,46
9079,9079,,1,0,1,41
9080,9080,,1,0,1,46
9081,9081,,0,1,1,1358
9082,9082,,1,0,1,1358
9083,9083,,0,1,1,1359
9084,9084,,1,0,1,1359
9085,9085,,0,1,1,1360
9086,9086,,1,0,1,1360
9087,9087,,0,1,1,1361
9088,9088,,1,0,1,1361
9089,9089,,1,0,1,152
9090,9090,,0,0,0,1362
9091,9091,,0,0,0,1363
9092,9092,,1,0,1,1233
9093,9093,,0,1,1,1364
9094,9094,,1,0,1,1364
9095,9095,,0,1,1,1365
9096,9096,,1,0,1,1365
9097,9097,,0,1,1,1366
9098,9098,,1,0,1,1366
9099,9099,,0,1,1,1367
9100,9100,,1,0,1,1367
9101,9101,,1,0,1,1896
9102,9102,,0,1,1,1368
9103,9103,,1,0,1,1368
9104,9104,,0,3,3,1529
9105,9105,,1,0,1,1529
9106,9106,,1,0,1,46
9107,9107,,0,1,1,1369
9108,9108,,1,0,1,1369
9109,9109,,0,1,1,1370
9110,9110,,1,0,1,1370
9111,9111,,0,1,1,1371
9112,9112,,1,0,1,1371
9113,9113,,0,2,2,1372
9114,9114,,1,0,1,1372
9115,9115,,0,1,1,1373
9116,9116,,1,0,1,1373
9117,9117,,1,0,1,215
9118,9118,,1,0,1,74
9119,9119,,1,0,1,40
9120,9120,,1,0,1,27
9121,9121,,0,1,1,1374
9122,9122,,1,0,1,1374
9123,9123,,0,1,1,1375
9124,9124,,1,0,1,1375
9125,9125,,1,0,1,46
9126,9126,,1,0,1,1714
9127,9127,,0,0,0,1376
9128,9128,,0,1,1,1377
9129,9129,,1,0,1,1377
9130,9130,,0,1,1,1378
9131,9131,,2,0,2,1378
9132,9132,,0,1,1,1598
9133,9133,,2,0,2,1598
9134,9134,,0,2,2,1666
9135,9135,,1,0,1,1666
9136,9136,,1,0,1,113
9137,9137,,1,0,1,16
9138,9138,,1,0,1,171
9139,9139,,0,0,0,1379
9140,9140,,0,0,0,1380
9141,9141,,0,2,2,1381
9142,9142,,1,0,1,1381
9143,9143,,1,0,1,113
9144,9144,,1,0,1,1975
9145,9145,,1,0,1,46
9146,9146,,0,0,0,1382
9147,9147,,0,0,0,1383
9148,9148,,0,0,0,1384
9149,9149,,0,1,1,1385
9150,9150,,1,0,1,1385
9151,9151,,0,1,1,1386
9152,9152,,1,0,1,1386
9153,9153,,0,3,3,1387
9154,9154,,1,0,1,1387
9155,9155,,0,2,2,35
9156,9156,,1,0,1,41
9157,9157,,0,1,1,1388
9158,9158,,1,0,1,1388
9159,9159,,0,1,1,113
9160,9160,,2,0,2,113
9161,9161,,0,1,1,1389
9162,9162,,1,0,1,1389
9163,9163,,0,0,0,1390
9164,9164,,0,0,0,1391
9165,9165,,0,1,1,1392
9166,9166,,1,0,1,1392
9167,9167,,0,1,1,1393
9168,9168,,1,0,1,1393
9169,9169,,0,1,1,1394
9170,9170,,1,0,1,1394
9171,9171,,1,0,1,43
9172,9172,,1,0,1,1630
9173,9173,,1,0,1,959
9174,9174,,1,0,1,96
9175,9175,,0,3,3,1646
9176,9176,,1,0,1,1646
9177,9177,,0,1,1,1395
9178,9178,,1,0,1,1395
9179,9179,,0,1,1,1396
9180,9180,,1,0,1,1396
9181,9181,,1,0,1,34
9182,9182,,3,0,3,81
9183,9183,,1,0,1,301
9184,9184,,0,0,0,1397
9185,9185,,0,0,0,1398
9186,9186,,0,0,0,1399
9187,9187,,0,0,0,1400
9188,9188,,0,1,1,1401
9189,9189,,1,0,1,1401
9190,9190,,1,0,1,46
9191,9191,,0,1,1,1402
9192,9192,,1,0,1,1402
9193,9193,,0,1,1,1403
9194,9194,,1,0,1,1403
9195,9195,,1,0,1,30
9196,9196,,0,1,1,1548
9197,9197,,0,0,0,1404
9198,9198,,0,1,1,1405
9199,9199,,1,0,1,1405
9200,9200,,0,0,0,1406
9201,9201,,0,0,0,1407
9202,9202,,1,0,1,260
9203,9203,,0,1,1,1408
9204,9204,,1,0,1,1408
9205,9205,,1,0,1,2010
9206,9206,,0,1,1,1409
9207,9207,,1,0,1,1409
9208,9208,,1,0,1,260
9209,9209,,0,1,1,1410
9210,9210,,1,0,1,1410
9211,9211,,1,0,1,971
9212,9212,,0,0,0,1411
9213,9213,,1,0,1,260
9214,9214,,0,1,1,35
9215,9215,,2,0,2,35
9216,9216,,0,2,2,1412
9217,9217,,4,0,4,1412
9218,9218,,0,1,1,1413
9219,9219,,1,0,1,1413
9220,9220,,0,1,1,1414
9221,9221,,2,0,2,1414
9222,9222,,1,0,1,67
9223,9223,,0,1,1,1415
9224,9224,,1,0,1,1415
9225,9225,,0,1,1,1416
9226,9226,,1,0,1,1416
9227,9227,,0,1,1,1417
9228,9228,,1,0,1,1417
9229,9229,,0,1,1,1418
9230,9230,,1,0,1,1418
9231,9231,,0,0,0,1419
9232,9232,,0,0,0,1420
9233,9233,,1,0,1,215
9234,9234,,1,0,1,1781
9235,9235,,0,0,0,1421
9236,9236,,0,0,0,1422
9237,9237,,0,1,1,1423
9238,9238,,1,0,1,1423
9239,9239,,0,1,1,1424
9240,9240,,1,0,1,1424
9241,9241,,0,0,0,1425
9242,9242,,0,0,0,1426
9243,9243,,0,1,1,1427
9244,9244,,1,0,1,1427
9245,9245,,0,1,1,35
9246,9246,,0,0,0,1428
9247,9247,,0,0,0,1429
9248,9248,,0,1,1,1430
9249,9249,,1,0,1,1430
9250,9250,,0,1,1,1431
9251,9251,,1,0,1,1431
9252,9252,,0,0,0,1432
9253,9253,,0,0,0,1433
9254,9254,,0,0,0,1434
9255,9255,,0,0,0,1435
9256,9256,,0,2,2,1454
9257,9257,,0,1,1,1436
9258,9258,,1,0,1,1436
9259,9259,,0,2,2,1978
9260,9260,,1,0,1,1978
9261,9261,,1,0,1,47
9262,9262,,1,0,1,26
9263,9263,,2,0,2,27
9264,9264,,0,1,1,1437
9265,9265,,2,0,2,1437
9266,9266,,0,1,1,1438
9267,9267,,1,0,1,1438
9268,9268,,1,0,1,152
9269,9269,,1,0,1,46
9270,9270,,0,1,1,225
9271,9271,,0,1,1,804
9272,9272,,0,2,2,1646
9273,9273,,2,0,2,1646
9274,9274,,1,0,1,259
9275,9275,,0,1,1,1439
9276,9276,,1,0,1,1439
9277,9277,,0,0,0,1440
9278,9278,,0,2,2,1441
9279,9279,,1,0,1,1441
9280,9280,,0,1,1,1442
9281,9281,,1,0,1,1442
9282,9282,,1,0,1,152
9283,9283,,1,0,1,46
9284,9284,,1,0,1,19
9285,9285,,2,0,2,55
9286,9286,,1,0,1,2010
9287,9287,,0,1,1,1443
9288,9288,,1,0,1,1443
9289,9289,,0,1,1,1444
9290,9290,,1,0,1,839
9291,9291,,1,0,1,33
9292,9292,,0,1,1,1445
9293,9293,,1,0,1,1445
9294,9294,,0,2,2,1785
9295,9295,,1,0,1,1785
9296,9296,,0,0,0,1446
9297,9297,,0,2,2,2008
9298,9298,,1,0,1,2008
9299,9299,,0,1,1,1645
9300,9300,,0,0,0,1447
9301,9301,,1,0,1,260
9302,9302,,1,0,1,42
9303,9303,,2,0,2,1448
9304,9304,,0,1,1,1449
9305,9305,,1,0,1,1449
9306,9306,,0,1,1,1450
9307,9307,,1,0,1,1450
9308,9308,,0,1,1,1451
9309,9309,,1,0,1,1451
9310,9310,,0,5,5,1584
9311,9311,,1,0,1,1584
9312,9312,,1,0,1,38
9313,9313,,0,2,2,1452
9314,9314,,1,0,1,1452
9315,9315,,1,0,1,46
9316,9316,,0,1,1,1453
9317,9317,,2,0,2,1453
9318,9318,,1,0,1,1454
9319,9319,,1,0,1,41
9320,9320,,1,0,1,1975
9321,9321,,0,0,0,1455
9322,9322,,0,0,0,1456
9323,9323,,0,0,0,1457
9324,9324,,1,0,1,280
9325,9325,,0,1,1,1458
9326,9326,,1,0,1,1458
9327,9327,,0,0,0,1459
9328,9328,,0,1,1,1460
9329,9329,,1,0,1,1460
9330,9330,,0,1,1,1461
9331,9331,,1,0,1,1461
9332,9332,,0,0,0,1462
9333,9333,,0,1,1,1463
9334,9334,,2,0,2,1463
9335,9335,,0,1,1,1464
9336,9336,,1,0,1,1464
9337,9337,,0,0,0,1465
9338,9338,,0,1,1,1466
9339,9339,,1,0,1,1466
9340,9340,,0,2,2,1448
9341,9341,,0,1,1,1830
9342,9342,,0,1,1,1467
9343,9343,,1,0,1,1467
9344,9344,,0,1,1,1468
9345,9345,,1,0,1,1468
9346,9346,,1,0,1,255
9347,9347,,1,0,1,1221
9348,9348,,0,1,1,954
9349,9349,,0,0,0,1469
9350,9350,,0,0,0,1470
9351,9351,,0,0,0,1471
9352,9352,,0,0,0,1472
9353,9353,,0,3,3,27
9354,9354,,1,0,1,27
9355,9355,,0,1,1,1473
9356,9356,,1,0,1,1473
9357,9357,,0,2,2,1659
9358,9358,,1,0,1,1659
9359,9359,,1,0,1,44
9360,9360,,1,0,1,272
9361,9361,,0,0,0,1474
9362,9362,,0,0,0,1475
9363,9363,,1,0,1,27
9364,9364,,0,0,0,1476
9365,9365,,1,0,1,1975
9366,9366,,1,0,1,46
9367,9367,,1,0,1,1387
9368,9368,,0,1,1,204
9369,9369,,1,0,1,18
9370,9370,,0,1,1,1477
9371,9371,,1,0,1,1477
9372,9372,,1,0,1,46
9373,9373,,1,0,1,272
9374,9374,,1,0,1,46
9375,9375,,0,0,0,1478
9376,9376,,0,0,0,1479
9377,9377,,0,0,0,1480
9378,9378,,0,0,0,1481
9379,9379,,0,1,1,1482
9380,9380,,1,0,1,1482
9381,9381,,0,0,0,1483
9382,9382,,0,0,0,1484
9383,9383,,1,0,1,260
9384,9384,,0,1,1,1485
9385,9385,,1,0,1,1485
9386,9386,,0,3,3,260
9387,9387,,1,0,1,260
9388,9388,,0,1,1,1463
9389,9389,,0,1,1,1486
9390,9390,,1,0,1,1486
9391,9391,,0,0,0,1487
9392,9392,,1,0,1,113
9393,9393,,0,2,2,1488
9394,9394,,1,0,1,1488
9395,9395,,0,0,0,1489
9396,9396,,0,0,0,1490
9397,9397,,0,0,0,1491
9398,9398,,0,0,0,1492
9399,9399,,0,1,1,1493
9400,9400,,1,0,1,1493
9401,9401,,1,0,1,1494
9402,9402,,0,1,1,1495
9403,9403,,1,0,1,1495
9404,9404,,0,0,0,1496
9405,9405,,1,0,1,67
9406,9406,,1,0,1,1067
9407,9407,,0,1,1,1497
9408,9408,,1,0,1,1497
9409,9409,,1,0,1,255
9410,9410,,0,1,1,1498
9411,9411,,1,0,1,1498
9412,9412,,0,0,0,1499
9413,9413,,0,0,0,1500
9414,9414,,1,0,1,46
9415,9415,,1,0,1,1554
9416,9416,,1,0,1,890
9417,9417,,1,0,1,1501
9418,9418,,1,0,1,1452
9419,9419,,0,1,1,1502
9420,9420,,1,0,1,1502
9421,9421,,1,0,1,260
9422,9422,,1,0,1,46
9423,9423,,0,0,0,1503
9424,9424,,1,0,1,1571
9425,9425,,0,1,1,1504
9426,9426,,1,0,1,1504
9427,9427,,1,0,1,1387
9428,9428,,0,1,1,1505
9429,9429,,1,0,1,1505
9430,9430,,1,0,1,15
9431,9431,,1,0,1,67
9432,9432,,0,1,1,1506
9433,9433,,1,0,1,1506
9434,9434,,0,1,1,938
9435,9435,,1,0,1,804
9436,9436,,0,1,1,1507
9437,9437,,1,0,1,1507
9438,9438,,0,1,1,1508
9439,9439,,1,0,1,1508
9440,9440,,1,0,1,1646
9441,9441,,0,1,1,1509
9442,9442,,1,0,1,1509
9443,9443,,0,0,0,1510
9444,9444,,0,0,0,1511
9445,9445,,0,0,0,1512
9446,9446,,1,0,1,44
9447,9447,,0,1,1,1513
9448,9448,,1,0,1,1513
9449,9449,,1,0,1,46
9450,9450,,0,0,0,1514
9451,9451,,0,1,1,260
9452,9452,,2,0,2,260
9453,9453,,0,1,1,1515
9454,9454,,1,0,1,1515
9455,9455,,1,0,1,1516
9456,9456,,1,0,1,171
9457,9457,,0,1,1,1517
9458,9458,,1,0,1,1517
9459,9459,,0,1,1,1518
9460,9460,,2,0,2,1518
9461,9461,,1,0,1,1265
9462,9462,,0,1,1,1519
9463,9463,,1,0,1,1519
9464,9464,,0,1,1,1412
9465,9465,,1,0,1,1520
9466,9466,,0,1,1,1521
9467,9467,,1,0,1,1521
9468,9468,,1,0,1,113
9469,9469,,1,0,1,1278
9470,9470,,1,0,1,815
9471,9471,,0,1,1,1522
9472,9472,,1,0,1,1522
9473,9473,,1,0,1,272
9474,9474,,0,0,0,1523
9475,9475,,0,0,0,1524
9476,9476,,0,0,0,1525
9477,9477,,0,0,0,1526
9478,9478,,2,0,2,67
9479,9479,,1,0,1,260
9480,9480,,1,0,1,19
9481,9481,,0,1,1,1527
9482,9482,,1,0,1,1527
9483,9483,,0,0,0,1528
9484,9484,,1,0,1,26
9485,9485,,1,0,1,30
9486,9486,,1,0,1,1529
9487,9487,,1,0,1,1975
9488,9488,,1,0,1,113
9489,9489,,0,1,1,1530
9490,9490,,1,0,1,1530
9491,9491,,0,1,1,1531
9492,9492,,1,0,1,1531
9493,9493,,0,1,1,1532
9494,9494,,1,0,1,1532
9495,9495,,0,1,1,1533
9496,9496,,1,0,1,1533
9497,9497,,0,1,1,1534
9498,9498,,1,0,1,1534
9499,9499,,0,1,1,1535
9500,9500,,1,0,1,1535
9501,9501,,1,0,1,67
9502,9502,,0,1,1,1536
9503,9503,,1,0,1,1536
9504,9504,,1,0,1,1274
9505,9505,,0,1,1,1537
9506,9506,,1,0,1,1537
9507,9507,,0,1,1,878
9508,9508,,0,1,1,1538
9509,9509,,1,0,1,1538
9510,9510,,1,0,1,30
9511,9511,,1,0,1,1221
9512,9512,,1,0,1,260
9513,9513,,0,1,1,1539
9514,9514,,1,0,1,1539
9515,9515,,0,2,2,1540
9516,9516,,1,0,1,1540
9517,9517,,1,0,1,44
9518,9518,,1,0,1,34
9519,9519,,0,0,0,1541
9520,9520,,0,0,0,1542
9521,9521,,0,1,1,1543
9522,9522,,1,0,1,1543
9523,9523,,0,1,1,1544
9524,9524,,1,0,1,1544
9525,9525,,1,0,1,1062
9526,9526,,0,1,1,216
9527,9527,,2,0,2,216
9528,9528,,1,0,1,39
9529,9529,,0,1,1,1545
9530,9530,,1,0,1,1545
9531,9531,,0,0,0,1546
9532,9532,,0,0,0,1547
9533,9533,,1,0,1,1548
9534,9534,,0,0,0,1549
9535,9535,,1,0,1,96
9536,9536,,0,0,0,1550
9537,9537,,0,1,1,1551
9538,9538,,1,0,1,1551
9539,9539,,0,0,0,1552
9540,9540,,1,0,1,1553
9541,9541,,1,0,1,1265
9542,9542,,2,0,2,28
9543,9543,,1,0,1,46
9544,9544,,1,0,1,1554
9545,9545,,0,0,0,1555
9546,9546,,0,0,0,1556
9547,9547,,1,0,1,1975
9548,9548,,1,0,1,260
9549,9549,,0,1,1,1806
9550,9550,,1,0,1,280
9551,9551,,0,0,0,1557
9552,9552,,0,0,0,1558
9553,9553,,0,0,0,1559
9554,9554,,0,0,0,1560
9555,9555,,0,0,0,1561
9556,9556,,0,1,1,19
9557,9557,,2,0,2,19
9558,9558,,1,0,1,73
9559,9559,,0,1,1,1562
9560,9560,,1,0,1,1562
9561,9561,,0,1,1,1563
9562,9562,,1,0,1,1563
9563,9563,,0,0,0,1564
9564,9564,,1,0,1,26
9565,9565,,0,1,1,1565
9566,9566,,1,0,1,1565
9567,9567,,1,0,1,1274
9568,9568,,1,0,1,1381
9569,9569,,1,0,1,67
9570,9570,,0,1,1,1566
9571,9571,,1,0,1,1566
9572,9572,,0,0,0,1567
9573,9573,,1,0,1,1975
9574,9574,,1,0,1,35
9575,9575,,0,1,1,81
9576,9576,,1,0,1,46
9577,9577,,0,1,1,1568
9578,9578,,1,0,1,1568
9579,9579,,0,0,0,1569
9580,9580,,0,1,1,1570
9581,9581,,1,0,1,1570
9582,9582,,1,0,1,46
9583,9583,,1,0,1,42
9584,9584,,1,0,1,1448
9585,9585,,0,1,1,1571
9586,9586,,0,1,1,1572
9587,9587,,1,0,1,1572
9588,9588,,0,1,1,1573
9589,9589,,1,0,1,1573
9590,9590,,1,0,1,81
9591,9591,,1,0,1,96
9592,9592,,0,0,0,1574
9593,9593,,0,0,0,1575
9594,9594,,1,0,1,215
9595,9595,,0,1,1,1576
9596,9596,,1,0,1,1576
9597,9597,,0,1,1,1577
9598,9598,,1,0,1,1577
9599,9599,,0,1,1,1578
9600,9600,,1,0,1,1578
9601,9601,,0,0,0,1579
9602,9602,,2,0,2,27
9603,9603,,0,1,1,1580
9604,9604,,1,0,1,1580
9605,9605,,1,0,1,260
9606,9606,,0,0,0,1581
9607,9607,,0,0,0,1582
9608,9608,,0,1,1,1583
9609,9609,,1,0,1,1583
9610,9610,,1,0,1,144
9611,9611,,1,0,1,26
9612,9612,,1,0,1,67
9613,9613,,1,0,1,1584
9614,9614,,0,1,1,1585
9615,9615,,1,0,1,1585
9616,9616,,0,0,0,1586
9617,9617,,0,0,0,1587
9618,9618,,0,1,1,1518
9619,9619,,0,0,0,1588
9620,9620,,0,0,0,1589
9621,9621,,0,2,2,1590
9622,9622,,1,0,1,1590
9623,9623,,1,0,1,53
9624,9624,,1,0,1,260
9625,9625,,0,0,0,1591
9626,9626,,0,0,0,1592
9627,9627,,1,0,1,46
9628,9628,,1,0,1,19
9629,9629,,0,1,1,1593
9630,9630,,1,0,1,1593
9631,9631,,0,2,2,1594
9632,9632,,1,0,1,1594
9633,9633,,1,0,1,280
9634,9634,,1,0,1,46
9635,9635,,0,0,0,1595
9636,9636,,0,0,0,1596
9637,9637,,1,0,1,1597
9638,9638,,0,2,2,1598
9639,9639,,1,0,1,1598
9640,9640,,1,0,1,133
9641,9641,,0,0,0,1599
9642,9642,,0,1,1,1600
9643,9643,,1,0,1,1600
9644,9644,,1,0,1,44
9645,9645,,0,0,0,1601
9646,9646,,0,0,0,1602
9647,9647,,2,0,2,42
9648,9648,,0,1,1,1603
9649,9649,,1,0,1,1603
9650,9650,,0,1,1,1604
9651,9651,,2,0,2,1604
9652,9652,,0,1,1,1605
9653,9653,,1,0,1,1605
9654,9654,,1,0,1,1540
9655,9655,,1,0,1,1606
9656,9656,,0,0,0,1607
9657,9657,,0,0,0,1608
9658,9658,,0,1,1,1609
9659,9659,,1,0,1,1609
9660,9660,,0,0,0,1610
9661,9661,,0,0,0,1611
9662,9662,,0,0,0,1612
9663,9663,,1,0,1,728
9664,9664,,0,0,0,1613
9665,9665,,1,0,1,40
9666,9666,,0,1,1,55
9667,9667,,0,0,0,1614
9668,9668,,0,0,0,1615
9669,9669,,1,0,1,46
9670,9670,,0,0,0,1616
9671,9671,,0,0,0,1617
9672,9672,,1,0,1,1101
9673,9673,,0,0,0,1618
9674,9674,,0,1,1,1619
9675,9675,,1,0,1,1619
9676,9676,,1,0,1,33
9677,9677,,1,0,1,1747
9678,9678,,0,2,2,1620
9679,9679,,1,0,1,1620
9680,9680,,1,0,1,46
9681,9681,,0,1,1,1621
9682,9682,,1,0,1,1621
9683,9683,,0,0,0,1622
9684,9684,,0,0,0,1623
9685,9685,,0,0,0,1624
9686,9686,,1,0,1,1067
9687,9687,,0,1,1,1625
9688,9688,,1,0,1,1625
9689,9689,,0,0,0,1626
9690,9690,,0,1,1,1627
9691,9691,,1,0,1,1627
9692,9692,,0,1,1,1628
9693,9693,,1,0,1,1628
9694,9694,,0,1,1,1629
9695,9695,,1,0,1,1629
9696,9696,,0,2,2,1630
9697,9697,,0,1,1,1631
9698,9698,,1,0,1,1631
9699,9699,,0,1,1,1799
9700,9700,,2,0,2,1799
9701,9701,,0,1,1,1632
9702,9702,,1,0,1,1632
9703,9703,,0,0,0,1633
9704,9704,,0,0,0,1634
9705,9705,,0,0,0,1635
9706,9706,,0,1,1,323
9707,9707,,1,0,1,1636
9708,9708,,1,0,1,260
9709,9709,,0,1,1,1637
9710,9710,,1,0,1,1637
9711,9711,,0,2,2,1638
9712,9712,,1,0,1,1638
9713,9713,,1,0,1,34
9714,9714,,0,0,0,1639
9715,9715,,0,0,0,1640
9716,9716,,1,0,1,34
9717,9717,,1,0,1,1747
9718,9718,,1,0,1,255
9719,9719,,0,2,2,1792
9720,9720,,1,0,1,1792
9721,9721,,0,2,2,1885
9722,9722,,1,0,1,1885
9723,9723,,0,1,1,1641
9724,9724,,1,0,1,1641
9725,9725,,0,0,0,1642
9726,9726,,0,0,0,1643
9727,9727,,0,2,2,1644
9728,9728,,1,0,1,1644
9729,9729,,1,0,1,1645
9730,9730,,1,0,1,27
9731,9731,,0,1,1,870
9732,9732,,1,0,1,1646
9733,9733,,0,1,1,1647
9734,9734,,1,0,1,1647
9735,9735,,0,3,3,1709
9736,9736,,1,0,1,1709
9737,9737,,1,0,1,1896
9738,9738,,0,0,0,1648
9739,9739,,0,0,0,1649
9740,9740,,0,0,0,1650
9741,9741,,0,1,1,1651
9742,9742,,1,0,1,1651
9743,9743,,1,0,1,1652
9744,9744,,0,0,0,1653
9745,9745,,0,0,0,1654
9746,9746,,1,0,1,804
9747,9747,,0,1,1,1655
9748,9748,,1,0,1,1655
9749,9749,,0,3,3,1945
9750,9750,,1,0,1,1945
9751,9751,,0,0,0,1656
9752,9752,,0,0,0,1657
9753,9753,,0,1,1,1658
9754,9754,,1,0,1,1658
9755,9755,,1,0,1,1659
9756,9756,,1,0,1,260
9757,9757,,0,1,1,1660
9758,9758,,1,0,1,1660
9759,9759,,1,0,1,46
9760,9760,,1,0,1,925
9761,9761,,0,1,1,1661
9762,9762,,1,0,1,1661
9763,9763,,1,0,1,1662
9764,9764,,1,0,1,2010
9765,9765,,0,2,2,1663
9766,9766,,1,0,1,1663
9767,9767,,0,1,1,1664
9768,9768,,1,0,1,1664
9769,9769,,1,0,1,1876
9770,9770,,0,1,1,1267
9771,9771,,1,0,1,53
9772,9772,,0,1,1,1665
9773,9773,,1,0,1,1665
9774,9774,,1,0,1,46
9775,9775,,1,0,1,74
9776,9776,,1,0,1,1666
9777,9777,,1,0,1,1975
9778,9778,,1,0,1,25
9779,9779,,1,0,1,1072
9780,9780,,1,0,1,19
9781,9781,,1,0,1,1253
9782,9782,,1,0,1,255
9783,9783,,0,0,0,1667
9784,9784,,0,1,1,1668
9785,9785,,1,0,1,1668
9786,9786,,0,0,0,1669
9787,9787,,0,1,1,1670
9788,9788,,1,0,1,1670
9789,9789,,0,1,1,1671
9790,9790,,1,0,1,1671
9791,9791,,0,1,1,1672
9792,9792,,1,0,1,1672
9793,9793,,1,0,1,19
9794,9794,,0,1,1,1673
9795,9795,,1,0,1,1673
9796,9796,,0,0,0,1674
9797,9797,,0,1,1,1675
9798,9798,,1,0,1,1675
9799,9799,,1,0,1,42
9800,9800,,0,1,1,1676
9801,9801,,1,0,1,1676
9802,9802,,0,1,1,1677
9803,9803,,1,0,1,1677
9804,9804,,0,0,0,1678
9805,9805,,0,0,0,1679
9806,9806,,0,1,1,1680
9807,9807,,1,0,1,1680
9808,9808,,0,1,1,1681
9809,9809,,1,0,1,1681
9810,9810,,1,0,1,255
9811,9811,,0,0,0,1682
9812,9812,,0,1,1,1683
9813,9813,,1,0,1,1683
9814,9814,,0,1,1,821
9815,9815,,0,1,1,1008
9816,9816,,0,1,1,1684
9817,9817,,1,0,1,1684
9818,9818,,0,1,1,1225
9819,9819,,1,0,1,1529
9820,9820,,1,0,1,152
9821,9821,,0,1,1,1685
9822,9822,,1,0,1,1685
9823,9823,,0,1,1,1686
9824,9824,,1,0,1,1686
9825,9825,,0,0,0,1687
9826,9826,,0,1,1,1688
9827,9827,,1,0,1,1688
9828,9828,,1,0,1,280
9829,9829,,1,0,1,27
9830,9830,,0,1,1,1689
9831,9831,,1,0,1,1689
9832,9832,,0,1,1,1690
9833,9833,,1,0,1,1690
9834,9834,,0,0,0,1691
9835,9835,,0,1,1,1692
9836,9836,,1,0,1,1692
9837,9837,,0,1,1,42
9838,9838,,0,1,1,1693
9839,9839,,1,0,1,1693
9840,9840,,0,1,1,1694
9841,9841,,1,0,1,1694
9842,9842,,1,0,1,57
9843,9843,,1,0,1,46
9844,9844,,0,1,1,1695
9845,9845,,1,0,1,1695
9846,9846,,0,1,1,25
9847,9847,,1,0,1,547
9848,9848,,0,1,1,1696
9849,9849,,1,0,1,1696
9850,9850,,1,0,1,1697
9851,9851,,1,0,1,1090
9852,9852,,0,1,1,1698
9853,9853,,1,0,1,1698
9854,9854,,1,0,1,46
9855,9855,,1,0,1,113
9856,9856,,0,1,1,1699
9857,9857,,1,0,1,1699
9858,9858,,1,0,1,216
9859,9859,,0,1,1,1700
9860,9860,,1,0,1,1700
9861,9861,,0,1,1,1701
9862,9862,,1,0,1,1701
9863,9863,,0,0,0,1702
9864,9864,,0,0,0,1703
9865,9865,,0,1,1,1704
9866,9866,,1,0,1,1704
9867,9867,,1,0,1,77
9868,9868,,0,1,1,1705
9869,9869,,1,0,1,1705
9870,9870,,0,1,1,1706
9871,9871,,1,0,1,1706
9872,9872,,0,0,0,1707
9873,9873,,0,1,1,1708
9874,9874,,1,0,1,1708
9875,9875,,1,0,1,1709
9876,9876,,1,0,1,67
9877,9877,,0,1,1,1710
9878,9878,,1,0,1,1710
9879,9879,,1,0,1,46
9880,9880,,1,0,1,44
9881,9881,,1,0,1,29
9882,9882,,1,0,1,1253
9883,9883,,0,1,1,1711
9884,9884,,1,0,1,1711
9885,9885,,0,0,0,1712
9886,9886,,0,0,0,1713
9887,9887,,1,0,1,53
9888,9888,,0,1,1,833
9889,9889,,1,0,1,1714
9890,9890,,0,0,0,1715
9891,9891,,0,1,1,25
9892,9892,,0,1,1,1716
9893,9893,,1,0,1,1716
9894,9894,,0,0,0,1717
9895,9895,,1,0,1,260
9896,9896,,0,1,1,1718
9897,9897,,1,0,1,1718
9898,9898,,1,0,1,34
9899,9899,,1,0,1,27
9900,9900,,0,1,1,1719
9901,9901,,1,0,1,1719
9902,9902,,1,0,1,67
9903,9903,,0,1,1,1720
9904,9904,,1,0,1,1720
9905,9905,,0,1,1,1721
9906,9906,,1,0,1,1721
9907,9907,,0,1,1,1722
9908,9908,,1,0,1,1722
9909,9909,,0,1,1,1378
9910,9910,,0,0,0,1723
9911,9911,,0,0,0,1724
9912,9912,,0,1,1,1351
9913,9913,,1,0,1,1597
9914,9914,,1,0,1,384
9915,9915,,1,0,1,57
9916,9916,,1,0,1,280
9917,9917,,1,0,1,44
9918,9918,,1,0,1,118
9919,9919,,0,0,0,1725
9920,9920,,0,0,0,1726
9921,9921,,0,1,1,1727
9922,9922,,1,0,1,1727
9923,9923,,0,1,1,1728
9924,9924,,1,0,1,1728
9925,9925,,0,1,1,1729
9926,9926,,1,0,1,1729
9927,9927,,0,1,1,1730
9928,9928,,1,0,1,1730
9929,9929,,1,0,1,2010
9930,9930,,1,0,1,16
9931,9931,,1,0,1,280
9932,9932,,0,0,0,1731
9933,9933,,0,0,0,1732
9934,9934,,0,0,0,1733
9935,9935,,0,1,1,1734
9936,9936,,1,0,1,1734
9937,9937,,1,0,1,46
9938,9938,,1,0,1,1372
9939,9939,,0,1,1,1735
9940,9940,,1,0,1,1735
9941,9941,,1,0,1,19
9942,9942,,0,1,1,28
9943,9943,,0,1,1,1736
9944,9944,,1,0,1,1736
9945,9945,,0,0,0,1737
9946,9946,,0,1,1,1738
9947,9947,,1,0,1,1738
9948,9948,,0,1,1,35
9949,9949,,1,0,1,1278
9950,9950,,1,0,1,316
9951,9951,,1,0,1,46
9952,9952,,0,0,0,1739
9953,9953,,1,0,1,19
9954,9954,,1,0,1,1740
9955,9955,,0,0,0,1741
9956,9956,,0,0,0,1742
9957,9957,,0,1,1,1097
9958,9958,,0,1,1,754
9959,9959,,1,0,1,77
9960,9960,,1,0,1,34
9961,9961,,1,0,1,59
9962,9962,,1,0,1,1945
9963,9963,,0,0,0,1743
9964,9964,,1,0,1,1959
9965,9965,,1,0,1,1975
9966,9966,,1,0,1,280
9967,9967,,1,0,1,1584
9968,9968,,0,1,1,1744
9969,9969,,1,0,1,1744
9970,9970,,1,0,1,30
9971,9971,,1,0,1,113
9972,9972,,0,1,1,1059
9973,9973,,1,0,1,1652
9974,9974,,0,0,0,1745
9975,9975,,0,0,0,1746
9976,9976,,1,0,1,1747
9977,9977,,1,0,1,1748
9978,9978,,0,1,1,1749
9979,9979,,1,0,1,1749
9980,9980,,1,0,1,34
9981,9981,,1,0,1,260
9982,9982,,0,1,1,1750
9983,9983,,1,0,1,1750
9984,9984,,0,1,1,1751
9985,9985,,1,0,1,1751
9986,9986,,1,0,1,25
9987,9987,,0,1,1,1752
9988,9988,,1,0,1,1752
9989,9989,,0,0,0,1753
9990,9990,,1,0,1,44
9991,9991,,0,1,1,1754
9992,9992,,1,0,1,1754
9993,9993,,0,0,0,1755
9994,9994,,1,0,1,280
9995,9995,,1,0,1,41
9996,9996,,0,1,1,1756
9997,9997,,1,0,1,1756
9998,9998,,0,1,1,1757
9999,9999,,1,0,1,1757
10000,10000,,0,1,1,1758
10001,10001,,1,0,1,1758
10002,10002,,1,0,1,47
10003,10003,,0,0,0,1759
10004,10004,,0,0,0,1760
10005,10005,,0,1,1,260
10006,10006,,0,1,1,1761
10007,10007,,1,0,1,1761
10008,10008,,0,1,1,1762
10009,10009,,1,0,1,1762
10010,10010,,0,0,0,1763
10011,10011,,0,1,1,1764
10012,10012,,1,0,1,1764
10013,10013,,1,0,1,1765
10014,10014,,0,1,1,1766
10015,10015,,1,0,1,1766
10016,10016,,0,1,1,1767
10017,10017,,1,0,1,1767
10018,10018,,1,0,1,30
10019,10019,,0,0,0,1768
10020,10020,,1,0,1,30
10021,10021,,1,0,1,74
10022,10022,,1,0,1,839
10023,10023,,0,1,1,384
10024,10024,,0,0,0,1769
10025,10025,,1,0,1,187
10026,10026,,1,0,1,280
10027,10027,,0,1,1,1770
10028,10028,,1,0,1,1770
10029,10029,,1,0,1,839
10030,10030,,0,1,1,1771
10031,10031,,1,0,1,1771
10032,10032,,1,0,1,27
10033,10033,,0,1,1,1772
10034,10034,,1,0,1,1772
10035,10035,,2,0,2,260
10036,10036,,1,0,1,19
10037,10037,,0,1,1,1773
10038,10038,,1,0,1,1773
10039,10039,,0,0,0,1774
10040,10040,,0,0,0,1775
10041,10041,,0,1,1,1776
10042,10042,,1,0,1,1776
10043,10043,,0,1,1,1777
10044,10044,,1,0,1,1777
10045,10045,,0,1,1,1778
10046,10046,,1,0,1,1778
10047,10047,,1,0,1,1584
10048,10048,,0,0,0,1779
10049,10049,,0,1,1,1780
10050,10050,,1,0,1,1780
10051,10051,,1,0,1,722
10052,10052,,1,0,1,1781
10053,10053,,0,1,1,1782
10054,10054,,1,0,1,1782
10055,10055,,0,0,0,1783
10056,10056,,0,1,1,1784
10057,10057,,1,0,1,1784
10058,10058,,1,0,1,1785
10059,10059,,1,0,1,869
10060,10060,,0,1,1,1786
10061,10061,,1,0,1,1786
10062,10062,,0,1,1,1453
10063,10063,,0,0,0,1787
10064,10064,,0,1,1,1788
10065,10065,,1,0,1,1788
10066,10066,,1,0,1,260
10067,10067,,0,0,0,1789
10068,10068,,0,1,1,1790
10069,10069,,1,0,1,1790
10070,10070,,1,0,1,984
10071,10071,,0,1,1,1791
10072,10072,,1,0,1,1791
10073,10073,,1,0,1,260
10074,10074,,1,0,1,1792
10075,10075,,1,0,1,41
10076,10076,,1,0,1,26
10077,10077,,1,0,1,46
10078,10078,,1,0,1,1067
10079,10079,,1,0,1,19
10080,10080,,1,0,1,33
10081,10081,,0,1,1,1437
10082,10082,,1,0,1,47
10083,10083,,1,0,1,260
10084,10084,,0,1,1,1793
10085,10085,,1,0,1,1793
10086,10086,,0,0,0,1794
10087,10087,,0,0,0,1795
10088,10088,,1,0,1,280
10089,10089,,0,0,0,1796
10090,10090,,0,0,0,1797
10091,10091,,0,0,0,1798
10092,10092,,0,2,2,1799
10093,10093,,1,0,1,1799
10094,10094,,1,0,1,853
10095,10095,,0,0,0,1800
10096,10096,,0,1,1,1801
10097,10097,,1,0,1,1801
10098,10098,,0,1,1,1089
10099,10099,,1,0,1,30
10100,10100,,0,1,1,1802
10101,10101,,1,0,1,1802
10102,10102,,1,0,1,41
10103,10103,,0,1,1,1803
10104,10104,,1,0,1,1803
10105,10105,,0,1,1,1804
10106,10106,,1,0,1,1804
10107,10107,,0,1,1,1805
10108,10108,,1,0,1,1805
10109,10109,,0,1,1,1806
10110,10110,,0,0,0,1807
10111,10111,,1,0,1,239
10112,10112,,0,1,1,1830
10113,10113,,0,0,0,1808
10114,10114,,0,0,0,1809
10115,10115,,0,1,1,1810
10116,10116,,1,0,1,1810
10117,10117,,0,1,1,1811
10118,10118,,1,0,1,1811
10119,10119,,0,1,1,1812
10120,10120,,1,0,1,1812
10121,10121,,1,0,1,260
10122,10122,,0,1,1,1813
10123,10123,,1,0,1,1813
10124,10124,,0,1,1,1814
10125,10125,,1,0,1,1814
10126,10126,,0,0,0,1815
10127,10127,,0,0,0,1816
10128,10128,,0,0,0,1817
10129,10129,,0,0,0,1818
10130,10130,,0,0,0,1819
10131,10131,,0,0,0,1820
10132,10132,,0,1,1,1821
10133,10133,,1,0,1,1821
10134,10134,,0,0,0,1822
10135,10135,,0,1,1,1823
10136,10136,,1,0,1,1823
10137,10137,,1,0,1,804
10138,10138,,1,0,1,19
10139,10139,,1,0,1,1644
10140,10140,,1,0,1,1067
10141,10141,,0,1,1,1824
10142,10142,,1,0,1,1824
10143,10143,,0,0,0,1825
10144,10144,,0,1,1,1826
10145,10145,,1,0,1,1826
10146,10146,,1,0,1,216
10147,10147,,0,1,1,1827
10148,10148,,1,0,1,1827
10149,10149,,0,0,0,1828
10150,10150,,0,1,1,1829
10151,10151,,1,0,1,1829
10152,10152,,0,1,1,1412
10153,10153,,0,2,2,1830
10154,10154,,0,1,1,1831
10155,10155,,1,0,1,1831
10156,10156,,1,0,1,34
10157,10157,,0,1,1,1412
10158,10158,,1,0,1,260
10159,10159,,1,0,1,40
10160,10160,,0,1,1,1832
10161,10161,,1,0,1,1832
10162,10162,,1,0,1,44
10163,10163,,0,0,0,1833
10164,10164,,0,0,0,1834
10165,10165,,0,1,1,1835
10166,10166,,1,0,1,1835
10167,10167,,1,0,1,1221
10168,10168,,0,1,1,1836
10169,10169,,1,0,1,1836
10170,10170,,0,1,1,1837
10171,10171,,1,0,1,1837
10172,10172,,0,1,1,1838
10173,10173,,1,0,1,1838
10174,10174,,1,0,1,1975
10175,10175,,1,0,1,1594
10176,10176,,1,0,1,43
10177,10177,,0,1,1,1839
10178,10178,,1,0,1,1839
10179,10179,,1,0,1,67
10180,10180,,0,1,1,1840
10181,10181,,1,0,1,1840
10182,10182,,0,1,1,1841
10183,10183,,3,0,3,1841
10184,10184,,0,1,1,1842
10185,10185,,1,0,1,1842
10186,10186,,1,0,1,46
10187,10187,,0,1,1,1843
10188,10188,,1,0,1,1843
10189,10189,,1,0,1,1221
10190,10190,,0,1,1,1844
10191,10191,,1,0,1,1844
10192,10192,,1,0,1,280
10193,10193,,1,0,1,46
10194,10194,,0,1,1,1845
10195,10195,,1,0,1,1845
10196,10196,,1,0,1,204
10197,10197,,0,2,2,1931
10198,10198,,1,0,1,1931
10199,10199,,0,1,1,1846
10200,10200,,1,0,1,1846
10201,10201,,0,1,1,67
10202,10202,,0,0,0,1847
10203,10203,,0,0,0,1848
10204,10204,,1,0,1,67
10205,10205,,0,0,0,1849
10206,10206,,0,0,0,1850
10207,10207,,0,1,1,1851
10208,10208,,1,0,1,1851
10209,10209,,0,0,0,1852
10210,10210,,1,0,1,21
10211,10211,,0,1,1,1853
10212,10212,,1,0,1,1853
10213,10213,,0,1,1,1854
10214,10214,,1,0,1,1854
10215,10215,,0,0,0,1855
10216,10216,,0,0,0,1856
10217,10217,,0,0,0,1857
10218,10218,,0,0,0,1858
10219,10219,,0,0,0,1859
10220,10220,,0,0,0,1860
10221,10221,,0,1,1,1861
10222,10222,,1,0,1,1861
10223,10223,,0,0,0,1862
10224,10224,,1,0,1,216
10225,10225,,1,0,1,272
10226,10226,,1,0,1,259
10227,10227,,0,0,0,1863
10228,10228,,1,0,1,971
10229,10229,,1,0,1,40
10230,10230,,0,1,1,1864
10231,10231,,2,0,2,1864
10232,10232,,0,1,1,1865
10233,10233,,1,0,1,1865
10234,10234,,0,1,1,194
10235,10235,,1,0,1,1663
10236,10236,,1,0,1,34
10237,10237,,0,0,0,1866
10238,10238,,0,0,0,1867
10239,10239,,0,1,1,1868
10240,10240,,1,0,1,1868
10241,10241,,1,0,1,1344
10242,10242,,0,1,1,1869
10243,10243,,1,0,1,1869
10244,10244,,0,0,0,1870
10245,10245,,0,1,1,1604
10246,10246,,1,0,1,280
10247,10247,,1,0,1,46
10248,10248,,1,0,1,260
10249,10249,,1,0,1,1652
10250,10250,,0,1,1,1871
10251,10251,,1,0,1,1871
10252,10252,,0,1,1,1872
10253,10253,,1,0,1,1872
10254,10254,,1,0,1,1412
10255,10255,,1,0,1,216
10256,10256,,0,0,0,1873
10257,10257,,1,0,1,42
10258,10258,,1,0,1,1441
10259,10259,,0,0,0,1874
10260,10260,,0,1,1,1875
10261,10261,,1,0,1,1875
10262,10262,,1,0,1,1876
10263,10263,,1,0,1,1877
10264,10264,,0,0,0,1878
10265,10265,,0,0,0,1879
10266,10266,,1,0,1,34
10267,10267,,0,0,0,1880
10268,10268,,0,0,0,1881
10269,10269,,1,0,1,39
10270,10270,,1,0,1,44
10271,10271,,1,0,1,1882
10272,10272,,0,0,0,1883
10273,10273,,1,0,1,90
10274,10274,,0,0,0,1884
10275,10275,,1,0,1,1885
10276,10276,,0,0,0,1886
10277,10277,,0,0,0,1887
10278,10278,,2,0,2,67
10279,10279,,1,0,1,44
10280,10280,,0,1,1,1864
10281,10281,,0,1,1,1412
10282,10282,,1,0,1,46
10283,10283,,1,0,1,280
10284,10284,,0,1,1,1830
10285,10285,,1,0,1,260
10286,10286,,0,0,0,1888
10287,10287,,0,0,0,1889
10288,10288,,1,0,1,46
10289,10289,,0,1,1,1890
10290,10290,,1,0,1,1890
10291,10291,,0,1,1,1891
10292,10292,,1,0,1,1891
10293,10293,,1,0,1,171
10294,10294,,0,0,0,1892
10295,10295,,0,0,0,1893
10296,10296,,0,0,0,1894
10297,10297,,0,0,0,1895
10298,10298,,1,0,1,1896
10299,10299,,1,0,1,280
10300,10300,,0,1,1,1897
10301,10301,,1,0,1,1897
10302,10302,,0,1,1,1898
10303,10303,,1,0,1,1898
10304,10304,,0,1,1,1899
10305,10305,,1,0,1,1899
10306,10306,,1,0,1,215
10307,10307,,0,0,0,1900
10308,10308,,0,0,0,1901
10309,10309,,0,0,0,1902
10310,10310,,1,0,1,41
10311,10311,,1,0,1,1903
10312,10312,,0,1,1,1904
10313,10313,,1,0,1,1904
10314,10314,,1,0,1,152
10315,10315,,0,0,0,1905
10316,10316,,0,0,0,1906
10317,10317,,1,0,1,55
10318,10318,,0,1,1,1907
10319,10319,,1,0,1,1907
10320,10320,,0,0,0,1908
10321,10321,,0,0,0,1909
10322,10322,,0,0,0,1910
10323,10323,,0,0,0,1911
10324,10324,,1,0,1,27
10325,10325,,0,1,1,21
10326,10326,,2,0,2,21
10327,10327,,0,1,1,1912
10328,10328,,1,0,1,1912
10329,10329,,1,0,1,30
10330,10330,,0,1,1,1913
10331,10331,,1,0,1,1913
10332,10332,,1,0,1,280
10333,10333,,0,1,1,1914
10334,10334,,1,0,1,1914
10335,10335,,0,0,0,1915
10336,10336,,0,1,1,821
10337,10337,,0,1,1,1916
10338,10338,,1,0,1,1916
10339,10339,,0,0,0,1917
10340,10340,,0,1,1,26
10341,10341,,0,0,0,1918
10342,10342,,0,1,1,870
10343,10343,,0,1,1,1919
10344,10344,,1,0,1,1919
10345,10345,,0,1,1,1920
10346,10346,,1,0,1,1920
10347,10347,,1,0,1,46
10348,10348,,1,0,1,34
10349,10349,,1,0,1,44
10350,10350,,0,1,1,1921
10351,10351,,1,0,1,1921
10352,10352,,0,0,0,1922
10353,10353,,1,0,1,73
10354,10354,,0,0,0,1923
10355,10355,,0,0,0,1924
10356,10356,,0,0,0,1925
10357,10357,,0,1,1,1926
10358,10358,,1,0,1,1926
10359,10359,,0,1,1,1927
10360,10360,,1,0,1,1927
10361,10361,,1,0,1,1520
10362,10362,,0,0,0,1928
10363,10363,,0,1,1,1929
10364,10364,,1,0,1,1929
10365,10365,,1,0,1,216
10366,10366,,1,0,1,41
10367,10367,,1,0,1,916
10368,10368,,0,1,1,1930
10369,10369,,1,0,1,1930
10370,10370,,1,0,1,74
10371,10371,,1,0,1,27
10372,10372,,1,0,1,1931
10373,10373,,1,0,1,1975
10374,10374,,1,0,1,260
10375,10375,,0,0,0,1932
10376,10376,,0,0,0,1933
10377,10377,,1,0,1,46
10378,10378,,1,0,1,216
10379,10379,,0,1,1,1934
10380,10380,,1,0,1,1934
10381,10381,,1,0,1,73
10382,10382,,0,1,1,1935
10383,10383,,1,0,1,1935
10384,10384,,1,0,1,260
10385,10385,,0,1,1,1936
10386,10386,,1,0,1,1936
10387,10387,,1,0,1,1553
10388,10388,,0,0,0,1937
10389,10389,,0,0,0,1938
10390,10390,,0,1,1,1144
10391,10391,,0,1,1,1939
10392,10392,,1,0,1,1939
10393,10393,,0,1,1,1940
10394,10394,,1,0,1,1940
10395,10395,,0,1,1,1941
10396,10396,,1,0,1,1941
10397,10397,,1,0,1,77
10398,10398,,1,0,1,44
10399,10399,,0,1,1,1153
10400,10400,,0,1,1,1942
10401,10401,,1,0,1,1942
10402,10402,,1,0,1,1620
10403,10403,,1,0,1,18
10404,10404,,0,1,1,1943
10405,10405,,1,0,1,1943
10406,10406,,1,0,1,19
10407,10407,,0,0,0,1944
10408,10408,,1,0,1,46
10409,10409,,0,1,1,1121
10410,10410,,1,0,1,1945
10411,10411,,1,0,1,260
10412,10412,,0,0,0,1946
10413,10413,,0,0,0,1947
10414,10414,,0,1,1,969
10415,10415,,0,1,1,1948
10416,10416,,1,0,1,1948
10417,10417,,1,0,1,77
10418,10418,,1,0,1,1488
10419,10419,,0,0,0,1949
10420,10420,,0,0,0,1950
10421,10421,,0,1,1,1951
10422,10422,,1,0,1,1951
10423,10423,,0,0,0,1952
10424,10424,,0,1,1,1953
10425,10425,,1,0,1,1953
10426,10426,,1,0,1,1876
10427,10427,,0,1,1,1954
10428,10428,,1,0,1,1954
10429,10429,,0,1,1,1955
10430,10430,,1,0,1,1955
10431,10431,,1,0,1,867
10432,10432,,1,0,1,1956
10433,10433,,0,0,0,1957
10434,10434,,0,0,0,1958
10435,10435,,0,1,1,1412
10436,10436,,1,0,1,42
10437,10437,,0,1,1,1959
10438,10438,,1,0,1,34
10439,10439,,0,0,0,1960
10440,10440,,1,0,1,30
10441,10441,,0,0,0,1961
10442,10442,,0,0,0,1962
10443,10443,,1,0,1,1975
10444,10444,,0,1,1,1963
10445,10445,,1,0,1,1963
10446,10446,,0,0,0,1964
10447,10447,,0,1,1,1965
10448,10448,,1,0,1,1965
10449,10449,,1,0,1,15
10450,10450,,1,0,1,1143
10451,10451,,1,0,1,272
10452,10452,,0,1,1,1966
10453,10453,,1,0,1,1966
10454,10454,,0,1,1,1967
10455,10455,,1,0,1,1967
10456,10456,,0,1,1,1968
10457,10457,,1,0,1,1968
10458,10458,,1,0,1,77
10459,10459,,0,1,1,1969
10460,10460,,1,0,1,1969
10461,10461,,1,0,1,280
10462,10462,,1,0,1,44
10463,10463,,0,0,0,1970
10464,10464,,0,0,0,1971
10465,10465,,0,1,1,1972
10466,10466,,1,0,1,1972
10467,10467,,0,2,2,27
10468,10468,,0,0,0,1973
10469,10469,,0,0,0,1974
10470,10470,,1,0,1,34
10471,10471,,1,0,1,1975
10472,10472,,1,0,1,27
10473,10473,,0,0,0,1976
10474,10474,,0,0,0,1977
10475,10475,,1,0,1,1978
10476,10476,,0,1,1,1979
10477,10477,,1,0,1,1979
10478,10478,,1,0,1,27
10479,10479,,1,0,1,1709
10480,10480,,0,1,1,1980
10481,10481,,1,0,1,1980
10482,10482,,0,1,1,1981
10483,10483,,1,0,1,1981
10484,10484,,0,1,1,1982
10485,10485,,1,0,1,1982
10486,10486,,0,1,1,1983
10487,10487,,1,0,1,1983
10488,10488,,0,0,0,1984
10489,10489,,0,1,1,1841
10490,10490,,1,0,1,1975
10491,10491,,0,0,0,1985
10492,10492,,1,0,1,1584
10493,10493,,0,1,1,1841
10494,10494,,0,0,0,1986
10495,10495,,0,1,1,1987
10496,10496,,1,0,1,1987
10497,10497,,0,1,1,1988
10498,10498,,1,0,1,1988
10499,10499,,0,0,0,1989
10500,10500,,0,1,1,1990
10501,10501,,1,0,1,1990
10502,10502,,0,0,0,1991
10503,10503,,0,0,0,1992
10504,10504,,0,1,1,1993
10505,10505,,1,0,1,1993
10506,10506,,0,1,1,1994
10507,10507,,1,0,1,1994
10508,10508,,0,1,1,1995
10509,10509,,1,0,1,1995
10510,10510,,1,0,1,1996
10511,10511,,0,1,1,1997
10512,10512,,1,0,1,1997
10513,10513,,0,0,0,1998
10514,10514,,0,0,0,1999
10515,10515,,1,0,1,260
10516,10516,,0,1,1,2000
10517,10517,,1,0,1,2000
10518,10518,,0,1,1,1414
10519,10519,,0,1,1,2001
10520,10520,,1,0,1,2001
10521,10521,,0,0,0,2002
10522,10522,,1,0,1,67
10523,10523,,0,0,0,2003
10524,10524,,1,0,1,43
10525,10525,,0,1,1,2004
10526,10526,,1,0,1,2004
10527,10527,,0,1,1,1073
10528,10528,,0,1,1,2005
10529,10529,,1,0,1,2005
10530,10530,,0,1,1,2006
10531,10531,,1,0,1,2006
10532,10532,,1,0,1,1882
10533,10533,,0,0,0,2007
10534,10534,,1,0,1,2008
10535,10535,,0,1,1,2009
10536,10536,,1,0,1,2009
10537,10537,,0,1,1,2010
10538,10538,,1,0,1,46
10539,10539,,0,1,1,2011
10540,10540,,1,0,1,2011
10541,10541,,1,0,1,44
10542,10542,,0,1,1,932
10543,10543,,1,0,1,46
10544,10544,,0,1,1,2012
10545,10545,,1,0,1,2012
10546,10546,,0,1,1,2013
10547,10547,,1,0,1,2013
10548,10548,,1,0,1,35
10549,10549,,0,0,0,2014
10550,10550,,0,1,1,2015
10551,10551,,1,0,1,2015
10552,10552,,0,0,0,2016
10553,10553,,1,0,1,34
10554,10554,,1,0,1,34
10555,10555,,1,0,1,216
10556,10556,,1,0,1,255
10557,10557,,1,0,1,67
10558,10558,,1,0,1,1630
10559,10559,,0,0,0,2017
10560,10560,,0,0,0,2018
10561,10561,,1,0,1,46
10562,10562,,1,0,1,57
10563,10563,,0,0,0,2019
10564,10564,,0,0,0,2020
10565,10565,,0,1,1,2021
10566,10566,,1,0,1,2021
10567,10567,,0,1,1,2022
10568,10568,,1,0,1,2022
10569,10569,,0,1,1,2023
10570,10570,,1,0,1,2023
10571,10571,,0,0,0,2024
10572,10572,,0,1,1,995
10573,10573,,1,0,1,1590
10574,10574,,1,0,1,1233
10575,10575,,1,0,1,40
10576,10576,,0,1,1,1412
10577,10577,,1,0,1,74
10578,10578,,0,1,1,2025
10579,10579,,1,0,1,2025
10580,10580,,1,0,1,30
10581,10581,,0,1,1,81
10582,10582,,0,1,1,627
10583,10583,,1,0,1,280
10584,10584,,1,0,1,1896
10585,10585,,0,0,0,2026
10586,10586,,0,1,1,2027
10587,10587,,1,0,1,2027
10588,10588,,0,0,0,2028
10589,10589,,0,0,0,2029
10590,10590,,0,1,1,2030
10591,10591,,1,0,1,2030
10592,10592,,0,0,0,2031
10593,10593,,0,1,1,2032
10594,10594,,1,0,1,2032
10595,10595,,1,0,1,21
10596,10596,,1,0,1,19
10597,10597,,0,1,1,1830
10598,10598,,1,0,1,77
10599,10599,,1,0,1,73
10600,10600,,0,1,1,19
10601,10601,,1,0,1,916
10602,10602,,0,1,1,947
10603,10603,,1,0,1,839
10604,10604,,0,0,0,2033
10605,10605,,0,0,0,2034
10606,10606,,1,0,1,46
10607,10607,,0,1,1,2035
10608,10608,,1,0,1,2035
10609,10609,,0,0,0,2036
10610,10610,,0,0,0,2037
10611,10611,,0,0,0,2038
10612,10612,,0,0,0,2039
10613,10613,,0,0,0,2040
10614,10614,,0,0,0,2041
10615,10615,,0,0,0,2042
10616,10616,,1,0,1,255
10617,10617,,1,0,1,1714
10618,10618,,0,1,1,2043
10619,10619,,1,0,1,2043
10620,10620,,0,0,0,2044
10621,10621,,1,0,1,27
10622,10622,,1,0,1,19
